state,government_function,full_time_equivalent_employees,total_march_pay,full_time_employees,part_time_employees,full_time_pay,part_time_pay,part_time_hours,year
US,total,14214109,39411694146,12622627,4110332,36378852787,3032841359,275300694,1997
US,financial administration,360724,967575026,342667,51045,930619766,36955260,3286983,1997
US,other government administration,250515,693951419,225186,158505,629457297,64494122,4676722,1997
US,judicial and legal,343343,1070534622,327470,38757,1031031298,39503324,2817261,1997
US,police protection - officers,602524,2159916970,592940,30069,2142851841,17065129,1703411,1997
US,police protection - other,195900,484821246,173871,59256,450263156,34558090,3869334,1997
US,fire protection - firefighters,256374,929435722,244920,84426,912095870,17339852,2062205,1997
US,fire protection - other,20778,60323381,18965,7627,57163053,3160328,331437,1997
US,corrections,648540,1775574157,633428,45105,1742418075,33156082,2633087,1997
US,streets and highways,530577,1396191318,515936,32550,1368750079,27441239,2631904,1997
US,air transportation,36881,111468499,35430,2770,109056960,2411539,255255,1997
US,water transport and terminals,12837,40184301,12293,1088,39151786,1032515,95617,1997
US,public welfare,474987,1172370213,448607,49311,1123608934,48761279,4559735,1997
US,health,377429,1014820175,343663,68498,940867624,73952551,5879182,1997
US,hospitals,984375,2603113990,876556,183453,2329549537,273564453,18859896,1997
US,social insurance administration,92777,258953964,87132,9098,245121591,13832373,976860,1997
US,solid waste management,107922,271548878,102376,12243,262887090,8661788,1002353,1997
US,sewerage,123115,352715670,120351,8829,347123572,5592098,518506,1997
US,parks and recreation,229762,494738140,169071,161232,407497009,87241131,10629618,1997
US,housing and community development,115062,291681806,108720,13854,279681765,12000041,1092883,1997
US,natural resources,184269,495745600,164242,41549,459085944,36659656,3515783,1997
US,water transport and terminals,153549,435666178,149307,15067,427470572,8195606,801748,1997
US,electric power,78605,301948859,77253,2436,298878545,3070314,239225,1997
US,gas supply,9764,26491708,9642,208,26288596,203112,21526,1997
US,transit,190721,676280379,181718,15068,657263072,19017307,1568973,1997
US,education - elementary and secondary instructional,3865494,11666664057,3582068,738395,11123160380,543503677,48160365,1997
US,education - elementary and secondary other,1655408,3046272432,1321524,766378,2548281474,497990958,56396635,1997
US,education - higher education instructional,584162,2398270837,406904,462892,1882825199,515445638,30824650,1997
US,education - higher education other,1054265,2402182066,753301,827901,1923663569,478518497,52511707,1997
US,education - other,91169,259358958,85565,13741,246668521,12690437,973483,1997
US,libraries,109859,233648382,77753,78044,185293727,48354655,5567205,1997
US,liquor stores,7167,16087461,5793,3570,14067068,2020393,239865,1997
US,other and unallocable,465255,1303157732,427975,127367,1236709817,66447915,6597280,1997
AL,total,256458,564271252,237658,49070,533038079,31233173,3257217,1997
AL,financial administration,5869,13995323,5724,358,13783346,211977,26687,1997
AL,other government administration,2846,6666684,2641,1670,5934982,731702,38421,1997
AL,judicial and legal,4341,11589048,4137,625,11131403,457645,38128,1997
AL,police protection - officers,9281,24173386,9181,259,24018409,154977,18677,1997
AL,police protection - other,2571,4896123,2336,714,4573904,322219,43067,1997
AL,fire protection - firefighters,4648,11911455,4485,683,11703695,207760,29253,1997
AL,fire protection - other,190,416860,184,32,407889,8971,1148,1997
AL,corrections,6761,15553781,6656,165,15426339,127442,18850,1997
AL,streets and highways,10934,21707153,10735,373,21424599,282554,35834,1997
AL,air transportation,445,960871,406,65,900263,60608,6820,1997
AL,water transport and terminals,646,1415732,645,1,1414332,1400,116,1997
AL,public welfare,5227,11629345,5044,326,11384321,245024,32505,1997
AL,health,11401,23951717,10642,1423,22882536,1069181,134613,1997
AL,hospitals,34562,74343590,30259,7050,65220520,9123070,753725,1997
AL,social insurance administration,1446,3333748,1421,60,3306113,27635,4393,1997
AL,solid waste management,3562,6028743,3478,161,5911939,116804,15114,1997
AL,sewerage,1210,2716734,1200,30,2703451,13283,2183,1997
AL,parks and recreation,4124,6907077,3100,2021,5814940,1092137,181892,1997
AL,housing and community development,2460,5382907,2355,220,5226841,156066,17653,1997
AL,natural resources,2742,6822652,2500,491,6538527,284125,41757,1997
AL,water transport and terminals,3351,7494509,3261,272,7361303,133206,17385,1997
AL,electric power,1130,3197134,1105,33,3163302,33832,4300,1997
AL,gas supply,843,2178803,818,40,2149714,29089,4465,1997
AL,transit,134,225454,105,46,191161,34293,5344,1997
AL,education - elementary and secondary instructional,65776,154728843,64528,5536,152959587,1769256,206970,1997
AL,education - elementary and secondary other,26253,33333549,24353,5364,31111216,2222333,319353,1997
AL,education - higher education instructional,10497,40497644,8512,6173,35352220,5145424,335963,1997
AL,education - higher education other,20908,40965512,16610,12260,35423649,5541863,736346,1997
AL,education - other,3423,9680403,3232,793,9217027,463376,33551,1997
AL,libraries,950,1712635,752,457,1442185,270450,34851,1997
AL,liquor stores,653,1263930,653,0,1263930,0,0,1997
AL,other and unallocable,7274,14589907,6600,1369,13694436,895471,117853,1997
AK,total,45490,163984422,41251,12074,154751872,9232550,727492,1997
AK,financial administration,1800,6656859,1763,89,6556664,100195,6607,1997
AK,other government administration,1323,4534230,1220,491,4274390,259840,18202,1997
AK,judicial and legal,1275,5183298,1241,87,5068765,114533,5667,1997
AK,police protection - officers,992,5124233,969,56,5081323,42910,3563,1997
AK,police protection - other,612,2238892,596,47,2206508,32384,3082,1997
AK,fire protection - firefighters,545,2627429,512,171,2566626,60803,5831,1997
AK,fire protection - other,22,66214,18,11,57668,8546,806,1997
AK,corrections,1309,5272716,1306,7,5261393,11323,641,1997
AK,streets and highways,3333,13026122,3299,103,12950259,75863,5901,1997
AK,air transportation,77,277091,75,6,270389,6702,489,1997
AK,water transport and terminals,114,417985,103,22,387105,30880,1847,1997
AK,public welfare,2034,6407803,1891,201,6177083,230720,24085,1997
AK,health,1041,3416224,974,104,3261707,154517,11482,1997
AK,hospitals,708,2375719,631,123,2185247,190472,13056,1997
AK,social insurance administration,381,1328038,380,2,1326137,1901,132,1997
AK,solid waste management,394,1504654,376,56,1464227,40427,3403,1997
AK,sewerage,331,1293341,312,66,1250229,43112,3487,1997
AK,parks and recreation,567,1378323,342,414,1034861,343462,38991,1997
AK,housing and community development,594,1986225,375,247,1357321,628904,36482,1997
AK,natural resources,2128,7906786,2098,64,7818780,88006,5064,1997
AK,water transport and terminals,378,1127082,359,71,1086491,40591,3193,1997
AK,electric power,563,2638227,555,14,2616381,21846,1174,1997
AK,gas supply,0,0,0,0,0,0,0,1997
AK,transit,241,819257,219,24,765743,53514,3677,1997
AK,education - elementary and secondary instructional,11344,43352667,10413,2537,41447622,1905045,154754,1997
AK,education - elementary and secondary other,4914,14369824,4263,2674,13062872,1306952,110448,1997
AK,education - higher education instructional,1310,6650748,1002,1130,5499483,1151265,54540,1997
AK,education - higher education other,2936,7417619,2075,2161,5799384,1618235,152350,1997
AK,education - other,491,1728688,479,34,1701032,27656,2074,1997
AK,libraries,282,720101,200,148,576694,143407,14277,1997
AK,liquor stores,0,0,0,0,0,0,0,1997
AK,other and unallocable,3451,12138027,3205,914,11639488,498539,42187,1997
AZ,total,226563,577933239,196259,72780,526938964,50994275,5328650,1997
AZ,financial administration,6988,17113206,6890,217,16936906,176300,17595,1997
AZ,other government administration,4497,13647830,4256,616,13096107,551723,42729,1997
AZ,judicial and legal,7891,21983257,7562,878,21238718,744539,58889,1997
AZ,police protection - officers,10849,36604506,10828,48,36563576,40930,3419,1997
AZ,police protection - other,3853,10483839,3677,328,10170765,313074,30599,1997
AZ,fire protection - firefighters,3878,13990698,3640,1288,13618689,372009,41862,1997
AZ,fire protection - other,694,2274443,620,153,2135303,139140,13309,1997
AZ,corrections,12067,27422534,11882,453,27096163,326371,32962,1997
AZ,streets and highways,7143,18595129,7059,133,18443072,152057,14405,1997
AZ,air transportation,931,2611797,901,46,2566455,45342,4840,1997
AZ,water transport and terminals,0,0,0,0,0,0,0,1997
AZ,public welfare,7454,14872749,7143,574,14360365,512384,54973,1997
AZ,health,4606,10205883,4452,330,9946945,258938,27420,1997
AZ,hospitals,4047,8009787,2986,2639,6105670,1904117,187920,1997
AZ,social insurance administration,2017,4067791,2004,49,4048354,19437,2227,1997
AZ,solid waste management,1983,5388264,1924,93,5288044,100220,10197,1997
AZ,sewerage,1236,3326789,1219,44,3296111,30678,2597,1997
AZ,parks and recreation,4000,8495484,2835,3122,6874746,1620738,206255,1997
AZ,housing and community development,910,2603443,879,49,2552840,50603,5276,1997
AZ,natural resources,3349,8578955,3013,755,8012516,566439,60030,1997
AZ,water transport and terminals,2842,8702972,2802,76,8635598,67374,7076,1997
AZ,electric power,4510,20634873,4420,134,20355439,279434,16099,1997
AZ,gas supply,18,43286,18,0,43286,0,0,1997
AZ,transit,106,298536,90,32,267515,31021,2858,1997
AZ,education - elementary and secondary instructional,58194,151382236,52035,11803,141432682,9949554,1083795,1997
AZ,education - elementary and secondary other,28508,48674505,21653,14312,39378335,9296170,1198093,1997
AZ,education - higher education instructional,11117,41034440,6572,12287,30127419,10907021,799006,1997
AZ,education - higher education other,21938,50094390,14727,20486,39165227,10929163,1269298,1997
AZ,education - other,2731,6127576,2588,384,5515890,611686,25136,1997
AZ,libraries,1487,3320408,1099,836,2748518,571890,68677,1997
AZ,liquor stores,0,0,0,0,0,0,0,1997
AZ,other and unallocable,6719,17343633,6485,615,16917710,425923,41108,1997
AR,total,139367,288602602,128903,31989,273272869,15329733,1846159,1997
AR,financial administration,3795,7453246,3658,371,7223556,229690,25700,1997
AR,other government administration,2654,5260300,2384,2431,4594487,665813,52342,1997
AR,judicial and legal,2005,4826106,1809,563,4480945,345161,35060,1997
AR,police protection - officers,4978,11924657,4885,287,11787769,136888,17325,1997
AR,police protection - other,1631,2676721,1551,245,2580312,96409,14221,1997
AR,fire protection - firefighters,2093,5300830,2034,1547,5198604,102226,12625,1997
AR,fire protection - other,83,131942,71,54,118500,13442,2418,1997
AR,corrections,4972,8469021,4917,112,8403629,65392,9032,1997
AR,streets and highways,7113,15135178,6975,312,14965165,170013,24662,1997
AR,air transportation,193,334729,185,20,325711,9018,1391,1997
AR,water transport and terminals,10,30458,10,0,30458,0,0,1997
AR,public welfare,3937,7525051,3905,68,7489132,35919,5980,1997
AR,health,4832,10378865,4715,185,10207554,171311,20544,1997
AR,hospitals,9188,17184964,8526,1244,15991585,1193379,114614,1997
AR,social insurance administration,991,2563786,867,193,2390177,173609,21899,1997
AR,solid waste management,1319,2086975,1263,148,2016261,70714,10194,1997
AR,sewerage,871,1704325,854,57,1675045,29280,3557,1997
AR,parks and recreation,1627,2526351,1231,769,2139644,386707,70289,1997
AR,housing and community development,904,1585630,820,189,1468454,117176,15371,1997
AR,natural resources,2492,5514035,2291,435,5271238,242797,35213,1997
AR,water transport and terminals,1808,3489333,1756,196,3387284,102049,11503,1997
AR,electric power,303,817033,302,3,815832,1201,126,1997
AR,gas supply,3,4002,2,1,3418,584,97,1997
AR,transit,176,405888,169,10,396213,9675,1063,1997
AR,education - elementary and secondary instructional,39985,90336488,38735,4626,88741319,1595169,214206,1997
AR,education - elementary and secondary other,18070,22665164,15715,7223,19768372,2896792,409601,1997
AR,education - higher education instructional,5454,22561220,4313,3454,19369739,3191481,201432,1997
AR,education - higher education other,10040,18938551,7907,5089,16788716,2149835,376559,1997
AR,education - other,2740,6617544,2480,621,6178301,439243,45545,1997
AR,libraries,753,1136022,593,419,959896,176126,27901,1997
AR,liquor stores,0,0,0,0,0,0,0,1997
AR,other and unallocable,4347,9018187,3980,1117,8505553,512634,65689,1997
CA,total,1529599,5263693310,1294993,550946,4757595455,506097855,40899912,1997
CA,financial administration,38283,129560004,36488,3808,125760615,3799389,316898,1997
CA,other government administration,26202,98313903,24363,4882,93036358,5277545,322126,1997
CA,judicial and legal,39514,161032723,38167,2571,156912641,4120082,235632,1997
CA,police protection - officers,64470,317010313,63845,2409,315196123,1814190,110099,1997
CA,police protection - other,28174,91848683,25612,5799,87046484,4802199,451189,1997
CA,fire protection - firefighters,27162,150098468,26491,3628,148786941,1311527,120835,1997
CA,fire protection - other,2646,9675530,2439,511,9279117,396413,37755,1997
CA,corrections,72736,264812740,68481,6343,252935835,11876905,749330,1997
CA,streets and highways,37357,137728591,36142,2028,134649742,3078849,213832,1997
CA,air transportation,4999,18223020,4788,359,17821270,401750,36893,1997
CA,water transport and terminals,1994,8236071,1895,210,7992727,243344,17247,1997
CA,public welfare,52685,151609533,51222,2810,148400167,3209366,254963,1997
CA,health,45405,158296243,41638,6683,147322711,10973532,659087,1997
CA,hospitals,95541,331278200,82268,23264,288937841,42340359,2337811,1997
CA,social insurance administration,17976,59549305,16190,3020,54122449,5426856,316018,1997
CA,solid waste management,7047,24030734,6657,582,23247702,783032,67997,1997
CA,sewerage,12308,48221508,11949,767,47261670,959838,64440,1997
CA,parks and recreation,33470,82553138,23014,24842,65741985,16811153,1846036,1997
CA,housing and community development,11618,40034024,10792,1501,38096533,1937491,145178,1997
CA,natural resources,23643,77566325,21993,2882,74118865,3447460,292697,1997
CA,water transport and terminals,23863,96357859,23121,1752,94433701,1924158,131052,1997
CA,electric power,14102,65772209,13778,541,64880466,891743,57285,1997
CA,gas supply,264,924116,264,0,924116,0,0,1997
CA,transit,28868,109159926,27563,1945,106059926,3100000,229924,1997
CA,education - elementary and secondary instructional,373235,1311142489,303819,151080,1164823431,146319058,11946561,1997
CA,education - elementary and secondary other,173676,381338743,130684,102127,311533837,69804906,7395818,1997
CA,education - higher education instructional,67022,271433561,39203,64852,198377556,73056005,4907871,1997
CA,education - higher education other,117356,346409384,82358,111763,275298425,71110959,6185230,1997
CA,education - other,4720,16093397,4295,769,15032945,1060452,75160,1997
CA,libraries,11270,30009186,7771,8502,23143961,6865225,616912,1997
CA,liquor stores,0,0,0,0,0,0,0,1997
CA,other and unallocable,71993,275373384,67703,8716,266419315,8954069,758036,1997
CO,total,212578,601724085,177368,87422,515506591,86217494,6213865,1997
CO,financial administration,5277,15449247,5099,425,15031830,417417,31638,1997
CO,other government administration,4656,12739012,4346,7851,11904603,834409,56785,1997
CO,judicial and legal,5069,17028439,4637,1010,15618252,1410187,78954,1997
CO,police protection - officers,8290,29417083,8266,91,29368966,48117,4324,1997
CO,police protection - other,3133,7693596,2973,420,7405353,288243,28446,1997
CO,fire protection - firefighters,3778,14660059,3668,585,14486351,173708,19563,1997
CO,fire protection - other,379,1053489,344,203,982066,71423,6776,1997
CO,corrections,7501,21618487,7411,170,21392673,225814,16176,1997
CO,streets and highways,8013,23129805,7737,536,22494994,634811,49647,1997
CO,air transportation,1103,3645993,1038,130,3534721,111272,11284,1997
CO,water transport and terminals,0,0,0,0,0,0,0,1997
CO,public welfare,6392,16297549,6045,676,15606527,691022,61107,1997
CO,health,3418,9543686,2888,1353,8451503,1092183,93231,1997
CO,hospitals,12043,31281884,10496,2847,26680423,4601461,272237,1997
CO,social insurance administration,886,3083553,695,303,2441557,641996,33789,1997
CO,solid waste management,648,1587002,604,90,1515778,71224,8064,1997
CO,sewerage,2134,6463996,2070,304,6335870,128126,11635,1997
CO,parks and recreation,5980,13273166,3579,6341,9921818,3351348,424282,1997
CO,housing and community development,1477,3967541,1348,368,3736145,231396,22694,1997
CO,natural resources,1863,6137966,1687,436,5753499,384467,32612,1997
CO,water transport and terminals,3807,11477040,3712,458,11290790,186250,17526,1997
CO,electric power,1398,5179563,1377,29,5146527,33036,3515,1997
CO,gas supply,323,1090636,323,0,1090636,0,0,1997
CO,transit,2520,6678841,2291,340,6279065,399776,40194,1997
CO,education - elementary and secondary instructional,54549,150955667,49056,15092,140777283,10178384,958442,1997
CO,education - elementary and secondary other,24119,43879035,18722,11988,36863312,7015723,945349,1997
CO,education - higher education instructional,13357,63424408,8935,10144,41284497,22139911,782525,1997
CO,education - higher education other,21159,56241306,10177,21736,28285405,27955901,1943695,1997
CO,education - other,1346,4068978,1041,638,3262949,806029,53858,1997
CO,libraries,1978,4363786,1402,1458,3339195,1024591,101509,1997
CO,liquor stores,0,0,0,0,0,0,0,1997
CO,other and unallocable,5982,16293272,5401,1400,15224003,1069269,104008,1997
CT,total,164112,564180093,149055,39665,531614891,32565202,2459933,1997
CT,financial administration,4885,14771133,4677,504,14277211,493922,35131,1997
CT,other government administration,3039,9832201,2759,860,9145775,686426,46786,1997
CT,judicial and legal,3729,12050969,3643,118,11799028,251941,13082,1997
CT,police protection - officers,7692,33915848,7576,317,33692065,223783,19470,1997
CT,police protection - other,2070,5669795,1711,953,4974003,695792,61789,1997
CT,fire protection - firefighters,4144,17300126,4056,473,17120002,180124,15402,1997
CT,fire protection - other,269,785381,232,147,688110,97271,6819,1997
CT,corrections,8131,25666016,8076,82,25483985,182031,8644,1997
CT,streets and highways,7472,25887326,7392,192,25727693,159633,13397,1997
CT,air transportation,162,599120,162,0,599120,0,0,1997
CT,water transport and terminals,0,0,0,0,0,0,0,1997
CT,public welfare,6622,20655236,6193,871,19669088,986148,71252,1997
CT,health,3501,11416890,3263,549,10774659,642231,40713,1997
CT,hospitals,10733,37800937,9522,1931,34205702,3595235,195877,1997
CT,social insurance administration,1050,3275560,1050,0,3275560,0,0,1997
CT,solid waste management,1094,3618947,1036,140,3516850,102097,10014,1997
CT,sewerage,1119,3848605,1100,53,3808807,39798,3122,1997
CT,parks and recreation,2484,6659394,1839,2067,5619936,1039458,109810,1997
CT,housing and community development,1511,4625858,1383,294,4391383,234475,20441,1997
CT,natural resources,619,2076865,578,47,2002039,74826,6362,1997
CT,water transport and terminals,1030,3587465,1016,54,3556647,30818,2711,1997
CT,electric power,214,1013324,214,1,1012899,425,71,1997
CT,gas supply,33,138942,33,0,138942,0,0,1997
CT,transit,455,1332621,413,101,1260083,72538,7120,1997
CT,education - elementary and secondary instructional,53207,204960523,49306,8893,196554763,8405760,627648,1997
CT,education - elementary and secondary other,16092,35435975,13448,6344,31099429,4336546,435467,1997
CT,education - higher education instructional,5049,22416847,3875,3344,18813481,3603366,190656,1997
CT,education - higher education other,8414,27304926,6281,8553,22960886,4344040,339248,1997
CT,education - other,2903,8713567,2762,227,8378822,334745,21750,1997
CT,libraries,1415,3571291,993,1287,2835008,736283,71844,1997
CT,liquor stores,0,0,0,0,0,0,0,1997
CT,other and unallocable,4974,15248405,4466,1263,14232915,1015490,85307,1997
DE,total,40741,110763701,36665,10378,103402530,7361171,679048,1997
DE,financial administration,1173,2892484,1132,85,2828898,63586,7137,1997
DE,other government administration,640,1831138,570,196,1600891,230247,12446,1997
DE,judicial and legal,1460,3976454,1448,32,3942959,33495,2169,1997
DE,police protection - officers,1496,5777902,1486,21,5765581,12321,1317,1997
DE,police protection - other,617,1366294,423,291,1052326,313968,31554,1997
DE,fire protection - firefighters,194,678966,194,0,678966,0,0,1997
DE,fire protection - other,90,310069,89,2,309232,837,93,1997
DE,corrections,2022,5234704,1941,159,5071818,162886,13810,1997
DE,streets and highways,1853,4121366,1755,113,3994473,126893,16541,1997
DE,air transportation,24,64864,23,1,63737,1127,108,1997
DE,water transport and terminals,198,557835,156,75,472180,85655,7514,1997
DE,public welfare,1433,3526318,1355,137,3385680,140638,12833,1997
DE,health,1819,4856506,1699,233,4639912,216594,19837,1997
DE,hospitals,2261,4692908,2188,147,4539404,153504,12200,1997
DE,social insurance administration,300,661362,295,9,652798,8564,704,1997
DE,solid waste management,205,442427,192,26,425089,17338,2363,1997
DE,sewerage,368,914370,367,1,912962,1408,142,1997
DE,parks and recreation,491,1089716,387,533,950479,139237,17583,1997
DE,housing and community development,279,572433,270,15,563265,9168,1375,1997
DE,natural resources,487,1238931,437,108,1162373,76558,8360,1997
DE,water transport and terminals,166,352259,165,4,350577,1682,246,1997
DE,electric power,140,422411,139,1,419373,3038,177,1997
DE,gas supply,0,0,0,0,0,0,0,1997
DE,transit,472,1321016,447,35,1281775,39241,4420,1997
DE,education - elementary and secondary instructional,9438,28154620,9058,950,27512636,641984,63144,1997
DE,education - elementary and secondary other,4046,8635546,3406,1276,7925749,709797,107199,1997
DE,education - higher education instructional,2431,9396728,1533,2134,7221170,2175558,149045,1997
DE,education - higher education other,4386,11426174,3375,3391,9624162,1802012,166736,1997
DE,education - other,268,926506,264,5,920192,6314,480,1997
DE,libraries,185,373227,136,133,309723,63504,8310,1997
DE,liquor stores,0,0,0,0,0,0,0,1997
DE,other and unallocable,1799,4948167,1735,265,4824150,124017,11205,1997
DC,total,46246,177629245,44905,2366,174129482,3499763,230497,1997
DC,financial administration,737,2500589,707,67,2399786,100803,5258,1997
DC,other government administration,590,2127809,578,20,2083775,44034,2161,1997
DC,judicial and legal,1792,6284247,1777,31,6231341,52906,2670,1997
DC,police protection - officers,3657,15921131,3655,3,15913322,7809,317,1997
DC,police protection - other,687,2102047,634,133,1939130,162917,9427,1997
DC,fire protection - firefighters,1191,4427088,1191,0,4427088,0,0,1997
DC,fire protection - other,434,1606204,434,0,1606204,0,0,1997
DC,corrections,3749,14135430,3729,17,14061524,73906,3469,1997
DC,streets and highways,546,1698842,546,0,1698842,0,0,1997
DC,air transportation,0,0,0,0,0,0,0,1997
DC,water transport and terminals,0,0,0,0,0,0,0,1997
DC,public welfare,1187,3586445,1187,0,3586445,0,0,1997
DC,health,1387,4477788,1352,68,4363411,114377,6274,1997
DC,hospitals,4027,14133892,3840,194,13477014,656878,33124,1997
DC,social insurance administration,0,0,0,0,0,0,0,1997
DC,solid waste management,389,1045092,389,0,1045092,0,0,1997
DC,sewerage,577,2152245,577,0,2152245,0,0,1997
DC,parks and recreation,617,1628557,571,117,1506512,122045,8187,1997
DC,housing and community development,1500,4201065,1500,0,4201065,0,0,1997
DC,natural resources,0,0,0,0,0,0,0,1997
DC,water transport and terminals,576,2147715,576,0,2147715,0,0,1997
DC,electric power,0,0,0,0,0,0,0,1997
DC,gas supply,0,0,0,0,0,0,0,1997
DC,transit,7787,44444130,7666,241,44050263,393867,21348,1997
DC,education - elementary and secondary instructional,6242,25821904,6118,321,25429530,392374,20662,1997
DC,education - elementary and secondary other,4465,9179144,3951,664,8336268,842876,85366,1997
DC,education - higher education instructional,424,2051254,327,127,1706286,344968,17256,1997
DC,education - higher education other,325,1004605,283,105,951761,52844,7373,1997
DC,education - other,0,0,0,0,0,0,0,1997
DC,libraries,380,1116332,368,24,1079828,36504,2203,1997
DC,liquor stores,0,0,0,0,0,0,0,1997
DC,other and unallocable,2980,9835690,2949,234,9735035,100655,5402,1997
FL,total,730982,1855324059,681232,177242,1768229744,87094315,8748759,1997
FL,financial administration,20852,54594609,20297,988,53729017,865592,96002,1997
FL,other government administration,14417,42191729,13731,1813,40536015,1655714,120016,1997
FL,judicial and legal,24637,71262042,24038,941,69989677,1272365,104955,1997
FL,police protection - officers,34423,121769063,34215,758,121377960,391103,37202,1997
FL,police protection - other,15988,35686641,14362,4183,33272303,2414338,286282,1997
FL,fire protection - firefighters,16679,59186183,16471,636,58862075,324108,36911,1997
FL,fire protection - other,1899,5534992,1831,117,5424032,110960,10836,1997
FL,corrections,51243,143858683,50752,18784,143306534,552149,86608,1997
FL,streets and highways,25044,56649809,24662,765,55910330,739479,66980,1997
FL,air transportation,2799,8654639,2741,79,8550017,104622,9870,1997
FL,water transport and terminals,942,3066616,889,90,2991845,74771,9402,1997
FL,public welfare,14393,29449403,13821,1227,28809357,640046,100095,1997
FL,health,19849,46441859,19034,1240,44929948,1511911,143960,1997
FL,hospitals,48578,129501698,43851,8360,118314918,11186780,836426,1997
FL,social insurance administration,4795,12849128,4783,25,12824681,24447,2100,1997
FL,solid waste management,6915,14804956,6786,204,14620096,184860,22219,1997
FL,sewerage,8507,21361783,8445,101,21244896,116887,11010,1997
FL,parks and recreation,16187,31464224,12880,8419,26717939,4746285,583049,1997
FL,housing and community development,4540,10990883,4310,357,10648825,342058,38787,1997
FL,natural resources,11683,30325845,10512,2165,28415077,1910768,207129,1997
FL,water transport and terminals,9941,25761885,9862,140,25617186,144699,13643,1997
FL,electric power,5235,18493276,5220,36,18454620,38656,2597,1997
FL,gas supply,603,1244659,598,9,1236067,8592,803,1997
FL,transit,5805,17243371,5556,389,16802339,441032,43855,1997
FL,education - elementary and secondary instructional,147460,426584188,143465,36394,419327381,7256807,707121,1997
FL,education - elementary and secondary other,118379,168797011,109359,33140,157354836,11442175,1595465,1997
FL,education - higher education instructional,23914,91033987,16849,22684,71596705,19437282,1236118,1997
FL,education - higher education other,41093,90754275,29933,28017,74910008,15844267,1951866,1997
FL,education - other,1945,5550975,1918,241,5490521,60454,4928,1997
FL,libraries,4609,9569679,3839,1530,8565978,1003701,135652,1997
FL,liquor stores,0,0,0,0,0,0,0,1997
FL,other and unallocable,27628,70645968,26222,3410,68398561,2247407,246872,1997
GA,total,435945,1002192630,401401,89423,937289678,64902952,6090567,1997
GA,financial administration,9208,21956304,8637,1056,21119020,837284,100093,1997
GA,other government administration,4861,12240374,4328,2481,10828411,1411963,97141,1997
GA,judicial and legal,7750,21695552,7319,1451,20487648,1207904,78121,1997
GA,police protection - officers,16799,42837965,16562,610,42513249,324716,41023,1997
GA,police protection - other,5041,10244529,4552,1267,9531359,713170,85919,1997
GA,fire protection - firefighters,8254,22423992,8020,1308,22083359,340633,42918,1997
GA,fire protection - other,484,958169,467,64,931648,26521,2971,1997
GA,corrections,23434,51648312,23144,513,51097215,551097,51499,1997
GA,streets and highways,13698,24076089,13581,227,23910561,165528,21007,1997
GA,air transportation,533,1379344,509,54,1321374,57970,4458,1997
GA,water transport and terminals,687,1742951,687,0,1742951,0,0,1997
GA,public welfare,8170,17186661,7849,434,16735230,451431,56494,1997
GA,health,16692,37626934,14755,3891,34427450,3199484,342071,1997
GA,hospitals,52336,124318121,45842,10642,109834542,14483579,1148804,1997
GA,social insurance administration,1870,4780992,1813,85,4695679,85313,10102,1997
GA,solid waste management,4499,7924630,4245,488,7531728,392902,45141,1997
GA,sewerage,3030,6858824,2978,74,6778693,80131,9055,1997
GA,parks and recreation,7110,12569849,5190,3983,10149592,2420257,339044,1997
GA,housing and community development,3390,6734028,3234,356,6454151,279877,27092,1997
GA,natural resources,5521,12945653,4908,1355,12028505,917148,108637,1997
GA,water transport and terminals,4830,10611389,4743,234,10490112,121277,15397,1997
GA,electric power,743,2078222,739,7,2073147,5075,557,1997
GA,gas supply,415,897146,413,3,893793,3353,412,1997
GA,transit,4538,12475969,4177,608,11796574,679395,63728,1997
GA,education - elementary and secondary instructional,126062,315731962,122237,15363,308883098,6848864,664587,1997
GA,education - elementary and secondary other,50307,71883871,45303,12556,64528511,7355360,878221,1997
GA,education - higher education instructional,12802,57398828,9785,9861,47096197,10302631,531512,1997
GA,education - higher education other,23902,44882365,18489,14616,36635489,8246876,956691,1997
GA,education - other,5497,15940364,4810,2193,14560232,1380132,121347,1997
GA,libraries,2285,4753569,1780,1241,4016027,737542,89312,1997
GA,liquor stores,0,0,0,0,0,0,0,1997
GA,other and unallocable,11197,23389672,10305,2402,22114133,1275539,157213,1997
HI,total,65995,182754796,61405,20208,170726022,12028774,787009,1997
HI,financial administration,1746,4819742,1742,12,4812948,6794,770,1997
HI,other government administration,1882,5308894,1851,71,5242944,65950,5269,1997
HI,judicial and legal,2628,8376104,2601,67,8290828,85276,4710,1997
HI,police protection - officers,2615,11332632,2615,0,11332632,0,0,1997
HI,police protection - other,799,2140426,755,213,2073726,66700,7618,1997
HI,fire protection - firefighters,1596,5810408,1596,0,5810408,0,0,1997
HI,fire protection - other,69,204162,69,0,204162,0,0,1997
HI,corrections,2156,5258562,2144,24,5219914,38648,2080,1997
HI,streets and highways,1846,4791982,1836,28,4774964,17018,1690,1997
HI,air transportation,976,2165908,972,12,2161216,4692,766,1997
HI,water transport and terminals,213,527410,210,9,524162,3248,462,1997
HI,public welfare,1192,3379368,1173,46,3357202,22166,3350,1997
HI,health,2992,7867196,2934,120,7722086,145110,10216,1997
HI,hospitals,3311,8076100,3212,226,7714070,362030,17610,1997
HI,social insurance administration,375,1054110,341,46,983522,70588,5936,1997
HI,solid waste management,603,1697664,603,0,1697664,0,0,1997
HI,sewerage,894,2751528,892,3,2749330,2198,274,1997
HI,parks and recreation,2085,4758102,1765,1090,4168432,589670,56576,1997
HI,housing and community development,118,351828,117,3,349506,2322,170,1997
HI,natural resources,1427,4622316,1330,355,4237044,385272,17754,1997
HI,water transport and terminals,1028,2990360,1018,33,2975126,15234,1840,1997
HI,electric power,0,0,0,0,0,0,0,1997
HI,gas supply,0,0,0,0,0,0,0,1997
HI,transit,69,176754,69,1,176432,322,28,1997
HI,education - elementary and secondary instructional,17874,45918088,16455,6685,42150414,3767674,235480,1997
HI,education - elementary and secondary other,5026,9356168,4220,4263,7859820,1496348,133798,1997
HI,education - higher education instructional,2447,11595350,2012,1434,9559610,2035740,76994,1997
HI,education - higher education other,4308,12781602,3434,4757,10347382,2434220,154692,1997
HI,education - other,133,368164,132,3,364680,3484,240,1997
HI,libraries,566,1237788,494,222,1130268,107520,11946,1997
HI,liquor stores,0,0,0,0,0,0,0,1997
HI,other and unallocable,5021,13036080,4813,485,12735530,300550,36740,1997
ID,total,68572,152003498,59291,26427,135077166,16926332,1632490,1997
ID,financial administration,2207,5120104,2095,307,4941238,178866,21453,1997
ID,other government administration,1087,2513782,961,924,2128612,385170,24994,1997
ID,judicial and legal,1276,3553506,1230,121,3455680,97826,8284,1997
ID,police protection - officers,2082,5828687,2058,102,5790207,38480,4642,1997
ID,police protection - other,858,1770649,786,216,1661006,109643,13128,1997
ID,fire protection - firefighters,917,2805887,827,1332,2657247,148640,16579,1997
ID,fire protection - other,55,113130,43,128,88523,24607,2772,1997
ID,corrections,2381,5263586,2266,232,5087016,176570,20757,1997
ID,streets and highways,3200,8037347,3022,377,7714593,322754,31976,1997
ID,air transportation,97,225402,90,19,215943,9459,1224,1997
ID,water transport and terminals,2,7232,2,1,6712,520,65,1997
ID,public welfare,2041,4785391,1900,245,4503582,281809,24955,1997
ID,health,1987,4742991,1724,559,4217349,525642,46662,1997
ID,hospitals,5571,13245986,4558,1729,10701453,2544533,176577,1997
ID,social insurance administration,614,1497957,444,162,1257346,240611,30075,1997
ID,solid waste management,333,649496,306,60,611807,37689,4897,1997
ID,sewerage,390,959678,368,88,914271,45407,4360,1997
ID,parks and recreation,807,1593600,553,872,1248822,344778,44759,1997
ID,housing and community development,111,215613,95,36,193557,22056,2862,1997
ID,natural resources,2438,5928561,1869,1026,4552105,1376456,100876,1997
ID,water transport and terminals,396,936172,377,91,896823,39349,3996,1997
ID,electric power,89,322212,88,2,318152,4060,219,1997
ID,gas supply,0,0,0,0,0,0,0,1997
ID,transit,26,39192,8,35,18717,20475,3162,1997
ID,education - elementary and secondary instructional,20342,46732712,18365,6092,43653681,3079031,336319,1997
ID,education - elementary and secondary other,6896,10679411,5484,4222,8826474,1852937,244662,1997
ID,education - higher education instructional,3007,8621604,2431,1553,6610113,2011491,101684,1997
ID,education - higher education other,6476,9843303,5036,3972,7687512,2155791,254866,1997
ID,education - other,520,1226269,402,463,1060554,165715,20715,1997
ID,libraries,443,778766,229,600,471307,307459,37250,1997
ID,liquor stores,151,314076,92,135,230615,83461,10432,1997
ID,other and unallocable,1772,3651196,1582,726,3356149,295047,37288,1997
IL,total,600920,1791137117,535631,192458,1678977625,112159492,11214384,1997
IL,financial administration,13646,37203582,13107,2322,36006399,1197183,108442,1997
IL,other government administration,11817,32213811,10863,13556,29166458,3047353,197086,1997
IL,judicial and legal,15996,48988308,15721,750,48302875,685433,47709,1997
IL,police protection - officers,32551,140791788,31975,1952,139839412,952376,106715,1997
IL,police protection - other,10873,31679595,9893,3034,30214152,1465443,173364,1997
IL,fire protection - firefighters,14166,54176731,12893,10222,52279989,1896742,226192,1997
IL,fire protection - other,1039,2352651,888,1014,2086825,265826,28430,1997
IL,corrections,23219,68094853,23087,261,67884168,210685,22446,1997
IL,streets and highways,19212,61064054,18133,3256,58563366,2500688,199106,1997
IL,air transportation,2313,7645180,2277,112,7602549,42631,6449,1997
IL,water transport and terminals,151,490697,143,11,478137,12560,1339,1997
IL,public welfare,19632,53267205,18699,1742,51759977,1507228,157846,1997
IL,health,10247,28569539,9613,1534,27300682,1268857,108763,1997
IL,hospitals,30181,88700794,28646,2734,84953767,3747027,264146,1997
IL,social insurance administration,3489,10105495,3149,516,9037528,1067967,56526,1997
IL,solid waste management,4768,18319379,4694,182,18206947,112432,13157,1997
IL,sewerage,6191,22720504,6049,596,22460825,259679,28239,1997
IL,parks and recreation,15651,35775743,10183,16372,27312554,8463189,951425,1997
IL,housing and community development,6402,18158854,6248,381,17886788,272066,26474,1997
IL,natural resources,4916,12663841,3925,2116,11473798,1190043,166581,1997
IL,water transport and terminals,5928,19430416,5691,1434,18969716,460700,49098,1997
IL,electric power,1140,4085229,1132,15,4077454,7775,1061,1997
IL,gas supply,91,228837,91,1,228748,89,9,1997
IL,transit,16627,54194503,15580,1613,51899708,2294795,184882,1997
IL,education - elementary and secondary instructional,171839,537881287,163046,23917,520798235,17083052,1482928,1997
IL,education - elementary and secondary other,59207,128702290,49364,27678,112976640,15725650,1668979,1997
IL,education - higher education instructional,26088,102617862,17547,23724,81727298,20890564,1455700,1997
IL,education - higher education other,47306,103586927,30742,38418,84264978,19321949,2788062,1997
IL,education - other,3004,9340348,2984,41,9287912,52436,3578,1997
IL,libraries,8047,15922022,5367,6566,12092202,3829820,459163,1997
IL,liquor stores,0,0,0,0,0,0,0,1997
IL,other and unallocable,15183,42164792,13901,6388,39837538,2327254,230489,1997
IN,total,307385,746680881,266055,96814,667224604,79456277,7104322,1997
IN,financial administration,8713,16373564,8150,1787,15476880,896684,106774,1997
IN,other government administration,5493,10172259,5003,4456,8883901,1288358,97211,1997
IN,judicial and legal,5758,13261284,5299,931,12238975,1022309,79249,1997
IN,police protection - officers,10670,31650932,10527,496,31420886,230046,26960,1997
IN,police protection - other,3846,6902747,3491,1118,6378540,524207,61436,1997
IN,fire protection - firefighters,5922,17752847,5726,1976,17503826,249021,35792,1997
IN,fire protection - other,394,832768,361,91,788943,43825,6283,1997
IN,corrections,10175,21594155,9867,653,21078594,515561,51105,1997
IN,streets and highways,10573,21669306,10443,271,21481471,187835,24065,1997
IN,air transportation,132,314740,123,27,303784,10956,1559,1997
IN,water transport and terminals,31,97312,30,3,94660,2652,224,1997
IN,public welfare,6650,12657258,6475,387,12411849,245409,28719,1997
IN,health,4551,10283270,4284,804,9877227,406043,44315,1997
IN,hospitals,28634,62983636,23931,7394,52980888,10002748,782920,1997
IN,social insurance administration,1502,3292635,1399,143,3158236,134399,17121,1997
IN,solid waste management,1659,3277561,1548,244,3132534,145027,18797,1997
IN,sewerage,2810,6693730,2731,295,6554654,139076,15106,1997
IN,parks and recreation,3189,5955188,2449,1847,5004206,950982,129288,1997
IN,housing and community development,1703,3719322,1545,341,3504033,215289,27603,1997
IN,natural resources,4182,8144049,2902,2219,6253750,1890299,215253,1997
IN,water transport and terminals,2088,4769714,2042,194,4685469,84245,10012,1997
IN,electric power,909,2499602,902,14,2493453,6149,881,1997
IN,gas supply,1028,3148440,998,45,3080988,67452,5431,1997
IN,transit,1259,2684756,1200,110,2582084,102672,10155,1997
IN,education - elementary and secondary instructional,84823,246526111,78307,14488,236652417,9873694,1092838,1997
IN,education - elementary and secondary other,41603,71940508,32631,18980,58197422,13743086,1502081,1997
IN,education - higher education instructional,17174,73934297,11912,11249,53750610,20183687,927717,1997
IN,education - higher education other,30497,60655835,22203,21197,46856937,13798898,1462700,1997
IN,education - other,1159,2997086,1136,42,2939210,57876,3914,1997
IN,libraries,4183,7291759,2763,3246,5507202,1784557,243635,1997
IN,liquor stores,0,0,0,0,0,0,0,1997
IN,other and unallocable,6075,12604210,5677,1766,11950975,653235,75178,1997
IA,total,168531,425676621,135592,71994,362292042,63384579,5833016,1997
IA,financial administration,3814,8795859,3570,564,8409059,386800,45468,1997
IA,other government administration,2836,7002390,2334,4007,5953604,1048786,102243,1997
IA,judicial and legal,2996,9229401,2728,439,8616732,612669,47087,1997
IA,police protection - officers,4866,14436997,4787,379,14297267,139730,16579,1997
IA,police protection - other,1654,3578984,1469,500,3311397,267587,32611,1997
IA,fire protection - firefighters,1660,5006990,1562,1794,4857168,149822,19343,1997
IA,fire protection - other,62,144907,49,85,126856,18051,2085,1997
IA,corrections,3280,8991063,3098,365,8641902,349161,31526,1997
IA,streets and highways,8279,20558148,8186,340,20387313,170835,19646,1997
IA,air transportation,171,452884,158,25,434010,18874,2151,1997
IA,water transport and terminals,0,0,0,0,0,0,0,1997
IA,public welfare,4613,11385154,4300,655,10831309,553845,54683,1997
IA,health,2383,5136467,1899,1001,4347750,788717,85290,1997
IA,hospitals,16065,40161423,12304,5522,31963234,8198189,662360,1997
IA,social insurance administration,414,1305647,407,14,1285668,19979,1240,1997
IA,solid waste management,871,1956060,764,277,1801259,154801,20667,1997
IA,sewerage,1240,3221771,1207,223,3141714,80057,9207,1997
IA,parks and recreation,1752,3872167,1314,1684,3326678,545489,77112,1997
IA,housing and community development,536,1370606,480,88,1293868,76738,9352,1997
IA,natural resources,3149,8763014,2355,1478,6774452,1988562,140600,1997
IA,water transport and terminals,1321,3446431,1271,294,3328439,117992,13411,1997
IA,electric power,775,2421859,754,42,2399406,22453,3576,1997
IA,gas supply,60,163699,58,3,161988,1711,239,1997
IA,transit,755,1587145,494,394,1200672,386473,45965,1997
IA,education - elementary and secondary instructional,46507,116290291,42151,11489,109594199,6696092,760027,1997
IA,education - elementary and secondary other,18934,32067805,13088,13337,23810185,8257620,1021469,1997
IA,education - higher education instructional,9723,40610337,5940,6161,30084104,10526233,667770,1997
IA,education - higher education other,22294,55004138,12588,16943,35031637,19972501,1716652,1997
IA,education - other,1177,3246364,1134,70,3155197,91167,7467,1997
IA,libraries,1365,2476330,737,1612,1659876,816454,112511,1997
IA,liquor stores,0,0,0,0,0,0,0,1997
IA,other and unallocable,4979,12992290,4406,2209,12065099,927191,104679,1997
KS,total,162776,378889635,142298,63667,345668185,33221450,3640376,1997
KS,financial administration,5195,10869861,5059,1269,10590981,278880,30007,1997
KS,other government administration,3032,7111969,2600,4345,6147044,964925,89390,1997
KS,judicial and legal,3347,8691829,3101,929,8167818,524011,47810,1997
KS,police protection - officers,5651,16188132,5550,344,16041257,146875,19117,1997
KS,police protection - other,2239,4628185,2099,533,4419246,208939,25442,1997
KS,fire protection - firefighters,2416,7330791,2271,2293,7122836,207955,28432,1997
KS,fire protection - other,108,257898,102,41,251611,6287,1066,1997
KS,corrections,5346,13421309,5252,220,13293240,128069,16743,1997
KS,streets and highways,8891,19712242,8686,701,19345989,366253,44065,1997
KS,air transportation,211,508471,206,12,503574,4897,689,1997
KS,water transport and terminals,10,28377,10,0,28377,0,0,1997
KS,public welfare,2460,5365132,2296,351,5061071,304061,29619,1997
KS,health,4007,9503256,3512,1569,8773327,729929,86721,1997
KS,hospitals,11799,26747817,10407,2786,23802635,2945182,245420,1997
KS,social insurance administration,109,242321,103,15,232161,10160,1088,1997
KS,solid waste management,913,1740633,867,133,1669282,71351,9122,1997
KS,sewerage,1114,2720537,1090,130,2671751,48786,5707,1997
KS,parks and recreation,2383,4771086,1877,1701,4176689,594397,89108,1997
KS,housing and community development,677,1350053,583,334,1192741,157312,18456,1997
KS,natural resources,1942,5037841,1620,710,4383999,653842,57818,1997
KS,water transport and terminals,1897,4841804,1752,556,4564048,277756,28741,1997
KS,electric power,1273,3314220,1269,14,3306970,7250,987,1997
KS,gas supply,47,114726,47,0,114726,0,0,1997
KS,transit,215,426992,207,21,416142,10850,1519,1997
KS,education - elementary and secondary instructional,47234,116430276,43375,10433,110404911,6025365,662441,1997
KS,education - elementary and secondary other,19862,31823424,16048,9593,26518496,5304928,660917,1997
KS,education - higher education instructional,7124,27648591,5375,5861,22291074,5357517,308006,1997
KS,education - higher education other,16648,33223169,11158,15252,26528896,6694273,971142,1997
KS,education - other,709,1693812,649,110,1624977,68835,10870,1997
KS,libraries,796,1472167,568,507,1168749,303418,41572,1997
KS,liquor stores,0,0,0,0,0,0,0,1997
KS,other and unallocable,5121,11672714,4559,2904,10853567,819147,108361,1997
KY,total,206356,469016388,187030,46270,440095257,28921131,3269872,1997
KY,financial administration,4985,11077197,4841,381,10845653,231544,24443,1997
KY,other government administration,3484,8155855,3245,1612,7451379,704476,44622,1997
KY,judicial and legal,4957,12333543,4376,961,11243237,1090306,97113,1997
KY,police protection - officers,6054,15626051,5845,340,15281064,344987,35802,1997
KY,police protection - other,2221,4340326,2017,482,4070686,269640,36015,1997
KY,fire protection - firefighters,2855,6249537,2732,680,6084772,164765,22502,1997
KY,fire protection - other,162,340695,149,41,322516,18179,2441,1997
KY,corrections,7183,14748544,6926,491,14273845,474699,43909,1997
KY,streets and highways,8450,18322847,8339,170,18127696,195151,19119,1997
KY,air transportation,328,754602,311,22,733578,21024,2960,1997
KY,water transport and terminals,35,77543,34,2,76671,872,168,1997
KY,public welfare,5346,11940674,5131,371,11595249,345425,36401,1997
KY,health,5834,14221812,5481,758,13659510,562302,61287,1997
KY,hospitals,9611,20912964,8455,1767,18682202,2230762,201769,1997
KY,social insurance administration,1272,3178414,1235,47,3107056,71358,6126,1997
KY,solid waste management,1489,2312595,1441,112,2257380,55215,8272,1997
KY,sewerage,1539,4516978,1521,26,4492265,24713,2705,1997
KY,parks and recreation,2720,4312372,2371,509,3885851,426521,58689,1997
KY,housing and community development,876,1961467,843,67,1919176,42291,5743,1997
KY,natural resources,3706,8640789,3255,994,7915282,725507,75771,1997
KY,water transport and terminals,2586,5937996,2489,295,5783548,154448,17598,1997
KY,electric power,604,1835431,596,26,1824503,10928,1528,1997
KY,gas supply,133,234477,131,5,231785,2692,405,1997
KY,transit,869,2325849,821,84,2247321,78528,8469,1997
KY,education - elementary and secondary instructional,63381,157197217,61118,5335,153953192,3244025,371668,1997
KY,education - elementary and secondary other,29035,39260942,24856,8777,34656976,4603966,679331,1997
KY,education - higher education instructional,8469,37219428,6627,4852,32155954,5063474,316278,1997
KY,education - higher education other,16980,34080887,11726,13957,28179238,5901649,905913,1997
KY,education - other,4010,11007138,3602,1061,10100396,906742,67612,1997
KY,libraries,1175,1832684,873,696,1510326,322358,52160,1997
KY,liquor stores,0,0,0,0,0,0,0,1997
KY,other and unallocable,6007,14059534,5643,1349,13426950,632584,63053,1997
LA,total,264467,574702714,246331,48821,542811434,31891280,3145934,1997
LA,financial administration,5753,11561461,5649,232,11420495,140966,18948,1997
LA,other government administration,4595,10409692,4154,1553,9434795,974897,81099,1997
LA,judicial and legal,5694,13066412,5447,770,12602287,464125,43600,1997
LA,police protection - officers,9677,23583529,9523,567,23379329,204200,28856,1997
LA,police protection - other,3207,5936608,2881,949,5557308,379300,55109,1997
LA,fire protection - firefighters,4091,10055425,4069,217,10024748,30677,4516,1997
LA,fire protection - other,189,406402,179,16,396528,9874,1592,1997
LA,corrections,11073,22867558,10842,353,22561032,306526,38658,1997
LA,streets and highways,10587,20364631,10412,259,20176874,187757,30117,1997
LA,air transportation,452,896695,426,40,868713,27982,4274,1997
LA,water transport and terminals,818,1894908,809,27,1874738,20170,1767,1997
LA,public welfare,6442,14592764,6394,88,14542898,49866,7680,1997
LA,health,6887,17673063,6601,547,17131531,541532,49146,1997
LA,hospitals,33673,74506911,29941,5965,66567782,7939129,655880,1997
LA,social insurance administration,1003,2554588,982,64,2514860,39728,3664,1997
LA,solid waste management,1474,2061501,1419,114,1995102,66399,9518,1997
LA,sewerage,2101,4327312,2070,58,4286389,40923,5631,1997
LA,parks and recreation,4472,7093247,3272,2374,5554733,1538514,208053,1997
LA,housing and community development,1352,2480917,1328,53,2451179,29738,4244,1997
LA,natural resources,5581,12262080,5104,1037,11677201,584879,84099,1997
LA,water transport and terminals,2825,5395764,2803,81,5361005,34759,4778,1997
LA,electric power,607,1423410,591,24,1404260,19150,3032,1997
LA,gas supply,274,518716,269,6,513972,4744,723,1997
LA,transit,341,863054,321,28,827761,35293,3556,1997
LA,education - elementary and secondary instructional,69162,150115970,67236,7075,147700130,2415840,322691,1997
LA,education - elementary and secondary other,31543,41245305,29206,5272,38834729,2410576,382590,1997
LA,education - higher education instructional,10006,54248811,8206,4940,47270105,6978706,318433,1997
LA,education - higher education other,18202,37522989,14749,13899,32456570,5066419,609367,1997
LA,education - other,3851,9440815,3675,520,9010346,430469,31417,1997
LA,libraries,1771,2702236,1466,660,2348455,353781,52653,1997
LA,liquor stores,0,0,0,0,0,0,0,1997
LA,other and unallocable,6764,12629940,6307,1033,12065579,564361,80243,1997
ME,total,66387,158749560,58356,25233,145506549,13243011,1386806,1997
ME,financial administration,2169,4934032,1986,750,4629395,304637,32519,1997
ME,other government administration,1399,3461732,1151,1270,2947464,514268,43475,1997
ME,judicial and legal,797,2279742,743,114,2180025,99717,9059,1997
ME,police protection - officers,2235,6184861,2112,372,6026187,158674,21917,1997
ME,police protection - other,565,1087744,474,336,967066,120678,16377,1997
ME,fire protection - firefighters,1282,3429084,1075,2102,3150773,278311,38076,1997
ME,fire protection - other,78,164129,63,99,145537,18592,2633,1997
ME,corrections,1759,4074329,1644,198,3940675,133654,16546,1997
ME,streets and highways,4476,10787505,4131,655,10178207,609298,60796,1997
ME,air transportation,295,622127,211,88,492993,129134,14997,1997
ME,water transport and terminals,181,374664,134,95,309772,64892,8210,1997
ME,public welfare,2771,6486544,2591,280,6113499,373045,32186,1997
ME,health,1389,3788743,1269,421,3546349,242394,21515,1997
ME,hospitals,1217,3133423,1058,338,2777059,356364,27404,1997
ME,social insurance administration,531,1267282,526,9,1255114,12168,934,1997
ME,solid waste management,491,998801,379,311,856600,142201,21060,1997
ME,sewerage,636,1559319,604,81,1506168,53151,5741,1997
ME,parks and recreation,715,1353208,428,765,953155,400053,50691,1997
ME,housing and community development,420,965293,386,60,921829,43464,5764,1997
ME,natural resources,1301,3429649,1209,241,3253570,176079,16271,1997
ME,water transport and terminals,694,1748720,664,119,1701085,47635,4976,1997
ME,electric power,19,53511,19,3,52931,580,78,1997
ME,gas supply,0,0,0,0,0,0,0,1997
ME,transit,101,299346,72,30,226285,73061,3646,1997
ME,education - elementary and secondary instructional,23646,58663800,21664,5621,55208918,3454882,332145,1997
ME,education - elementary and secondary other,8369,14724125,6785,3446,12370565,2353560,266827,1997
ME,education - higher education instructional,1170,4673679,1058,295,4353807,319872,19754,1997
ME,education - higher education other,4223,9711338,2934,5073,7690385,2020953,228042,1997
ME,education - other,938,2388585,832,399,2196274,192311,18939,1997
ME,libraries,327,621812,202,349,439090,182722,23072,1997
ME,liquor stores,130,290612,123,17,279504,11108,1198,1997
ME,other and unallocable,2063,5191821,1829,1296,4836268,355553,41958,1997
MD,total,251703,757725869,219895,67004,684992879,72732990,5553673,1997
MD,financial administration,6064,17999526,5836,333,17519848,479678,40454,1997
MD,other government administration,4481,13011850,3777,1430,11181773,1830077,125754,1997
MD,judicial and legal,6397,19174850,5843,765,17981129,1193721,97316,1997
MD,police protection - officers,12922,44790799,12817,243,44543664,247135,18280,1997
MD,police protection - other,3369,8609733,2941,1169,7914156,695577,73129,1997
MD,fire protection - firefighters,5554,21475594,5487,146,21380834,94760,10790,1997
MD,fire protection - other,343,1008382,317,215,946848,61534,4585,1997
MD,corrections,13250,36680321,12700,631,35534155,1146166,97047,1997
MD,streets and highways,9644,26023917,9593,135,25926647,97270,9210,1997
MD,air transportation,465,1398393,460,11,1390388,8005,884,1997
MD,water transport and terminals,599,1366757,599,1,1366549,208,31,1997
MD,public welfare,9633,21734525,7992,2110,18632692,3101833,289250,1997
MD,health,9463,26048968,7846,2329,22340900,3708068,284853,1997
MD,hospitals,6050,15026262,5766,567,14483306,542956,50220,1997
MD,social insurance administration,894,2287321,732,196,1959244,328077,28665,1997
MD,solid waste management,2182,4631649,2122,111,4546266,85383,10674,1997
MD,sewerage,3986,11741211,3965,44,11683803,57408,4021,1997
MD,parks and recreation,6716,13445547,5531,3210,11887623,1557924,206909,1997
MD,housing and community development,2825,6984778,2691,180,6671983,312795,23297,1997
MD,natural resources,2367,7007793,2083,445,6361738,646055,50438,1997
MD,water transport and terminals,2102,6071304,2091,22,6048367,22937,1963,1997
MD,electric power,79,234391,78,1,233727,664,133,1997
MD,gas supply,11,26702,11,0,26702,0,0,1997
MD,transit,3004,9711947,2754,366,9208298,503649,43851,1997
MD,education - elementary and secondary instructional,67181,243015614,60698,13870,227731910,15283704,1128038,1997
MD,education - elementary and secondary other,28861,65038597,23091,9443,55544372,9494225,998547,1997
MD,education - higher education instructional,9566,42615750,6226,10543,29103958,13511792,579675,1997
MD,education - higher education other,16774,45205426,11020,14745,31638606,13566820,1006573,1997
MD,education - other,1993,6001564,1847,253,5602714,398850,25768,1997
MD,libraries,2733,6277877,2025,1542,5063746,1214131,124997,1997
MD,liquor stores,0,0,0,0,0,0,0,1997
MD,other and unallocable,12195,33078521,10956,1948,30536933,2541588,218321,1997
MA,total,303665,912770125,273396,77428,852581115,60189010,5088393,1997
MA,financial administration,9184,27388394,8618,1453,26059913,1328481,96817,1997
MA,other government administration,5679,15780071,4990,1871,13580070,2200001,118082,1997
MA,judicial and legal,6805,21360180,6712,315,21072421,287759,16362,1997
MA,police protection - officers,15440,59600425,15057,1399,58731532,868893,64632,1997
MA,police protection - other,3414,7526233,2746,1935,6392457,1133776,111599,1997
MA,fire protection - firefighters,11843,41290991,11397,3090,40640229,650762,77703,1997
MA,fire protection - other,520,1409886,458,214,1278721,131165,11229,1997
MA,corrections,11401,36408140,11135,539,35781910,626230,46791,1997
MA,streets and highways,10489,33033045,10274,454,32487105,545940,38495,1997
MA,air transportation,1160,4561614,1137,43,4480957,80657,4129,1997
MA,water transport and terminals,150,522213,137,30,491395,30818,2285,1997
MA,public welfare,9429,27078829,8617,1552,25183571,1895258,140602,1997
MA,health,7899,25776211,6311,3344,21385295,4390916,278791,1997
MA,hospitals,23389,60852951,21326,3622,54531932,6321019,359998,1997
MA,social insurance administration,2026,5987579,1892,273,5651152,336427,23231,1997
MA,solid waste management,1311,3040205,1189,302,2838058,202147,22025,1997
MA,sewerage,3142,9168914,3056,221,8979222,189692,14823,1997
MA,parks and recreation,3054,7377311,2348,1778,6207594,1169717,113949,1997
MA,housing and community development,4206,11655074,3948,610,11178385,476689,44696,1997
MA,natural resources,1679,5579247,1577,203,5299463,279784,17604,1997
MA,water transport and terminals,3893,11079917,3793,373,10893472,186445,16730,1997
MA,electric power,1274,5026154,1256,52,4982125,44029,3206,1997
MA,gas supply,172,693993,171,1,692465,1528,102,1997
MA,transit,6003,22429850,5616,641,21260772,1169078,68235,1997
MA,education - elementary and secondary instructional,95782,307663891,89760,13089,296855647,10808244,982946,1997
MA,education - elementary and secondary other,29802,60173851,24097,13818,52458848,7715003,946341,1997
MA,education - higher education instructional,8379,32448675,5490,7741,24484414,7964261,481427,1997
MA,education - higher education other,13580,33220064,9564,13441,27480323,5739741,671516,1997
MA,education - other,729,2366884,675,107,2205497,161387,8915,1997
MA,libraries,3461,7869034,2442,2657,6182372,1686662,174656,1997
MA,liquor stores,0,0,0,0,0,0,0,1997
MA,other and unallocable,8370,24400299,7607,2260,22833798,1566501,130476,1997
MI,total,470613,1478401059,391148,207154,1310192287,168208772,13722977,1997
MI,financial administration,9563,28285953,8197,3717,24680638,3605315,257301,1997
MI,other government administration,9135,25166906,7842,10111,22009067,3157839,239609,1997
MI,judicial and legal,11798,36689733,11365,951,35714162,975571,76648,1997
MI,police protection - officers,19354,69338846,19015,1106,68779779,559067,59677,1997
MI,police protection - other,4882,11226967,4109,2373,10114835,1112132,138952,1997
MI,fire protection - firefighters,7098,23893153,5776,9169,21707505,2185648,233006,1997
MI,fire protection - other,776,2024189,682,446,1904921,119268,15614,1997
MI,corrections,21641,69857604,21105,1054,68579273,1278331,93141,1997
MI,streets and highways,12325,38969511,12055,637,38414213,555298,48641,1997
MI,air transportation,887,2844926,845,132,2774891,70035,7683,1997
MI,water transport and terminals,40,128558,39,1,127208,1350,140,1997
MI,public welfare,15718,47651373,14859,1682,46172629,1478744,148195,1997
MI,health,11317,32822836,10023,3032,30092101,2730735,226155,1997
MI,hospitals,22057,74236795,17175,7183,53139366,21097429,857131,1997
MI,social insurance administration,2116,6697895,2037,129,6470240,227655,13981,1997
MI,solid waste management,2323,6436893,2198,338,6212646,224247,22956,1997
MI,sewerage,4358,13496875,4279,242,13355339,141536,14568,1997
MI,parks and recreation,5508,12714090,3487,5528,9903935,2810155,353838,1997
MI,housing and community development,1672,5040524,1384,560,4028267,1012257,50230,1997
MI,natural resources,5284,16800884,4685,1255,15781548,1019336,105204,1997
MI,water transport and terminals,4463,13341485,4375,234,13190508,150977,15350,1997
MI,electric power,1565,6424374,1562,9,6419125,5249,506,1997
MI,gas supply,0,0,0,0,0,0,0,1997
MI,transit,4668,11248483,4321,587,10683966,564517,60710,1997
MI,education - elementary and secondary instructional,127058,471183543,114864,29311,447072079,24111464,2030681,1997
MI,education - elementary and secondary other,69132,157232159,50063,39798,127027302,30204857,3181417,1997
MI,education - higher education instructional,24698,123651758,16055,20884,89290248,34361510,1517301,1997
MI,education - higher education other,50972,114301400,31964,47809,85434380,28867020,3348754,1997
MI,education - other,541,2049012,518,64,1969315,79697,4054,1997
MI,libraries,3884,8119709,2282,3994,5905112,2214597,278585,1997
MI,liquor stores,0,0,0,0,0,0,0,1997
MI,other and unallocable,15780,46524625,13987,14818,43237689,3286936,322949,1997
MN,total,260244,750311909,208839,125886,649252848,101059061,9088453,1997
MN,financial administration,7114,21781524,6694,2078,20755769,1025755,82144,1997
MN,other government administration,5459,16188152,4620,9506,13659986,2528166,171256,1997
MN,judicial and legal,5437,19014070,4813,1057,17133186,1880884,110926,1997
MN,police protection - officers,7671,29345552,7509,546,29031791,313761,30609,1997
MN,police protection - other,2561,6499674,2219,734,5883788,615886,61009,1997
MN,fire protection - firefighters,2082,7698025,1698,4509,7155532,542493,71783,1997
MN,fire protection - other,130,421994,107,113,371898,50096,4106,1997
MN,corrections,7388,22821545,6932,977,21814047,1007498,80561,1997
MN,streets and highways,11868,38276529,11390,1210,37303514,973015,90759,1997
MN,air transportation,519,1950547,496,37,1911531,39016,4004,1997
MN,water transport and terminals,49,188307,49,1,187942,365,24,1997
MN,public welfare,12827,34478995,11013,2901,30860082,3618913,320075,1997
MN,health,5703,16310266,4292,2688,13249085,3061181,247770,1997
MN,hospitals,15161,42367746,10110,8530,29528875,12838871,891152,1997
MN,social insurance administration,1213,3998332,1211,3,3993691,4641,275,1997
MN,solid waste management,991,2669828,915,200,2534922,134906,13783,1997
MN,sewerage,2144,7234791,2044,430,7027269,207522,19657,1997
MN,parks and recreation,4658,12064201,3263,5706,9931279,2132922,246915,1997
MN,housing and community development,2083,6155301,1823,575,5636380,518921,44516,1997
MN,natural resources,3674,10893827,3249,935,10071815,822012,75346,1997
MN,water transport and terminals,1531,4782179,1464,227,4608347,173832,14752,1997
MN,electric power,836,2864408,806,75,2808207,56201,5439,1997
MN,gas supply,145,474000,144,1,472979,1021,144,1997
MN,transit,2384,7668485,2168,465,7216991,451494,37866,1997
MN,education - elementary and secondary instructional,76803,228357566,65924,22952,207919827,20437739,1893994,1997
MN,education - elementary and secondary other,29733,60627815,21201,20416,46922195,13705620,1482715,1997
MN,education - higher education instructional,11693,50772332,8058,8979,40123767,10648565,643607,1997
MN,education - higher education other,25846,59217045,14346,19938,39814425,19402620,2035330,1997
MN,education - other,1583,5449306,1473,138,5218491,230815,19218,1997
MN,libraries,2250,5299029,1445,2063,3822511,1476518,140663,1997
MN,liquor stores,0,0,0,0,0,0,0,1997
MN,other and unallocable,8708,24440538,7363,7896,22282726,2157812,248055,1997
MS,total,173591,341379797,161440,35069,322048350,19331447,2145672,1997
MS,financial administration,3847,7450681,3777,232,7318066,132615,13469,1997
MS,other government administration,2416,5283762,2264,1186,4838060,445702,29061,1997
MS,judicial and legal,2853,6281223,2690,648,5896951,384272,30615,1997
MS,police protection - officers,5824,12270705,5620,592,12017641,253064,37100,1997
MS,police protection - other,2249,3522420,2044,663,3254066,268354,38126,1997
MS,fire protection - firefighters,3068,6607949,2987,496,6505566,102383,14914,1997
MS,fire protection - other,96,180861,87,57,169852,11009,1730,1997
MS,corrections,5452,9378579,5356,178,9256389,122190,16695,1997
MS,streets and highways,8978,14948208,8804,382,14728954,219254,31384,1997
MS,air transportation,144,250566,126,39,233519,17047,2865,1997
MS,water transport and terminals,131,263458,126,16,258947,4511,713,1997
MS,public welfare,3749,6651406,3711,99,6602886,48520,7225,1997
MS,health,3474,7822782,3347,272,7562815,259967,22623,1997
MS,hospitals,27080,56958372,24822,4173,52126598,4831774,399524,1997
MS,social insurance administration,1080,2423770,847,240,2015848,407922,41280,1997
MS,solid waste management,1073,1494152,1029,124,1442788,51364,8081,1997
MS,sewerage,712,1224793,676,60,1181261,43532,6717,1997
MS,parks and recreation,1301,1879003,1023,948,1591391,287612,49076,1997
MS,housing and community development,889,1695014,837,115,1625617,69397,9505,1997
MS,natural resources,4200,8877160,3772,1022,8335780,541380,75539,1997
MS,water transport and terminals,1288,2248970,1229,128,2176134,72836,10575,1997
MS,electric power,531,1143169,519,24,1127729,15440,2092,1997
MS,gas supply,256,489635,251,9,481429,8206,1016,1997
MS,transit,127,187856,123,14,183529,4327,648,1997
MS,education - elementary and secondary instructional,45435,87764730,44604,3149,86607723,1157007,143819,1997
MS,education - elementary and secondary other,17333,20445060,14812,6800,17653114,2791946,439546,1997
MS,education - higher education instructional,9511,33278847,8175,4387,30077634,3201213,232372,1997
MS,education - higher education other,12311,24516198,10112,7264,21573937,2942261,386994,1997
MS,education - other,1794,4274671,1760,57,4229110,45561,5912,1997
MS,libraries,862,1240777,651,618,1015695,225082,38089,1997
MS,liquor stores,123,227121,123,0,227121,0,0,1997
MS,other and unallocable,5404,10097899,5136,1077,9732200,365699,48367,1997
MO,total,290454,664929183,264601,78348,623490660,41438523,4526188,1997
MO,financial administration,6517,13052779,6367,685,12756552,296227,29729,1997
MO,other government administration,4471,9842694,4076,3044,8797388,1045306,77198,1997
MO,judicial and legal,6721,16886084,6409,964,16339739,546345,57425,1997
MO,police protection - officers,11806,33265662,11656,545,33044681,220981,28380,1997
MO,police protection - other,4878,10073434,4664,686,9787371,286063,38707,1997
MO,fire protection - firefighters,5370,16860776,5133,2205,16516355,344421,43929,1997
MO,fire protection - other,322,933519,293,193,884450,49069,5721,1997
MO,corrections,11518,22135103,11283,960,21866256,268847,40392,1997
MO,streets and highways,13541,31266602,13152,1023,30629260,637342,75613,1997
MO,air transportation,1191,3000963,1163,51,2958781,42182,5086,1997
MO,water transport and terminals,2,6434,2,0,6434,0,0,1997
MO,public welfare,9988,17555929,9406,1173,16710657,845272,101792,1997
MO,health,8375,17483786,7574,2058,16200727,1283059,141212,1997
MO,hospitals,21752,45017284,19976,3941,40980127,4037157,312365,1997
MO,social insurance administration,1248,2879995,1238,14,2862159,17836,1734,1997
MO,solid waste management,892,1764802,781,170,1589348,175454,20119,1997
MO,sewerage,2617,6764959,2534,221,6617866,147093,16619,1997
MO,parks and recreation,4067,7856620,3099,2701,6637439,1219181,171509,1997
MO,housing and community development,1719,3582442,1624,232,3446219,136223,16637,1997
MO,natural resources,2999,6628792,2621,839,6093081,535711,67147,1997
MO,water transport and terminals,3124,6988158,2982,540,6760153,228005,28408,1997
MO,electric power,1260,3731311,1248,27,3709880,21431,2018,1997
MO,gas supply,138,394697,137,1,394023,674,104,1997
MO,transit,2780,7105736,2584,311,6741799,363937,34687,1997
MO,education - elementary and secondary instructional,82258,209461284,78128,12212,202507647,6953637,696037,1997
MO,education - elementary and secondary other,34832,57089709,29676,12070,49775655,7314054,880728,1997
MO,education - higher education instructional,11648,42318322,8931,9260,35815019,6503303,477310,1997
MO,education - higher education other,20862,42053632,15654,17682,36242477,5811155,915764,1997
MO,education - other,2125,4742052,2055,274,4589164,152888,12346,1997
MO,libraries,2728,4680376,1949,2207,3570825,1109551,138189,1997
MO,liquor stores,0,0,0,0,0,0,0,1997
MO,other and unallocable,8705,19505247,8206,2059,18659128,846119,89283,1997
MT,total,50924,114425018,42071,24325,100484538,13940480,1555674,1997
MT,financial administration,1646,3290198,1537,204,3121085,169113,19710,1997
MT,other government administration,1171,2726550,1003,804,2215869,510681,31481,1997
MT,judicial and legal,921,2410469,748,453,1847474,562995,30792,1997
MT,police protection - officers,1516,3980514,1494,106,3945513,35001,4430,1997
MT,police protection - other,681,1315270,624,170,1223011,92259,10246,1997
MT,fire protection - firefighters,510,1534929,498,439,1516340,18589,2717,1997
MT,fire protection - other,85,168874,79,36,162434,6440,1046,1997
MT,corrections,1280,2764657,1192,186,2622386,142271,15516,1997
MT,streets and highways,3135,7429012,3047,162,7277024,151988,15780,1997
MT,air transportation,104,272309,100,27,263435,8874,1110,1997
MT,water transport and terminals,0,0,0,0,0,0,0,1997
MT,public welfare,1983,4180261,1695,501,3738630,441631,51425,1997
MT,health,1044,2289093,814,556,1845171,443922,40657,1997
MT,hospitals,2037,3989464,1695,656,3482993,506471,60351,1997
MT,social insurance administration,700,1609826,674,43,1560385,49441,4617,1997
MT,solid waste management,542,1145932,504,155,1090395,55537,7512,1997
MT,sewerage,313,716518,293,82,683858,32660,4237,1997
MT,parks and recreation,417,851693,318,481,709079,142614,17731,1997
MT,housing and community development,227,466559,197,45,419707,46852,5045,1997
MT,natural resources,1527,3492016,1275,582,3052607,439409,44894,1997
MT,water transport and terminals,407,916445,386,148,866658,49787,5286,1997
MT,electric power,0,0,0,0,0,0,0,1997
MT,gas supply,0,0,0,0,0,0,0,1997
MT,transit,147,279961,137,22,267284,12677,1941,1997
MT,education - elementary and secondary instructional,15361,36546157,13173,5710,33173860,3372297,373608,1997
MT,education - elementary and secondary other,5338,9043100,3606,4651,6745720,2297380,300318,1997
MT,education - higher education instructional,2406,8614398,1732,1400,7097311,1517087,119277,1997
MT,education - higher education other,4339,7396700,2746,5039,5615970,1780730,281755,1997
MT,education - other,834,2095786,674,503,1696594,399192,28428,1997
MT,libraries,283,464362,160,290,291789,172573,21417,1997
MT,liquor stores,74,218267,73,2,215927,2340,175,1997
MT,other and unallocable,1896,4215698,1597,872,3736029,479669,54172,1997
NE,total,105101,245103770,92439,34635,225822867,19280903,2268958,1997
NE,financial administration,2178,4407773,2057,439,4207740,200033,23536,1997
NE,other government administration,2052,4463127,1857,2108,3994804,468323,40588,1997
NE,judicial and legal,1698,4882626,1604,258,4699795,182831,17299,1997
NE,police protection - officers,3102,9306432,3069,150,9244683,61749,7484,1997
NE,police protection - other,1065,2168553,974,186,2050812,117741,15758,1997
NE,fire protection - firefighters,1146,4292259,1127,220,4269272,22987,3709,1997
NE,fire protection - other,54,136758,52,72,129457,7301,905,1997
NE,corrections,2961,6329779,2882,193,6202002,127777,14317,1997
NE,streets and highways,5214,11412033,5104,364,11198823,213210,23155,1997
NE,air transportation,251,670999,228,71,626685,44314,4255,1997
NE,water transport and terminals,0,0,0,0,0,0,0,1997
NE,public welfare,3580,7124106,3380,439,6888290,235816,36162,1997
NE,health,1180,3020397,1062,315,2801652,218745,21179,1997
NE,hospitals,8780,17888453,7334,2216,15314992,2573461,252492,1997
NE,social insurance administration,466,1193403,457,16,1175644,17759,1577,1997
NE,solid waste management,254,542496,231,110,498101,44395,5821,1997
NE,sewerage,647,1675277,625,129,1614548,60729,6456,1997
NE,parks and recreation,1604,2783316,988,1116,2153467,629849,109307,1997
NE,housing and community development,706,1437600,585,306,1294792,142808,19488,1997
NE,natural resources,2447,4590934,2068,967,4118845,472089,68241,1997
NE,water transport and terminals,867,2314187,828,206,2232805,81382,9991,1997
NE,electric power,6602,23612223,6427,323,23297869,314354,31352,1997
NE,gas supply,525,1718964,525,0,1718964,0,0,1997
NE,transit,389,986916,377,32,968067,18849,2119,1997
NE,education - elementary and secondary instructional,29624,72534920,27111,6619,68672427,3862493,443034,1997
NE,education - elementary and secondary other,10077,16553434,7714,6087,13365406,3188028,426102,1997
NE,education - higher education instructional,4075,12671146,3271,2264,10733232,1937914,142787,1997
NE,education - higher education other,8657,15437310,6293,6964,12371645,3065665,418566,1997
NE,education - other,676,1870761,656,52,1829289,41472,3438,1997
NE,libraries,654,1168315,368,691,820361,347954,50464,1997
NE,liquor stores,0,0,0,0,0,0,0,1997
NE,other and unallocable,3570,7909273,3185,1722,7328398,580875,69376,1997
NV,total,79577,242104222,69607,21405,221656965,20447257,1725914,1997
NV,financial administration,2197,6626472,2148,83,6527140,99332,8512,1997
NV,other government administration,2465,8273747,2379,276,8098697,175050,15058,1997
NV,judicial and legal,2973,10747569,2825,331,10458016,289553,26534,1997
NV,police protection - officers,3518,14625437,3479,89,14562394,63043,7073,1997
NV,police protection - other,1664,4865050,1529,381,4661564,203486,23206,1997
NV,fire protection - firefighters,1761,8138839,1729,751,8078612,60227,5929,1997
NV,fire protection - other,159,583751,143,44,554568,29183,2980,1997
NV,corrections,4395,14218205,4328,126,14022109,196096,12012,1997
NV,streets and highways,2903,9495767,2877,49,9438614,57153,4613,1997
NV,air transportation,946,2805173,931,22,2777810,27363,2544,1997
NV,water transport and terminals,0,0,0,0,0,0,0,1997
NV,public welfare,1473,4009251,1413,114,3899682,109569,10810,1997
NV,health,1111,3491416,1048,166,3328235,163181,11336,1997
NV,hospitals,6155,19487370,5353,1324,16933248,2554122,141821,1997
NV,social insurance administration,1423,4289137,1412,18,4259679,29458,1997,1997
NV,solid waste management,52,132330,52,1,132022,308,28,1997
NV,sewerage,795,2721647,784,22,2700941,20706,1777,1997
NV,parks and recreation,2374,6077518,1622,2356,4936728,1140790,131375,1997
NV,housing and community development,518,1514585,509,23,1499873,14712,1542,1997
NV,natural resources,1107,2967938,902,394,2626191,341747,36183,1997
NV,water transport and terminals,1292,4646144,1271,42,4603777,42367,3594,1997
NV,electric power,78,288660,77,4,284839,3821,283,1997
NV,gas supply,0,0,0,0,0,0,0,1997
NV,transit,123,409758,119,11,403163,6595,802,1997
NV,education - elementary and secondary instructional,20568,60386650,18073,5866,54887004,5499646,421205,1997
NV,education - elementary and secondary other,7880,17819803,6125,3324,14637546,3182257,294345,1997
NV,education - higher education instructional,2396,10836434,1606,1447,8234090,2602344,139900,1997
NV,education - higher education other,4842,9649677,2980,3234,7037233,2612444,329580,1997
NV,education - other,97,334854,74,24,254767,80087,3985,1997
NV,libraries,736,1653913,520,406,1239896,414017,38103,1997
NV,liquor stores,0,0,0,0,0,0,0,1997
NV,other and unallocable,3576,11007127,3299,477,10578527,428600,48787,1997
NH,total,55859,142689855,48120,22410,129120697,13569158,1327932,1997
NH,financial administration,1310,3153006,1158,462,2886168,266838,27043,1997
NH,other government administration,1012,2635723,837,708,2310550,325173,30320,1997
NH,judicial and legal,1105,3137928,1062,91,3057525,80403,7089,1997
NH,police protection - officers,2468,8173048,2289,534,7880541,292507,32116,1997
NH,police protection - other,733,1594413,603,356,1400515,193898,22629,1997
NH,fire protection - firefighters,1374,4298353,1240,1526,4081980,216373,24743,1997
NH,fire protection - other,71,165867,57,61,145819,20048,2111,1997
NH,corrections,1653,4172050,1606,83,4092698,79352,8021,1997
NH,streets and highways,3424,9233024,3234,425,8912008,321016,32702,1997
NH,air transportation,58,168231,54,8,156756,11475,676,1997
NH,water transport and terminals,8,18365,5,6,14424,3941,492,1997
NH,public welfare,3400,7147194,2810,920,6114867,1032327,102142,1997
NH,health,1057,2855761,977,190,2701582,154179,14000,1997
NH,hospitals,1147,2525528,1031,248,2227819,297709,20560,1997
NH,social insurance administration,431,1021447,403,61,969608,51839,4794,1997
NH,solid waste management,618,1389379,502,353,1209302,180077,21585,1997
NH,sewerage,363,1016313,349,60,989715,26598,2429,1997
NH,parks and recreation,581,1097044,287,734,706151,390893,51930,1997
NH,housing and community development,377,878292,337,89,816924,61368,6237,1997
NH,natural resources,491,1104251,433,129,1028005,76246,10135,1997
NH,water transport and terminals,344,924315,309,151,852337,71978,6449,1997
NH,electric power,10,25753,9,3,24240,1513,141,1997
NH,gas supply,0,0,0,0,0,0,0,1997
NH,transit,100,197634,51,85,121600,76034,8643,1997
NH,education - elementary and secondary instructional,19323,53730372,17463,4200,50329894,3400478,308072,1997
NH,education - elementary and secondary other,5410,10091302,4244,2664,8428210,1663092,192689,1997
NH,education - higher education instructional,1888,6735755,1530,1522,5309771,1425984,61516,1997
NH,education - higher education other,3274,6329368,2164,4250,4532304,1797064,196461,1997
NH,education - other,318,806372,304,25,775150,31222,2351,1997
NH,libraries,637,1250489,392,623,893163,357326,44443,1997
NH,liquor stores,453,872747,296,340,695780,176967,27852,1997
NH,other and unallocable,2421,5940531,2084,1503,5455291,485240,57561,1997
NJ,total,421282,1502837208,384692,98179,1431072718,71764490,6041515,1997
NJ,financial administration,10554,32485565,9509,1811,30436690,2048875,168159,1997
NJ,other government administration,7818,24520628,6992,3268,22412136,2108492,142129,1997
NJ,judicial and legal,19747,66315448,19030,1735,64492790,1822658,121552,1997
NJ,police protection - officers,22586,105918522,22063,1283,105016766,901756,89472,1997
NJ,police protection - other,8724,26162239,6314,5886,22433782,3728457,419786,1997
NJ,fire protection - firefighters,6259,29107736,6062,726,28756415,351321,34186,1997
NJ,fire protection - other,574,1450375,432,547,1174214,276161,25460,1997
NJ,corrections,14557,53876450,14448,191,53632463,243987,17986,1997
NJ,streets and highways,18020,59860265,17309,1501,58165360,1694905,123859,1997
NJ,air transportation,48,164914,48,1,164387,527,64,1997
NJ,water transport and terminals,117,403272,112,9,394181,9091,851,1997
NJ,public welfare,16488,51212840,15661,1615,49519811,1693029,142749,1997
NJ,health,6335,20732810,5840,1270,19742201,990609,83479,1997
NJ,hospitals,21688,62955945,19839,2721,58530334,4425611,300516,1997
NJ,social insurance administration,2109,6215637,1654,587,5251701,963936,70565,1997
NJ,solid waste management,5490,16398292,5217,576,15942264,456028,48163,1997
NJ,sewerage,4457,15249443,4381,327,15040554,208889,13401,1997
NJ,parks and recreation,6948,18358898,5267,4421,15779273,2579625,289281,1997
NJ,housing and community development,3509,9922106,3333,346,9641696,280410,30946,1997
NJ,natural resources,2925,10385794,2764,542,9862626,523168,26749,1997
NJ,water transport and terminals,2712,8523043,2608,211,8351898,171145,18137,1997
NJ,electric power,287,1182406,285,2,1179445,2961,313,1997
NJ,gas supply,0,0,0,0,0,0,0,1997
NJ,transit,915,3113726,897,36,3068695,45031,3230,1997
NJ,education - elementary and secondary instructional,125011,547553386,118355,18542,533013975,14539411,1082475,1997
NJ,education - elementary and secondary other,51432,124412721,45297,17181,114883038,9529683,990348,1997
NJ,education - higher education instructional,12735,62806056,9201,9644,53229716,9576340,572589,1997
NJ,education - higher education other,25377,70872136,20608,15840,63045575,7826561,769013,1997
NJ,education - other,3553,13038734,3347,274,12688036,350698,31879,1997
NJ,libraries,4656,10389101,3445,3929,8632804,1756297,208867,1997
NJ,liquor stores,0,0,0,0,0,0,0,1997
NJ,other and unallocable,15651,49248720,14374,3157,46589892,2658828,215311,1997
NM,total,110980,245388169,102619,26006,231042748,14345421,1466658,1997
NM,financial administration,3400,8306152,3343,118,8215106,91046,10367,1997
NM,other government administration,2460,5961982,2341,684,5615247,346735,21481,1997
NM,judicial and legal,2415,6654044,2317,227,6475332,178712,18342,1997
NM,police protection - officers,3791,10483937,3745,84,10418221,65716,8113,1997
NM,police protection - other,1393,2595394,1262,336,2415793,179601,23121,1997
NM,fire protection - firefighters,1592,4703280,1578,170,4685723,17557,2504,1997
NM,fire protection - other,138,369716,133,13,363914,5802,658,1997
NM,corrections,5386,11763713,5329,93,11665025,98688,9796,1997
NM,streets and highways,4112,9569348,4100,25,9552641,16707,2234,1997
NM,air transportation,299,628520,292,14,620175,8345,1194,1997
NM,water transport and terminals,0,0,0,0,0,0,0,1997
NM,public welfare,1808,3923437,1701,171,3792579,130858,18593,1997
NM,health,3044,6370171,2953,219,6152948,217223,16038,1997
NM,hospitals,8306,18714324,6732,2614,14770615,3943709,278864,1997
NM,social insurance administration,475,1135940,474,1,1134040,1900,155,1997
NM,solid waste management,1167,2463543,1144,67,2432453,31090,4325,1997
NM,sewerage,695,1670672,686,31,1656830,13842,1401,1997
NM,parks and recreation,2267,4687492,1981,1873,4150615,536877,50636,1997
NM,housing and community development,353,700844,342,25,682447,18397,2042,1997
NM,natural resources,2241,5289941,2072,338,5082548,207393,30151,1997
NM,water transport and terminals,779,1702640,768,35,1688512,14128,1969,1997
NM,electric power,216,669542,215,2,667483,2059,162,1997
NM,gas supply,127,290390,123,8,285495,4895,768,1997
NM,transit,566,1234245,491,87,1113744,120501,13209,1997
NM,education - elementary and secondary instructional,30529,65444991,29820,2624,64490814,954177,117270,1997
NM,education - elementary and secondary other,10863,17240772,10211,2031,16465611,775161,110342,1997
NM,education - higher education instructional,4938,14979060,3799,4113,11984382,2994678,201558,1997
NM,education - higher education other,12883,27502154,10185,9363,24467637,3034517,477454,1997
NM,education - other,924,2250780,878,108,2188701,62079,7995,1997
NM,libraries,522,940524,426,186,820642,119882,16578,1997
NM,liquor stores,0,0,0,0,0,0,0,1997
NM,other and unallocable,3291,7140621,3178,346,6987475,153146,19338,1997
NY,total,1110246,3740259023,1005707,242359,3544081588,196177435,16696667,1997
NY,financial administration,30712,90834620,28904,4586,86627658,4206962,315928,1997
NY,other government administration,21481,59425619,18424,12643,53647422,5778197,531331,1997
NY,judicial and legal,28150,114205556,26582,4844,109595824,4609732,280480,1997
NY,police protection - officers,69517,278818223,68457,3914,276444674,2373549,179334,1997
NY,police protection - other,10600,33369239,9109,4303,30956635,2412604,261721,1997
NY,fire protection - firefighters,21446,86642372,21155,1309,86102146,540226,53096,1997
NY,fire protection - other,2242,8163432,2068,839,7823048,340384,34405,1997
NY,corrections,60128,213982244,59144,2013,211276193,2706051,166526,1997
NY,streets and highways,40859,123566520,39515,3226,121265193,2301327,233680,1997
NY,air transportation,1596,6864360,1578,34,6826212,38148,3148,1997
NY,water transport and terminals,1412,5222748,1371,80,5112988,109760,7240,1997
NY,public welfare,59078,151355512,55455,6881,143832939,7522573,589549,1997
NY,health,25998,83028039,23328,5097,75899791,7128248,439814,1997
NY,hospitals,101916,326280114,96782,9318,311270161,15009953,879180,1997
NY,social insurance administration,4547,13761356,4538,11,13731000,30356,1479,1997
NY,solid waste management,14811,53389096,14489,842,52839420,549676,57357,1997
NY,sewerage,6629,20723064,6501,447,20424069,298995,22226,1997
NY,parks and recreation,12698,32387136,9547,7208,27108460,5278676,533326,1997
NY,housing and community development,21649,51801479,21364,1383,51133574,667905,47318,1997
NY,natural resources,3451,12244268,3208,521,11546746,697522,43416,1997
NY,water transport and terminals,6391,20126990,6198,1561,19698424,428566,37090,1997
NY,electric power,3885,21137076,3803,150,20911076,226000,14806,1997
NY,gas supply,11,26796,10,1,25446,1350,92,1997
NY,transit,52340,211946594,51995,652,211343682,602912,60613,1997
NY,education - elementary and secondary instructional,277147,1081168152,260912,41284,1050869508,30298644,2537824,1997
NY,education - elementary and secondary other,113152,257627120,77669,62701,205013129,52613991,5295298,1997
NY,education - higher education instructional,28393,120695598,19891,22979,97659446,23036152,1385265,1997
NY,education - higher education other,39349,103139625,29862,23824,89214920,13924705,1552366,1997
NY,education - other,4778,16005631,4436,543,15062412,943219,60132,1997
NY,libraries,10041,23956909,7376,6985,20020551,3936358,430071,1997
NY,liquor stores,0,0,0,0,0,0,0,1997
NY,other and unallocable,35839,118363535,32036,12180,110798841,7564694,642556,1997
NC,total,415803,1009008817,376563,106585,935333073,73675744,6940595,1997
NC,financial administration,8996,22043174,8666,512,21528266,514908,57822,1997
NC,other government administration,5379,14171884,4572,2412,12479619,1692265,144163,1997
NC,judicial and legal,6304,18999171,6090,344,18621519,377652,37840,1997
NC,police protection - officers,16624,44376880,16415,655,44065341,311539,37764,1997
NC,police protection - other,4061,8751049,3752,875,8291978,459071,53793,1997
NC,fire protection - firefighters,5457,14306777,5390,567,14206249,100528,12395,1997
NC,fire protection - other,368,945321,355,33,927887,17434,2059,1997
NC,corrections,23318,55202644,23136,335,54906434,296210,32267,1997
NC,streets and highways,15787,34504089,15687,181,34364164,139925,17011,1997
NC,air transportation,666,1567074,621,111,1508775,58299,7885,1997
NC,water transport and terminals,305,962412,304,3,960580,1832,204,1997
NC,public welfare,14578,30893830,13745,1617,29851304,1042526,146165,1997
NC,health,17090,41507970,15992,2432,39495655,2012315,193943,1997
NC,hospitals,33531,82752416,31744,3636,78934238,3818178,316256,1997
NC,social insurance administration,2455,6139177,2317,240,5856648,282529,24534,1997
NC,solid waste management,4771,8902673,4321,794,8347575,555098,79067,1997
NC,sewerage,3361,7735707,3327,89,7676603,59104,6143,1997
NC,parks and recreation,4736,9141052,3682,3298,7937732,1203320,184673,1997
NC,housing and community development,2846,6420866,2683,263,6201807,219059,27434,1997
NC,natural resources,5419,13381924,4527,1299,10861834,2520090,157124,1997
NC,water transport and terminals,3527,7719654,3464,170,7620648,99006,11909,1997
NC,electric power,1202,3323252,1196,11,3313753,9499,1104,1997
NC,gas supply,162,385595,161,1,384477,1118,177,1997
NC,transit,528,952172,429,179,829566,122606,16996,1997
NC,education - elementary and secondary instructional,118288,309154830,112457,21070,293364325,15790505,1032115,1997
NC,education - elementary and secondary other,40708,67244563,32685,19219,55104731,12139832,1425268,1997
NC,education - higher education instructional,23818,80279346,15231,21134,62451723,17827623,1518209,1997
NC,education - higher education other,32414,71999420,25908,21553,61949641,10049779,1149587,1997
NC,education - other,2897,8421051,2818,124,8306802,114249,14130,1997
NC,libraries,2375,4626620,1914,1178,4040069,586551,81053,1997
NC,liquor stores,0,0,0,0,0,0,0,1997
NC,other and unallocable,13832,32196224,12974,2250,30943130,1253094,151505,1997
ND,total,36605,87771623,30361,25660,77201252,10570371,1135122,1997
ND,financial administration,1299,2755000,1188,1515,2527303,227697,26006,1997
ND,other government administration,678,2007273,417,5978,820055,1187218,55406,1997
ND,judicial and legal,706,1927170,663,211,1827729,99441,8814,1997
ND,police protection - officers,1095,2699852,1077,63,2667661,32191,3848,1997
ND,police protection - other,295,550518,279,47,527002,23516,2861,1997
ND,fire protection - firefighters,323,912821,318,541,899946,12875,1780,1997
ND,fire protection - other,7,15462,5,77,10670,4792,638,1997
ND,corrections,608,1265161,556,98,1201917,63244,8852,1997
ND,streets and highways,1880,4258030,1785,359,4116629,141401,18575,1997
ND,air transportation,74,188185,65,46,170722,17463,2059,1997
ND,water transport and terminals,0,0,0,0,0,0,0,1997
ND,public welfare,1108,2123848,978,342,1936927,186921,22968,1997
ND,health,1571,3534212,1364,529,3106005,428207,36494,1997
ND,hospitals,1163,2181118,1122,182,2138903,42215,7226,1997
ND,social insurance administration,405,939661,392,31,917054,22607,2432,1997
ND,solid waste management,356,769328,321,70,710257,59071,6517,1997
ND,sewerage,136,319136,127,70,302294,16842,2439,1997
ND,parks and recreation,855,1371620,474,1490,973688,397932,68048,1997
ND,housing and community development,265,505544,201,111,401551,103993,11285,1997
ND,natural resources,1435,3051810,1033,829,2624930,426880,71437,1997
ND,water transport and terminals,338,763684,310,117,717558,46126,6524,1997
ND,electric power,8,18996,8,0,18996,0,0,1997
ND,gas supply,0,0,0,0,0,0,0,1997
ND,transit,44,97162,24,29,58417,38745,3512,1997
ND,education - elementary and secondary instructional,9868,28348810,8639,2076,26447047,1901763,217712,1997
ND,education - elementary and secondary other,3421,5870774,2257,2611,4178638,1692136,206208,1997
ND,education - higher education instructional,2432,8990101,1863,1962,7200010,1790091,101063,1997
ND,education - higher education other,4206,7745370,3183,4303,6655623,1089747,181206,1997
ND,education - other,329,716066,307,55,684528,31538,3771,1997
ND,libraries,122,223117,76,164,158558,64559,9151,1997
ND,liquor stores,0,0,0,0,0,0,0,1997
ND,other and unallocable,1578,3621794,1329,1754,3200634,421160,48290,1997
OH,total,561229,1534747056,494028,180482,1412076934,122670122,11670745,1997
OH,financial administration,16095,46346358,15366,1789,44747583,1598775,135996,1997
OH,other government administration,9626,24097789,8282,9729,20286028,3811761,254364,1997
OH,judicial and legal,17512,44088533,16844,1810,42253870,1834663,120546,1997
OH,police protection - officers,22457,74628930,21754,2281,73495503,1133427,127395,1997
OH,police protection - other,7365,16995876,6409,2743,15508886,1486990,168632,1997
OH,fire protection - firefighters,13612,42667009,11366,10597,39524099,3142910,397360,1997
OH,fire protection - other,548,1228334,423,533,1068311,160023,22035,1997
OH,corrections,23999,64961408,23724,617,64465921,495487,48114,1997
OH,streets and highways,20766,58696488,19956,1991,57357432,1339056,148654,1997
OH,air transportation,1164,3215159,1123,100,3133489,81670,7412,1997
OH,water transport and terminals,46,118219,42,11,114956,3263,410,1997
OH,public welfare,26709,66001082,25769,1899,64460141,1540941,163774,1997
OH,health,20160,51940423,18249,4168,48419185,3521238,332818,1997
OH,hospitals,28637,72308178,24649,5703,63093877,9214301,702207,1997
OH,social insurance administration,2951,9183659,2885,93,9033634,150025,11674,1997
OH,solid waste management,3307,8266318,3072,443,7658160,608158,43150,1997
OH,sewerage,6362,17602843,6269,202,17448780,154063,15777,1997
OH,parks and recreation,8284,18661978,5907,5698,15385411,3276567,419865,1997
OH,housing and community development,4861,11980453,4689,367,11695449,285004,29180,1997
OH,natural resources,4687,12423567,4158,937,11283872,1139695,93470,1997
OH,water transport and terminals,7177,19059250,7016,448,18782449,276801,29292,1997
OH,electric power,1450,4855214,1428,43,4791202,64012,4140,1997
OH,gas supply,67,206043,64,3,199226,6817,469,1997
OH,transit,6106,18607457,5811,570,18120399,487058,52567,1997
OH,education - elementary and secondary instructional,143694,460921064,135212,20948,444564475,16356589,1420385,1997
OH,education - elementary and secondary other,66374,124209357,52220,34345,102427969,21781388,2381699,1997
OH,education - higher education instructional,24073,94665997,16444,19788,73448063,21217934,1334704,1997
OH,education - higher education other,45801,96623986,31695,40494,75529112,21094874,2481773,1997
OH,education - other,2225,7767768,2175,122,7595009,172759,8907,1997
OH,libraries,7366,15096835,4937,5329,11706395,3390440,414724,1997
OH,liquor stores,2,3897,2,0,3897,0,0,1997
OH,other and unallocable,17746,47317584,16088,6681,44474151,2843433,299252,1997
OK,total,201550,408242424,184071,48211,382728348,25514076,3063298,1997
OK,financial administration,4615,8890231,4541,411,8701456,188775,16719,1997
OK,other government administration,3252,7067627,3072,1339,6630276,437351,34514,1997
OK,judicial and legal,3401,8537919,3280,460,8307555,230364,25209,1997
OK,police protection - officers,7219,18285512,7100,310,18114363,171149,21689,1997
OK,police protection - other,2668,5062949,2512,544,4814198,248751,28356,1997
OK,fire protection - firefighters,3789,11971531,3703,1403,11835038,136493,17834,1997
OK,fire protection - other,165,382827,152,45,370305,12522,2331,1997
OK,corrections,11540,15695487,11332,343,15415582,279905,36583,1997
OK,streets and highways,9374,15692921,9217,280,15482564,210357,28005,1997
OK,air transportation,258,651856,248,17,640490,11366,1716,1997
OK,water transport and terminals,18,58268,17,10,55749,2519,260,1997
OK,public welfare,6223,10746010,6120,242,10614467,131543,18309,1997
OK,health,5201,10985069,5019,523,10737871,247198,32756,1997
OK,hospitals,15161,32581153,14107,2191,30053517,2527636,186786,1997
OK,social insurance administration,1794,3757813,1754,115,3635496,122317,6981,1997
OK,solid waste management,1163,2009450,1121,75,1960372,49078,7625,1997
OK,sewerage,1175,2314984,1160,65,2284445,30539,3688,1997
OK,parks and recreation,3833,6324934,3075,1571,5521692,803242,133853,1997
OK,housing and community development,970,1767290,909,188,1680465,86825,11712,1997
OK,natural resources,1897,3711198,1804,236,3594620,116578,16411,1997
OK,water transport and terminals,2678,5235482,2549,408,5036511,198971,23882,1997
OK,electric power,824,2345155,817,12,2337298,7857,1437,1997
OK,gas supply,29,54891,27,2,51921,2970,223,1997
OK,transit,215,545612,203,21,526367,19245,2105,1997
OK,education - elementary and secondary instructional,55995,127080826,53174,8712,123356958,3723868,478985,1997
OK,education - elementary and secondary other,24892,35655145,21125,9065,30895135,4760010,649480,1997
OK,education - higher education instructional,7540,26524985,5511,4970,21032361,5492624,357145,1997
OK,education - higher education other,17247,27244564,12488,13154,22686019,4558545,831791,1997
OK,education - other,2179,4919848,2144,109,4846644,73204,6049,1997
OK,libraries,788,1325780,621,475,1114677,211103,30166,1997
OK,liquor stores,0,0,0,0,0,0,0,1997
OK,other and unallocable,5447,10815107,5169,915,10393936,421171,50698,1997
OR,total,171712,482938707,142859,73669,421844559,61094148,5093280,1997
OR,financial administration,6310,17462592,6004,663,16854983,607609,54342,1997
OR,other government administration,3817,11362945,3527,697,10690167,672778,52422,1997
OR,judicial and legal,4172,11854317,3784,565,10879865,974452,69079,1997
OR,police protection - officers,5398,20241978,5327,200,20093391,148587,12915,1997
OR,police protection - other,2227,6605367,2109,378,6345739,259628,21042,1997
OR,fire protection - firefighters,3198,12838868,3099,1184,12688323,150545,18730,1997
OR,fire protection - other,549,1666624,503,153,1594575,72049,8608,1997
OR,corrections,6498,18267863,6016,860,17376762,891101,84745,1997
OR,streets and highways,7737,20616409,7556,286,20225876,390533,31710,1997
OR,air transportation,291,1048318,252,63,972962,75356,6784,1997
OR,water transport and terminals,205,695511,198,19,686390,9121,1215,1997
OR,public welfare,5591,14395880,5192,764,13050796,1345084,70286,1997
OR,health,5266,13442563,4328,1803,11532900,1909663,164591,1997
OR,hospitals,9665,21652267,6570,3076,16599083,5053184,541347,1997
OR,social insurance administration,2263,6995459,2061,219,6485191,510268,35688,1997
OR,solid waste management,463,1361181,413,150,1246760,114421,9108,1997
OR,sewerage,1547,4843285,1471,174,4709701,133584,13730,1997
OR,parks and recreation,2717,6424805,1834,3094,4915430,1509375,155201,1997
OR,housing and community development,868,2188601,822,120,2095552,93049,8129,1997
OR,natural resources,3415,8627137,3086,734,8066786,560351,58557,1997
OR,water transport and terminals,2181,6951101,2113,276,6811217,139884,12885,1997
OR,electric power,1302,5042658,1274,54,4977954,64704,4974,1997
OR,gas supply,0,0,0,0,0,0,0,1997
OR,transit,2603,7941320,2359,435,7394553,546767,43200,1997
OR,education - elementary and secondary instructional,42699,125877686,36038,16948,112151581,13726105,1174650,1997
OR,education - elementary and secondary other,18150,38244414,14010,9188,31724896,6519518,731470,1997
OR,education - higher education instructional,11999,46860845,7087,12839,30475715,16385130,868779,1997
OR,education - higher education other,11689,25149016,8241,15580,19372998,5776018,607698,1997
OR,education - other,1064,2931678,936,159,2589961,341717,22754,1997
OR,libraries,1502,3243024,894,1411,2191348,1051676,107671,1997
OR,liquor stores,165,439400,156,24,418890,20510,1655,1997
OR,other and unallocable,6161,17665595,5599,1553,16624214,1041381,99315,1997
PA,total,515927,1510172414,464937,142181,1415532803,94639611,8699613,1997
PA,financial administration,15455,39546356,14103,5850,36694239,2852117,251768,1997
PA,other government administration,12285,31695974,10767,9497,27544267,4151707,282031,1997
PA,judicial and legal,16117,41219442,15427,2269,39725423,1494019,117740,1997
PA,police protection - officers,24672,85221707,23291,3554,83191932,2029775,240984,1997
PA,police protection - other,6318,13515543,4468,4821,10538577,2976966,321038,1997
PA,fire protection - firefighters,5521,19282387,5360,541,19067383,215004,28279,1997
PA,fire protection - other,473,1154178,400,210,1035495,118683,12081,1997
PA,corrections,25085,67905362,24431,1003,66727391,1177971,109569,1997
PA,streets and highways,24226,62554307,22612,3118,60052186,2502121,280482,1997
PA,air transportation,1403,4007478,1309,172,3842466,165012,16199,1997
PA,water transport and terminals,967,2200721,853,144,2044312,156409,20019,1997
PA,public welfare,32106,77168445,30597,4002,74643224,2525221,258985,1997
PA,health,6769,18435878,6549,592,17972509,463369,38131,1997
PA,hospitals,15576,38171707,15145,776,37095975,1075732,72004,1997
PA,social insurance administration,4516,13242988,4293,229,12806203,436785,37031,1997
PA,solid waste management,3332,8174763,3224,263,8006657,168106,20312,1997
PA,sewerage,5459,14716545,5198,948,14271780,444765,48136,1997
PA,parks and recreation,5128,11884952,3860,2836,9958237,1926715,216661,1997
PA,housing and community development,6398,16085244,6036,659,15405226,680018,59738,1997
PA,natural resources,7685,23539698,6961,1445,21750504,1789194,124717,1997
PA,water transport and terminals,5298,14384032,5100,748,14057065,326967,37558,1997
PA,electric power,148,464603,138,26,444135,20468,1872,1997
PA,gas supply,7,20747,7,0,20747,0,0,1997
PA,transit,13336,46479226,13148,301,46210739,268487,32706,1997
PA,education - elementary and secondary instructional,141593,501658562,133532,21269,488675946,12982616,1344419,1997
PA,education - elementary and secondary other,59554,125543887,48668,23993,109884802,15659085,1829567,1997
PA,education - higher education instructional,19842,96986058,14036,13460,77873494,19112564,987184,1997
PA,education - higher education other,36429,83217335,27082,33424,67040072,16177263,1583361,1997
PA,education - other,2887,8615727,2823,209,8518907,96820,10636,1997
PA,libraries,1455,3552924,1191,618,3188331,364593,45529,1997
PA,liquor stores,3101,7505365,2811,1525,7185429,319936,48112,1997
PA,other and unallocable,12786,32020273,11517,3679,30059150,1961123,222764,1997
RI,total,49279,153881441,44856,11505,145521687,8359754,718691,1997
RI,financial administration,1210,3255466,1180,73,3199358,56108,5002,1997
RI,other government administration,1454,3131901,1412,432,3001793,130108,7545,1997
RI,judicial and legal,1190,3976899,1152,69,3885546,91353,6342,1997
RI,police protection - officers,2225,8155034,2219,15,8145388,9646,1011,1997
RI,police protection - other,592,1297868,495,242,1146221,151647,16455,1997
RI,fire protection - firefighters,2118,7105078,2079,220,7055371,49707,6505,1997
RI,fire protection - other,158,343041,153,28,335433,7608,796,1997
RI,corrections,1649,7265308,1649,0,7265308,0,0,1997
RI,streets and highways,1802,4926419,1779,52,4886982,39437,3703,1997
RI,air transportation,0,0,0,0,0,0,0,1997
RI,water transport and terminals,0,0,0,0,0,0,0,1997
RI,public welfare,1956,6283438,1901,105,6187496,95942,8592,1997
RI,health,1369,4817029,1362,17,4798966,18063,1172,1997
RI,hospitals,1251,4102505,1229,36,4017819,84686,3930,1997
RI,social insurance administration,725,2029184,690,43,1961738,67446,5404,1997
RI,solid waste management,226,654862,222,10,646017,8845,892,1997
RI,sewerage,638,1760746,633,10,1749253,11493,768,1997
RI,parks and recreation,407,872251,341,202,783253,88998,11184,1997
RI,housing and community development,535,1303189,469,116,1207310,95879,11351,1997
RI,natural resources,552,1738492,527,66,1709795,28697,4192,1997
RI,water transport and terminals,500,1279836,494,12,1271561,8275,912,1997
RI,electric power,12,43807,11,1,42753,1054,115,1997
RI,gas supply,0,0,0,0,0,0,0,1997
RI,transit,509,1567366,503,9,1554752,12614,1098,1997
RI,education - elementary and secondary instructional,15697,54805233,14891,1860,53361129,1444104,127329,1997
RI,education - elementary and secondary other,3876,9283372,3035,2010,7968108,1315264,129078,1997
RI,education - higher education instructional,3077,10609412,1854,2536,7120992,3488420,200077,1997
RI,education - higher education other,3090,6038944,2361,2744,5421864,617080,124790,1997
RI,education - other,582,2420088,527,113,2240252,179836,8594,1997
RI,libraries,393,771568,273,289,624151,147417,20264,1997
RI,liquor stores,0,0,0,0,0,0,0,1997
RI,other and unallocable,1486,4043105,1415,195,3933078,110027,11590,1997
SC,total,221735,512006458,208014,38810,489284843,22721615,2333872,1997
SC,financial administration,5490,12726780,5387,223,12572246,154534,17556,1997
SC,other government administration,2878,6817163,2569,1529,6124044,693119,53556,1997
SC,judicial and legal,3327,7838095,3134,438,7450369,387726,33789,1997
SC,police protection - officers,8166,20100306,8136,118,20050121,50185,5572,1997
SC,police protection - other,2649,4722421,2448,525,4484909,237512,34745,1997
SC,fire protection - firefighters,3069,6957772,2974,701,6840245,117527,16887,1997
SC,fire protection - other,165,334072,159,13,325901,8171,1041,1997
SC,corrections,10511,21096800,10485,40,21056484,40316,4008,1997
SC,streets and highways,7415,13896786,7387,50,13857886,38900,4547,1997
SC,air transportation,357,682844,347,23,666315,16529,1731,1997
SC,water transport and terminals,450,1605150,450,0,1605150,0,0,1997
SC,public welfare,5291,11031361,5257,66,10985709,45652,5603,1997
SC,health,9884,23205473,9588,573,22550601,654872,49923,1997
SC,hospitals,29518,68726307,27228,4648,63623296,5103011,403312,1997
SC,social insurance administration,1376,3304782,1374,4,3290990,13792,350,1997
SC,solid waste management,2667,4161636,2321,653,3772834,388802,59853,1997
SC,sewerage,1659,3588201,1637,42,3556826,31375,3904,1997
SC,parks and recreation,2725,4928426,2246,1275,4387743,540683,83124,1997
SC,housing and community development,1013,2168928,976,87,2122554,46374,6086,1997
SC,natural resources,2597,6756143,2561,59,6711157,44986,5476,1997
SC,water transport and terminals,2320,5362490,2290,106,5309242,53248,5806,1997
SC,electric power,2102,7044294,2093,15,7029895,14399,1752,1997
SC,gas supply,309,758896,302,18,748481,10415,1329,1997
SC,transit,432,649607,385,80,598123,51484,7958,1997
SC,education - elementary and secondary instructional,60133,153362916,58671,5211,151156684,2206232,246556,1997
SC,education - elementary and secondary other,22506,36850014,19885,6167,33624157,3225857,439236,1997
SC,education - higher education instructional,9416,35763235,7608,6535,31203754,4559481,300912,1997
SC,education - higher education other,14923,28934059,12158,8432,25557841,3376218,465205,1997
SC,education - other,2841,7076502,2818,47,7021812,54690,3806,1997
SC,libraries,952,1696186,767,539,1454561,241625,32175,1997
SC,liquor stores,0,0,0,0,0,0,0,1997
SC,other and unallocable,4594,9858813,4373,593,9544913,313900,38074,1997
SD,total,39837,86726995,34828,20479,78666522,8060473,904874,1997
SD,financial administration,1398,2889168,1303,854,2687903,201265,21275,1997
SD,other government administration,772,1790465,667,3907,1360627,429838,27158,1997
SD,judicial and legal,716,1915249,613,213,1520620,394629,18715,1997
SD,police protection - officers,1233,3096060,1210,97,3058035,38025,5282,1997
SD,police protection - other,423,742527,383,134,689676,52851,7550,1997
SD,fire protection - firefighters,361,1018682,360,214,1014027,4655,562,1997
SD,fire protection - other,22,53779,21,21,50481,3298,474,1997
SD,corrections,1148,2234856,1099,122,2110335,124521,8253,1997
SD,streets and highways,2779,6263859,2605,408,5992612,271247,33234,1997
SD,air transportation,52,115241,44,13,104654,10587,1212,1997
SD,water transport and terminals,0,0,0,0,0,0,0,1997
SD,public welfare,1237,2349415,1044,326,2080896,268519,34206,1997
SD,health,747,1658187,600,387,1433152,225035,25987,1997
SD,hospitals,1535,3049319,1275,475,2602350,446969,45997,1997
SD,social insurance administration,269,550449,265,6,543530,6919,735,1997
SD,solid waste management,232,456794,210,80,426311,30483,4595,1997
SD,sewerage,259,620098,243,116,584388,35710,3843,1997
SD,parks and recreation,517,1019206,364,497,835279,183927,27024,1997
SD,housing and community development,132,249208,103,89,208361,40847,4899,1997
SD,natural resources,1118,2323944,957,558,2120716,203228,28570,1997
SD,water transport and terminals,358,800156,334,86,760398,39758,5355,1997
SD,electric power,134,370974,128,24,358182,12792,1028,1997
SD,gas supply,12,44581,12,0,44581,0,0,1997
SD,transit,0,0,0,0,0,0,0,1997
SD,education - elementary and secondary instructional,12484,28099764,11660,2464,26734280,1365484,142977,1997
SD,education - elementary and secondary other,4558,7154473,3419,3694,5539423,1615050,199985,1997
SD,education - higher education instructional,2021,7156726,1672,1014,6339951,816775,61681,1997
SD,education - higher education other,3144,5847984,2407,3163,5078563,769421,130459,1997
SD,education - other,388,863590,366,45,831487,32103,3875,1997
SD,libraries,268,476705,181,279,368954,107751,16134,1997
SD,liquor stores,0,0,0,0,0,0,0,1997
SD,other and unallocable,1520,3515536,1283,1193,3186750,328786,43809,1997
TN,total,276033,621990777,253631,56031,584419880,37570897,3839228,1997
TN,financial administration,6046,14529017,5872,386,14271155,257862,30125,1997
TN,other government administration,3904,8957786,3734,1393,8466437,491349,31703,1997
TN,judicial and legal,5243,14689263,5058,512,14258787,430476,33020,1997
TN,police protection - officers,11716,30799567,11615,303,30656105,143462,18231,1997
TN,police protection - other,3578,7362132,3310,695,7009356,352776,48194,1997
TN,fire protection - firefighters,5687,16269512,5605,1065,16158775,110737,15447,1997
TN,fire protection - other,321,898653,316,42,894574,4079,693,1997
TN,corrections,11906,24464770,11833,160,24376050,88720,12455,1997
TN,streets and highways,11634,21941836,11522,204,21806167,135669,19537,1997
TN,air transportation,721,2076729,676,77,2015326,61403,7765,1997
TN,water transport and terminals,11,28958,11,2,27429,1529,131,1997
TN,public welfare,8060,16752684,7796,527,16418477,334207,45686,1997
TN,health,6186,14585322,6035,320,14345296,240026,26643,1997
TN,hospitals,23745,53517441,21463,3524,48442638,5074803,398512,1997
TN,social insurance administration,1631,3681680,1409,306,3324074,357606,36842,1997
TN,solid waste management,4221,7458802,3991,475,7212549,246253,40020,1997
TN,sewerage,1759,3528349,1747,43,3503297,25052,2539,1997
TN,parks and recreation,4973,7588820,4483,1264,6988317,600503,85607,1997
TN,housing and community development,2691,5825782,2576,188,5675962,149820,19236,1997
TN,natural resources,3665,8085554,3246,731,7515258,570296,73115,1997
TN,water transport and terminals,4060,9602699,3954,305,9441545,161154,18864,1997
TN,electric power,4816,15445446,4759,108,15365179,80267,9662,1997
TN,gas supply,1947,5459859,1929,39,5424924,34935,3441,1997
TN,transit,313,671813,244,119,547057,124756,12166,1997
TN,education - elementary and secondary instructional,73799,181824813,70855,9984,177579448,4245365,496512,1997
TN,education - elementary and secondary other,28505,36976692,24387,11590,31696168,5280524,696538,1997
TN,education - higher education instructional,12154,43978334,8785,6877,36072164,7906170,566671,1997
TN,education - higher education other,22170,41896562,16377,13424,32637224,9259338,997572,1997
TN,education - other,1830,4463783,1800,112,4392780,71003,4987,1997
TN,libraries,1335,2335753,1142,437,2081784,253969,34530,1997
TN,liquor stores,0,0,0,0,0,0,0,1997
TN,other and unallocable,7406,16292366,7101,819,15815578,476788,52784,1997
TX,total,1112355,2609460401,1031819,207353,2472441079,137019322,14090744,1997
TX,financial administration,21344,52137650,20916,920,51385879,751771,76668,1997
TX,other government administration,13198,31598405,12370,2764,30135534,1462871,153924,1997
TX,judicial and legal,20828,55060778,19984,1893,53388922,1671856,150867,1997
TX,police protection - officers,41469,122503074,41289,532,122209768,293306,31857,1997
TX,police protection - other,14713,29581888,13745,2871,28349356,1232532,170184,1997
TX,fire protection - firefighters,17228,56528427,17064,1095,56312081,216346,28964,1997
TX,fire protection - other,1452,3646709,1392,151,3528263,118446,11927,1997
TX,corrections,63549,131689765,62965,1146,130830825,858940,103524,1997
TX,streets and highways,31962,67093600,31231,1149,66020590,1073010,129104,1997
TX,air transportation,4255,9834165,4153,153,9727623,106542,18628,1997
TX,water transport and terminals,863,2701629,843,54,2668756,32873,3253,1997
TX,public welfare,25484,51614583,25085,820,51025909,588674,70931,1997
TX,health,28448,62646902,26813,3037,59255842,3391060,289500,1997
TX,hospitals,84774,218912098,80426,7851,209899481,9012617,768619,1997
TX,social insurance administration,5948,14374033,5880,92,14270536,103497,12101,1997
TX,solid waste management,6182,11803177,6026,291,11601140,202037,27345,1997
TX,sewerage,10306,22936680,10204,253,22789358,147322,18769,1997
TX,parks and recreation,14052,25460873,11662,5108,22556104,2904769,422983,1997
TX,housing and community development,6015,11561163,5538,1047,10797466,763697,84175,1997
TX,natural resources,16235,40724865,15068,3451,38537737,2187128,207554,1997
TX,water transport and terminals,13167,28976075,12912,689,28579752,396323,45901,1997
TX,electric power,7568,24665118,7521,97,24574580,90538,8566,1997
TX,gas supply,1332,3719033,1331,2,3717705,1328,146,1997
TX,transit,10006,31635448,9535,790,30777911,857537,83301,1997
TX,education - elementary and secondary instructional,361184,894311160,347638,42066,868968332,25342828,2325924,1997
TX,education - elementary and secondary other,147863,222893339,125850,50639,194479357,28413982,3805738,1997
TX,education - higher education instructional,40083,164030603,27521,30814,131161738,32868865,2215463,1997
TX,education - higher education other,71277,145887396,57276,42769,126734349,19153047,2472043,1997
TX,education - other,4802,11522980,4742,168,11352825,170155,10663,1997
TX,libraries,5264,9757522,4386,1864,8667214,1090308,154124,1997
TX,liquor stores,0,0,0,0,0,0,0,1997
TX,other and unallocable,21504,49651263,20453,2777,48136146,1515117,187998,1997
UT,total,109028,266461552,93075,46095,241370491,25091061,2775532,1997
UT,financial administration,2879,7418594,2658,454,7069917,348677,39405,1997
UT,other government administration,1884,5147337,1733,988,4784280,363057,28350,1997
UT,judicial and legal,2263,6836243,2079,475,6420052,416191,33869,1997
UT,police protection - officers,3218,9796976,3170,168,9716905,80071,8778,1997
UT,police protection - other,1577,3469370,1222,953,3035963,433407,63258,1997
UT,fire protection - firefighters,1352,4062162,1100,1216,3702481,359681,45494,1997
UT,fire protection - other,167,392017,152,75,372432,19585,2585,1997
UT,corrections,3350,8375476,3201,360,8112930,262546,26444,1997
UT,streets and highways,3328,9121765,3199,256,8907108,214657,23545,1997
UT,air transportation,473,1089319,456,32,1064587,24732,2698,1997
UT,water transport and terminals,0,0,0,0,0,0,0,1997
UT,public welfare,3457,8198934,3166,556,7683811,515123,51597,1997
UT,health,2667,7217852,2377,758,6606046,611806,51516,1997
UT,hospitals,5650,12160807,5374,643,11742277,418530,48933,1997
UT,social insurance administration,623,1821446,575,189,1572265,249181,8413,1997
UT,solid waste management,409,963053,379,80,914288,48765,5757,1997
UT,sewerage,747,1978189,701,129,1893021,85168,8414,1997
UT,parks and recreation,2113,4093064,1172,2934,2972787,1120277,166243,1997
UT,housing and community development,526,1351394,487,75,1300108,51286,6643,1997
UT,natural resources,1458,4106485,1359,313,3935506,170979,17595,1997
UT,water transport and terminals,1133,2955825,1093,192,2875479,80346,8291,1997
UT,electric power,495,1585619,476,39,1558306,27313,3035,1997
UT,gas supply,4,8250,3,4,6750,1500,230,1997
UT,transit,1226,3101486,1181,94,3022243,79243,7937,1997
UT,education - elementary and secondary instructional,29186,73250490,24994,11382,67101418,6149072,705712,1997
UT,education - elementary and secondary other,11034,19496702,7600,10568,14456922,5039780,591835,1997
UT,education - higher education instructional,5224,24487267,4400,2514,21861084,2626183,143902,1997
UT,education - higher education other,17383,31364812,14440,8058,27419536,3945276,519815,1997
UT,education - other,963,2508437,836,306,2278901,229536,22303,1997
UT,libraries,643,1292509,371,667,889399,403110,48303,1997
UT,liquor stores,264,502394,204,160,428409,73985,10667,1997
UT,other and unallocable,3332,8307278,2917,1457,7665280,641998,73965,1997
VT,total,30266,71927024,26307,11273,65232143,6694881,683995,1997
VT,financial administration,913,2037392,791,525,1807430,229962,23516,1997
VT,other government administration,705,1776750,597,725,1520858,255892,20379,1997
VT,judicial and legal,591,1717297,544,83,1614173,103124,8443,1997
VT,police protection - officers,889,2857243,824,176,2761323,95920,11276,1997
VT,police protection - other,344,802566,291,129,725236,77330,9598,1997
VT,fire protection - firefighters,281,774888,226,469,707387,67501,10430,1997
VT,fire protection - other,12,27377,7,29,18801,8576,1171,1997
VT,corrections,881,2044520,861,27,2007385,37135,3472,1997
VT,streets and highways,2003,4966594,1962,110,4890030,76564,8128,1997
VT,air transportation,20,62356,19,5,61209,1147,199,1997
VT,water transport and terminals,0,0,0,0,0,0,0,1997
VT,public welfare,1079,1897868,981,127,1706755,191113,17271,1997
VT,health,533,1398257,481,104,1250573,147684,9286,1997
VT,hospitals,180,374591,175,9,363705,10886,850,1997
VT,social insurance administration,318,787369,299,21,747860,39509,3412,1997
VT,solid waste management,127,280143,94,130,226476,53667,6791,1997
VT,sewerage,160,413829,148,30,392525,21304,2239,1997
VT,parks and recreation,306,682083,223,264,575216,106867,14714,1997
VT,housing and community development,94,208389,84,20,192004,16385,1669,1997
VT,natural resources,628,1660410,590,59,1578550,81860,6607,1997
VT,water transport and terminals,180,460155,168,81,436365,23790,2465,1997
VT,electric power,218,684928,213,9,679148,5780,670,1997
VT,gas supply,0,0,0,0,0,0,0,1997
VT,transit,117,234462,109,15,224187,10275,1242,1997
VT,education - elementary and secondary instructional,10706,25622537,9212,3690,23116199,2506338,250903,1997
VT,education - elementary and secondary other,2876,4892090,2138,1869,3788188,1103902,127973,1997
VT,education - higher education instructional,1428,5237880,1178,671,4623412,614468,41410,1997
VT,education - higher education other,2925,5680656,2509,1396,5170094,510562,68990,1997
VT,education - other,388,1098015,366,38,1055428,42587,3752,1997
VT,libraries,111,199706,48,151,105973,93733,11457,1997
VT,liquor stores,51,133637,51,0,133637,0,0,1997
VT,other and unallocable,1202,2913036,1118,311,2752016,161020,15682,1997
VA,total,358733,903851771,314528,105765,834114125,69737646,7556543,1997
VA,financial administration,10118,26693365,9395,1286,25413561,1279804,127667,1997
VA,other government administration,5574,16706946,5147,1664,15595699,1111247,76311,1997
VA,judicial and legal,6387,19966267,6070,853,19184175,782092,56443,1997
VA,police protection - officers,13518,42579691,13408,253,42427467,152224,18771,1997
VA,police protection - other,3879,8286133,3440,898,7659492,626641,76743,1997
VA,fire protection - firefighters,6508,20621152,6485,152,20575779,45373,4075,1997
VA,fire protection - other,587,1723550,538,85,1649670,73880,8727,1997
VA,corrections,19695,45002636,19114,1071,43997508,1005128,100897,1997
VA,streets and highways,13857,36169396,13507,1085,35614075,555321,61726,1997
VA,air transportation,1463,5139699,1388,165,5002988,136711,13367,1997
VA,water transport and terminals,123,362897,123,3,362059,838,120,1997
VA,public welfare,9035,22389574,8509,882,21457265,932309,91443,1997
VA,health,10338,28513587,8910,2416,25879357,2634230,250467,1997
VA,hospitals,15845,32316179,14784,2302,30260488,2055691,185892,1997
VA,social insurance administration,1351,3502030,1083,468,3006120,495910,47422,1997
VA,solid waste management,3846,8265558,3540,510,7898650,366908,53476,1997
VA,sewerage,4012,10330468,3872,230,10052235,278233,24321,1997
VA,parks and recreation,6872,13948652,4835,5780,11133889,2814763,354476,1997
VA,housing and community development,1967,5118300,1902,114,5023385,94915,10595,1997
VA,natural resources,3360,9111791,2970,717,8537900,573891,69019,1997
VA,water transport and terminals,3747,9353748,3667,182,9226853,126895,13906,1997
VA,electric power,287,797236,284,5,791590,5646,495,1997
VA,gas supply,340,675463,336,5,667414,8049,701,1997
VA,transit,1362,2121960,908,759,1517186,604774,80077,1997
VA,education - elementary and secondary instructional,109486,298291467,103137,17940,287589969,10701498,1047721,1997
VA,education - elementary and secondary other,44592,74615971,30717,27533,56820207,17795764,2287466,1997
VA,education - higher education instructional,15441,62632121,11444,10597,51281425,11350696,707489,1997
VA,education - higher education other,25478,49393712,18415,21436,40851186,8542526,1250408,1997
VA,education - other,2814,7905826,2552,570,7375716,530110,46190,1997
VA,libraries,3425,6982689,2100,2670,5182134,1800555,229969,1997
VA,liquor stores,1146,2243436,675,885,1574030,669406,83290,1997
VA,other and unallocable,12280,32090271,11273,2249,30504653,1585618,176873,1997
WA,total,293245,896429107,234582,119171,773600384,122828723,10348243,1997
WA,financial administration,7461,22658406,7175,592,21941466,716940,50371,1997
WA,other government administration,5916,18982752,5486,1800,17875991,1106761,76828,1997
WA,judicial and legal,6882,23811232,6506,911,22837573,973659,65685,1997
WA,police protection - officers,8699,36437873,8645,177,36325160,112713,9782,1997
WA,police protection - other,3887,11207886,3756,318,10921490,286396,23498,1997
WA,fire protection - firefighters,6104,24801229,5653,4203,24132490,668739,83059,1997
WA,fire protection - other,561,1848291,519,256,1754514,93777,8504,1997
WA,corrections,10860,26807165,10380,910,25386517,1420648,84484,1997
WA,streets and highways,13063,43555982,12626,788,42242510,1313472,76554,1997
WA,air transportation,1147,4350335,1084,94,4234475,115860,11007,1997
WA,water transport and terminals,1278,4257677,1224,148,4135015,122662,9815,1997
WA,public welfare,8595,26107973,8076,988,24712095,1395878,91411,1997
WA,health,10387,33664901,9080,2320,29640172,4024729,216947,1997
WA,hospitals,17498,51151539,13047,8212,36743487,14408052,784635,1997
WA,social insurance administration,4449,10494252,4289,621,10183998,310254,28138,1997
WA,solid waste management,1584,4841300,1423,279,4402909,438391,27544,1997
WA,sewerage,2700,8952583,2611,215,8721911,230672,15750,1997
WA,parks and recreation,4714,12352322,3518,3563,10258816,2093506,212224,1997
WA,housing and community development,1988,5637690,1800,424,5293106,344584,33029,1997
WA,natural resources,6083,15958407,5436,1325,14808301,1150106,114533,1997
WA,water transport and terminals,2995,10077882,2870,413,9780608,297274,24242,1997
WA,electric power,7257,31445927,7023,360,30874090,571837,41261,1997
WA,gas supply,35,112688,35,0,112688,0,0,1997
WA,transit,6346,20239387,5279,1961,17010479,3228908,172639,1997
WA,education - elementary and secondary instructional,57634,203582621,54225,5799,192996973,10585648,604155,1997
WA,education - elementary and secondary other,30747,64518879,9707,37107,24390439,40128440,3723968,1997
WA,education - higher education instructional,13991,56442303,10965,10517,46229381,10212922,535986,1997
WA,education - higher education other,34908,78270921,19146,29216,57030425,21240496,2789913,1997
WA,education - other,699,2293602,660,83,2192316,101286,6920,1997
WA,libraries,3090,7658567,1790,2659,5325519,2333048,227577,1997
WA,liquor stores,765,1908452,447,480,1247834,660618,56210,1997
WA,other and unallocable,10922,31998083,10101,2432,29857636,2140447,141574,1997
WV,total,92275,208455846,85090,18750,196720142,11735704,1241787,1997
WV,financial administration,2698,4745056,2639,175,4647465,97591,11078,1997
WV,other government administration,1470,3160495,1223,1166,2357274,803221,44404,1997
WV,judicial and legal,1874,4384353,1830,192,4284216,100137,9384,1997
WV,police protection - officers,2777,6633404,2748,82,6593017,40387,5232,1997
WV,police protection - other,728,1077378,653,198,1000063,77315,13424,1997
WV,fire protection - firefighters,853,2002216,841,87,1989573,12643,2336,1997
WV,fire protection - other,36,67283,34,6,64793,2490,231,1997
WV,corrections,1444,2500907,1428,66,2475719,25188,3238,1997
WV,streets and highways,6835,14742763,6753,138,14614545,128218,14924,1997
WV,air transportation,161,253138,150,23,240970,12168,2011,1997
WV,water transport and terminals,0,0,0,0,0,0,0,1997
WV,public welfare,78,103366,78,0,103366,0,0,1997
WV,health,2058,4227250,1924,389,3968570,258680,22911,1997
WV,hospitals,5382,10380019,4619,907,8903069,1476950,133297,1997
WV,social insurance administration,785,1577718,780,17,1571230,6488,794,1997
WV,solid waste management,680,1032268,621,129,956217,76051,11519,1997
WV,sewerage,900,1695567,859,156,1629144,66423,8143,1997
WV,parks and recreation,1382,1866071,916,1099,1436183,429888,82281,1997
WV,housing and community development,575,1144933,515,130,1050726,94207,10402,1997
WV,natural resources,2012,4690360,1938,167,4613113,77247,13024,1997
WV,water transport and terminals,1222,2235914,1129,367,2099900,136014,17686,1997
WV,electric power,10,23338,10,0,23338,0,0,1997
WV,gas supply,0,0,0,0,0,0,0,1997
WV,transit,406,868564,389,58,844601,23963,2984,1997
WV,education - elementary and secondary instructional,27806,73776789,26485,2536,71513169,2263620,228175,1997
WV,education - elementary and secondary other,12852,22624889,11900,2631,21274812,1350077,166404,1997
WV,education - higher education instructional,4637,16579153,3321,4152,13982926,2596227,218457,1997
WV,education - higher education other,7279,15049471,6250,3121,13824510,1224961,171172,1997
WV,education - other,1422,3450472,1373,122,3360896,89576,8364,1997
WV,libraries,313,478255,251,145,411341,66914,10517,1997
WV,liquor stores,56,109978,54,2,107916,2062,274,1997
WV,other and unallocable,3544,6974478,3379,489,6777480,196998,29121,1997
WI,total,266342,773460305,224178,107206,685921029,87539276,7483463,1997
WI,financial administration,5955,16369550,5027,2963,14403336,1966214,186844,1997
WI,other government administration,5716,15226105,4352,9287,11921679,3304426,257169,1997
WI,judicial and legal,5206,17389555,4732,1290,16059600,1329955,84891,1997
WI,police protection - officers,11215,38603512,10900,1066,38064169,539343,57641,1997
WI,police protection - other,3221,7258939,2690,1826,6365603,893336,96898,1997
WI,fire protection - firefighters,4016,14589207,3612,4203,14036255,552952,72688,1997
WI,fire protection - other,311,915308,282,197,873305,42003,5718,1997
WI,corrections,9993,26381707,9365,1106,24839885,1541822,111253,1997
WI,streets and highways,10964,31578277,10506,1522,30789011,789266,89704,1997
WI,air transportation,355,1017521,338,45,984433,33088,3304,1997
WI,water transport and terminals,31,106956,31,4,106495,461,53,1997
WI,public welfare,13918,32393115,11387,4336,27802366,4590749,445876,1997
WI,health,7781,20890194,6217,2950,17300946,3589248,274886,1997
WI,hospitals,10623,27184310,8398,3778,21708225,5476085,393829,1997
WI,social insurance administration,869,2410973,833,50,2297696,113277,6485,1997
WI,solid waste management,1716,4610109,1471,971,4250599,359510,52543,1997
WI,sewerage,2312,7259638,2215,719,7038860,220778,21949,1997
WI,parks and recreation,2956,7396570,2121,2713,6170417,1226153,147564,1997
WI,housing and community development,1147,2969536,1021,378,2760538,208998,21867,1997
WI,natural resources,3590,9347113,2897,1427,7960636,1386477,122343,1997
WI,water transport and terminals,1839,5540736,1801,159,5465219,75517,8246,1997
WI,electric power,354,1126693,348,21,1112898,13795,1400,1997
WI,gas supply,0,0,0,0,0,0,0,1997
WI,transit,2211,6973358,2091,209,6678757,294601,21501,1997
WI,education - elementary and secondary instructional,82720,257184107,73114,17701,238691212,18492895,1676356,1997
WI,education - elementary and secondary other,25207,51082513,18397,16660,40287404,10795109,1189630,1997
WI,education - higher education instructional,14356,60595585,10714,9967,49108804,11486781,636885,1997
WI,education - higher education other,22246,65846184,16853,11542,52960625,12885559,947345,1997
WI,education - other,1206,3589103,1071,311,3372681,216422,24029,1997
WI,libraries,2516,5263383,1547,2308,3889108,1374275,170466,1997
WI,liquor stores,0,0,0,0,0,0,0,1997
WI,other and unallocable,11792,32360448,9847,7497,28620267,3740181,354100,1997
WY,total,38446,85926373,32647,15651,76854194,9072179,1016087,1997
WY,financial administration,1061,2309822,1040,61,2273950,35872,4084,1997
WY,other government administration,557,1235417,519,454,1109605,125812,8603,1997
WY,judicial and legal,692,1870795,656,141,1747126,123669,7257,1997
WY,police protection - officers,1091,2881573,1082,17,2867728,13845,1359,1997
WY,police protection - other,523,1029793,479,120,955052,74741,8401,1997
WY,fire protection - firefighters,323,958754,305,277,929696,29058,3739,1997
WY,fire protection - other,20,32916,14,14,26229,6687,1035,1997
WY,corrections,999,2017549,992,15,2002722,14827,1337,1997
WY,streets and highways,2633,5464544,2521,141,5310153,154391,19850,1997
WY,air transportation,112,250090,97,24,230532,19558,2414,1997
WY,water transport and terminals,0,0,0,0,0,0,0,1997
WY,public welfare,647,1209566,599,65,1158584,50982,8337,1997
WY,health,746,1697638,631,272,1487328,210310,20157,1997
WY,hospitals,5037,11900674,4339,1489,10370787,1529887,122210,1997
WY,social insurance administration,300,667941,300,0,667941,0,0,1997
WY,solid waste management,278,562752,262,70,529953,32799,3614,1997
WY,sewerage,159,380468,153,25,366530,13938,1424,1997
WY,parks and recreation,568,1110600,417,644,900209,210391,26992,1997
WY,housing and community development,60,102708,44,30,84831,17877,2937,1997
WY,natural resources,872,2037704,829,110,1971116,66588,8108,1997
WY,water transport and terminals,281,634797,261,76,604147,30650,3548,1997
WY,electric power,41,124388,41,0,124388,0,0,1997
WY,gas supply,0,0,0,0,0,0,0,1997
WY,transit,51,70188,19,43,20366,49822,5517,1997
WY,education - elementary and secondary instructional,10142,25791787,8762,3581,23653491,2138296,236349,1997
WY,education - elementary and secondary other,4544,7727570,3179,3269,5805928,1921642,235322,1997
WY,education - higher education instructional,1719,4957131,1291,1123,3967786,989345,75789,1997
WY,education - higher education other,3199,5301644,2229,3054,4387808,913836,171625,1997
WY,education - other,143,351436,139,12,344879,6557,751,1997
WY,libraries,227,375024,151,177,270256,104768,12863,1997
WY,liquor stores,33,54149,33,0,54149,0,0,1997
WY,other and unallocable,1388,2816955,1263,347,2630924,186031,22465,1997
