state,government_function,full_time_employees,full_time_pay,part_time_employees,part_time_pay,part_time_hours,full_time_equivalent_employees,total_march_pay,year
US,total,3564547,12027220901,1312873,1251915081,90651373,4082694,13279135982,2000
US,financial administration,155064,501833420,13942,18957340,1528962,163818,520790760,2000
US,other government administration,46292,160239441,12896,19427494,1201719,53228,179666935,2000
US,judicial and legal,147119,569926194,10695,17457304,1135590,153637,587383498,2000
US,police arrest,61088,255590744,684,920818,34066,61282,256511562,2000
US,police other,38720,120454198,2641,2664403,220687,39983,123118601,2000
US,corrections,450751,1375290846,12989,21678768,1403913,458721,1396969614,2000
US,streets and highways,240101,754687965,12064,17455571,1199601,246988,772143536,2000
US,air transportation,2959,11377080,169,246771,13640,3037,11623851,2000
US,water transportation,4397,15960797,118,154186,10264,4453,16114983,2000
US,public welfare,222337,639881241,10804,17508431,1194316,229217,657389672,2000
US,health,164797,523236036,14088,22332279,1385950,172678,545568315,2000
US,hospitals,378006,1110076940,53128,91170111,5601419,409906,1201247051,2000
US,social insurance administration,85910,278877349,8035,13557051,918607,91184,292434400,2000
US,solid waste management,1807,7469216,108,272097,13058,1882,7741313,2000
US,sewage disposal,1433,5677558,48,143715,5846,1466,5821273,2000
US,parks and recreation,27283,74049350,11273,10757048,1044379,33237,84806398,2000
US,housing and community development,0,0,0,0,0,0,0,2000
US,natural resources,130137,423545866,36022,36738253,3257187,148679,460284119,2000
US,water transport and terminals,822,3139548,41,74126,4055,844,3213674,2000
US,electric power,5387,29883399,89,173083,8560,5437,30056482,2000
US,gas supply,0,0,0,0,0,0,0,2000
US,transit,27730,122254452,1665,1722996,152120,28589,123977448,2000
US,elem and sec instruction,31573,114704679,8312,5862844,359203,33826,120567523,2000
US,elem and sec admin/cler,3683,10439011,167,122964,9276,3738,10561975,2000
US,elem and sec oper/maint,3621,8679535,2355,1181474,102777,4246,9861009,2000
US,elem and sec cafeteria,1995,3875452,844,397433,42969,2286,4272885,2000
US,elem and sec bus transit,35,90450,70,60672,6847,82,151122,2000
US,elem and sec health/rec,268,1148107,221,474214,22051,400,1622321,2000
US,elem and sec student,0,0,595,88599,15091,94,88599,2000
US,elem and sec unalloc,206,315839,1911,680621,69150,640,996460,2000
US,higher ed - instructional,346019,1822636457,330551,441354804,21970217,471506,2263991261,2000
US,education - higher education other,689825,2059187621,722982,460504520,44543959,944285,2519692141,2000
US,education - other,93669,301874311,20560,21609874,1361205,101475,323484185,2000
US,libraries,490,1190828,231,133562,9122,545,1324390,2000
US,liquor stores,5777,14883580,2920,2183004,234789,7122,17066584,2000
US,other and unallocable,195246,704743391,19655,23848651,1570778,204183,728592042,2000
AL,total,70063,199029594,24191,17723434,1686482,79631,216753028,2000
AL,financial administration,2446,7437827,209,151502,24547,2585,7589329,2000
AL,other government administration,547,1809326,88,96523,5900,581,1905849,2000
AL,judicial and legal,2925,9899508,154,188910,21318,3046,10088418,2000
AL,police arrest,745,2710510,0,0,0,745,2710510,2000
AL,police other,595,1445303,22,10809,2221,608,1456112,2000
AL,corrections,4368,11474360,9,7797,848,4372,11482157,2000
AL,streets and highways,3772,8484801,62,49620,5491,3803,8534421,2000
AL,air transportation,0,0,0,0,0,0,0,2000
AL,water transportation,389,1151364,1,1500,20,389,1152864,2000
AL,public welfare,3777,10078766,35,45534,3300,3795,10124300,2000
AL,health,4918,13039942,524,486189,65369,5287,13526131,2000
AL,hospitals,10600,24739099,1228,1764239,101547,11173,26503338,2000
AL,social insurance administration,1359,3460825,43,25443,3793,1380,3486268,2000
AL,solid waste management,0,0,0,0,0,0,0,2000
AL,sewage disposal,0,0,0,0,0,0,0,2000
AL,parks and recreation,398,843049,440,355817,27370,553,1198866,2000
AL,housing and community development,0,0,0,0,0,0,0,2000
AL,natural resources,2033,6013921,499,409393,43195,2278,6423314,2000
AL,water transport and terminals,0,0,0,0,0,0,0,2000
AL,electric power,0,0,0,0,0,0,0,2000
AL,gas supply,0,0,0,0,0,0,0,2000
AL,transit,0,0,0,0,0,0,0,2000
AL,elem and sec instruction,0,0,0,0,0,0,0,2000
AL,elem and sec admin/cler,0,0,0,0,0,0,0,2000
AL,elem and sec oper/maint,0,0,0,0,0,0,0,2000
AL,elem and sec cafeteria,0,0,0,0,0,0,0,2000
AL,elem and sec bus transit,0,0,0,0,0,0,0,2000
AL,elem and sec health/rec,0,0,0,0,0,0,0,2000
AL,elem and sec student,0,0,0,0,0,0,0,2000
AL,elem and sec unalloc,0,0,0,0,0,0,0,2000
AL,higher ed - instructional,8897,41197142,6573,6475387,426713,11322,47672529,2000
AL,education - higher education other,16226,37163530,13071,6770773,867837,21156,43934303,2000
AL,education - other,3387,10855596,700,433041,32211,3570,11288637,2000
AL,libraries,0,0,0,0,0,0,0,2000
AL,liquor stores,633,1271042,7,6666,846,638,1277708,2000
AL,other and unallocable,2048,5953683,526,444291,53956,2350,6397974,2000
AK,total,21139,81222233,5249,4342141,300332,22885,85564374,2000
AK,financial administration,941,3601635,28,46398,2397,956,3648033,2000
AK,other government administration,510,1795382,42,60710,3927,534,1856092,2000
AK,judicial and legal,1166,4834087,83,113501,5498,1199,4947588,2000
AK,police arrest,310,1625429,0,0,0,310,1625429,2000
AK,police other,114,380850,83,32424,2679,130,413274,2000
AK,corrections,1583,6273760,20,23587,2234,1597,6297347,2000
AK,streets and highways,2714,11183105,27,34263,2546,2729,11217368,2000
AK,air transportation,0,0,0,0,0,0,0,2000
AK,water transportation,0,0,0,0,0,0,0,2000
AK,public welfare,1599,5066257,155,186933,20784,1724,5253190,2000
AK,health,623,2367023,41,50211,2997,642,2417234,2000
AK,hospitals,227,802893,7,17375,1172,234,820268,2000
AK,social insurance administration,424,1422492,14,24524,1186,431,1447016,2000
AK,solid waste management,0,0,0,0,0,0,0,2000
AK,sewage disposal,0,0,0,0,0,0,0,2000
AK,parks and recreation,84,298620,0,0,0,84,298620,2000
AK,housing and community development,0,0,0,0,0,0,0,2000
AK,natural resources,1966,7477694,67,57771,4501,1992,7535465,2000
AK,water transport and terminals,0,0,0,0,0,0,0,2000
AK,electric power,0,0,0,0,0,0,0,2000
AK,gas supply,0,0,0,0,0,0,0,2000
AK,transit,0,0,0,0,0,0,0,2000
AK,elem and sec instruction,1966,7532647,571,445391,32148,2162,7978038,2000
AK,elem and sec admin/cler,298,1023157,69,63675,4346,324,1086832,2000
AK,elem and sec oper/maint,254,719036,203,180657,12699,330,899693,2000
AK,elem and sec cafeteria,96,193492,149,122335,8384,148,315827,2000
AK,elem and sec bus transit,1,2695,16,11334,1099,8,14029,2000
AK,elem and sec health/rec,22,33212,1,761,63,22,33973,2000
AK,elem and sec student,0,0,17,2771,461,2,2771,2000
AK,elem and sec unalloc,16,44715,91,58866,4365,43,103581,2000
AK,higher ed - instructional,978,5481908,1442,1468389,46439,1240,6950297,2000
AK,education - higher education other,2374,7574672,2021,1231911,133298,3127,8806583,2000
AK,education - other,355,1298299,46,33619,2458,370,1331918,2000
AK,libraries,0,0,0,0,0,0,0,2000
AK,liquor stores,0,0,0,0,0,0,0,2000
AK,other and unallocable,2518,10189173,56,74735,4651,2547,10263908,2000
AZ,total,55752,170321852,23212,18994107,1608241,64846,189315959,2000
AZ,financial administration,3338,9005149,39,59591,2876,3355,9064740,2000
AZ,other government administration,550,1671757,114,167906,7704,594,1839663,2000
AZ,judicial and legal,1291,5242969,96,179599,9553,1346,5422568,2000
AZ,police arrest,1066,4138933,0,0,0,1066,4138933,2000
AZ,police other,835,2578061,1,1140,89,836,2579201,2000
AZ,corrections,9524,25639120,107,179555,10178,9582,25818675,2000
AZ,streets and highways,3034,8829952,0,0,0,3034,8829952,2000
AZ,air transportation,0,0,0,0,0,0,0,2000
AZ,water transportation,0,0,0,0,0,0,0,2000
AZ,public welfare,5588,13739263,81,114163,8240,5635,13853426,2000
AZ,health,2224,5955559,39,72011,4567,2250,6027570,2000
AZ,hospitals,673,1974352,55,108415,6489,710,2082767,2000
AZ,social insurance administration,2075,4696738,11,15806,1373,2083,4712544,2000
AZ,solid waste management,0,0,0,0,0,0,0,2000
AZ,sewage disposal,0,0,0,0,0,0,0,2000
AZ,parks and recreation,388,795874,101,67294,8194,435,863168,2000
AZ,housing and community development,0,0,0,0,0,0,0,2000
AZ,natural resources,2061,6303758,684,612862,53125,2359,6916620,2000
AZ,water transport and terminals,0,0,0,0,0,0,0,2000
AZ,electric power,7,29096,5,420,30,7,29516,2000
AZ,gas supply,0,0,0,0,0,0,0,2000
AZ,transit,0,0,0,0,0,0,0,2000
AZ,elem and sec instruction,0,0,0,0,0,0,0,2000
AZ,elem and sec admin/cler,0,0,0,0,0,0,0,2000
AZ,elem and sec oper/maint,0,0,0,0,0,0,0,2000
AZ,elem and sec cafeteria,0,0,0,0,0,0,0,2000
AZ,elem and sec bus transit,0,0,0,0,0,0,0,2000
AZ,elem and sec health/rec,0,0,0,0,0,0,0,2000
AZ,elem and sec student,0,0,0,0,0,0,0,2000
AZ,elem and sec unalloc,0,0,0,0,0,0,0,2000
AZ,higher ed - instructional,4975,27660509,5995,7289150,457087,7558,34949659,2000
AZ,education - higher education other,11678,35554444,15388,9318316,988047,17262,44872760,2000
AZ,education - other,2771,6315515,338,632905,38351,2988,6948420,2000
AZ,libraries,0,0,0,0,0,0,0,2000
AZ,liquor stores,0,0,0,0,0,0,0,2000
AZ,other and unallocable,3674,10190803,158,174974,12338,3746,10365777,2000
AR,total,44500,126480151,12167,10138653,757951,48791,136618804,2000
AR,financial administration,1786,4448814,130,107984,16157,1878,4556798,2000
AR,other government administration,467,1492536,66,102281,7175,508,1594817,2000
AR,judicial and legal,405,2069641,13,20621,1151,412,2090262,2000
AR,police arrest,590,1842805,0,0,0,590,1842805,2000
AR,police other,560,1319407,1,1142,89,561,1320549,2000
AR,corrections,3752,7935393,19,18560,2400,3766,7953953,2000
AR,streets and highways,3377,9422374,36,22415,3210,3395,9444789,2000
AR,air transportation,0,0,0,0,0,0,0,2000
AR,water transportation,0,0,0,0,0,0,0,2000
AR,public welfare,2159,5368719,0,0,0,2159,5368719,2000
AR,health,4700,11521196,100,83078,7751,4743,11604274,2000
AR,hospitals,3903,10022217,159,218499,8864,3953,10240716,2000
AR,social insurance administration,868,2615066,198,199840,23110,999,2814906,2000
AR,solid waste management,0,0,0,0,0,0,0,2000
AR,sewage disposal,0,0,0,0,0,0,0,2000
AR,parks and recreation,595,1272260,249,140693,22988,725,1412953,2000
AR,housing and community development,0,0,0,0,0,0,0,2000
AR,natural resources,2138,5812619,306,249017,41577,2373,6061636,2000
AR,water transport and terminals,0,0,0,0,0,0,0,2000
AR,electric power,0,0,0,0,0,0,0,2000
AR,gas supply,0,0,0,0,0,0,0,2000
AR,transit,0,0,0,0,0,0,0,2000
AR,elem and sec instruction,0,0,0,0,0,0,0,2000
AR,elem and sec admin/cler,0,0,0,0,0,0,0,2000
AR,elem and sec oper/maint,0,0,0,0,0,0,0,2000
AR,elem and sec cafeteria,0,0,0,0,0,0,0,2000
AR,elem and sec bus transit,0,0,0,0,0,0,0,2000
AR,elem and sec health/rec,0,0,0,0,0,0,0,2000
AR,elem and sec student,0,0,0,0,0,0,0,2000
AR,elem and sec unalloc,0,0,0,0,0,0,0,2000
AR,higher ed - instructional,5073,25475834,3713,4369502,175782,6065,29845336,2000
AR,education - higher education other,9240,22475795,6307,3984015,394957,11477,26459810,2000
AR,education - other,2754,7371096,735,467751,40004,2982,7838847,2000
AR,libraries,0,0,0,0,0,0,0,2000
AR,liquor stores,0,0,0,0,0,0,0,2000
AR,other and unallocable,2133,6014379,135,153255,12736,2205,6167634,2000
CA,total,302913,1348347111,141156,162842450,9274908,355327,1511189561,2000
CA,financial administration,19600,72330023,4242,5899307,466222,22234,78229330,2000
CA,other government administration,3578,15553647,393,794723,40225,3821,16348370,2000
CA,judicial and legal,3392,18397327,450,850570,39595,3615,19247897,2000
CA,police arrest,7255,40370003,523,629324,15614,7343,40999327,2000
CA,police other,5072,17335339,1039,980293,75834,5500,18315632,2000
CA,corrections,45244,192742628,2840,6632139,361066,47283,199374767,2000
CA,streets and highways,20392,91318029,1142,2730780,110708,21018,94048809,2000
CA,air transportation,0,0,0,0,0,0,0,2000
CA,water transportation,72,289567,12,10349,641,76,299916,2000
CA,public welfare,3508,13694027,559,652947,31778,3688,14346974,2000
CA,health,10557,45805531,1505,2817528,131760,11301,48623059,2000
CA,hospitals,27345,118410254,6596,12438265,602771,30750,130848519,2000
CA,social insurance administration,15264,59018285,2846,6065016,355346,17272,65083301,2000
CA,solid waste management,369,1698604,64,185655,7905,414,1884259,2000
CA,sewage disposal,0,0,0,0,0,0,0,2000
CA,parks and recreation,2044,7618366,1598,2265102,185062,3089,9883468,2000
CA,housing and community development,0,0,0,0,0,0,0,2000
CA,natural resources,11550,50194032,3705,4246911,445052,14063,54440943,2000
CA,water transport and terminals,0,0,0,0,0,0,0,2000
CA,electric power,0,0,0,0,0,0,0,2000
CA,gas supply,0,0,0,0,0,0,0,2000
CA,transit,0,0,0,0,0,0,0,2000
CA,elem and sec instruction,0,0,0,0,0,0,0,2000
CA,elem and sec admin/cler,0,0,0,0,0,0,0,2000
CA,elem and sec oper/maint,0,0,0,0,0,0,0,2000
CA,elem and sec cafeteria,0,0,0,0,0,0,0,2000
CA,elem and sec bus transit,0,0,0,0,0,0,0,2000
CA,elem and sec health/rec,0,0,0,0,0,0,0,2000
CA,elem and sec student,0,0,0,0,0,0,0,2000
CA,elem and sec unalloc,0,0,0,0,0,0,0,2000
CA,higher ed - instructional,19777,133420569,26538,39658910,1570516,28649,173079479,2000
CA,education - higher education other,69927,285229004,82572,67249680,4442342,95024,352478684,2000
CA,education - other,4378,17311641,679,1106260,63304,4737,18417901,2000
CA,libraries,0,0,0,0,0,0,0,2000
CA,liquor stores,0,0,0,0,0,0,0,2000
CA,other and unallocable,33589,167610235,3853,7628691,329167,35450,175238926,2000
CO,total,45921,173546791,35615,68785093,3505938,65726,242331884,2000
CO,financial administration,1990,7433085,167,258166,13317,2064,7691251,2000
CO,other government administration,445,1410511,118,278619,19132,553,1689130,2000
CO,judicial and legal,2968,11143417,805,1572309,81451,3428,12715726,2000
CO,police arrest,706,3363033,1,782,80,706,3363815,2000
CO,police other,438,1719381,0,0,0,438,1719381,2000
CO,corrections,6043,20142827,80,178926,9738,6097,20321753,2000
CO,streets and highways,2940,10331644,183,337278,18738,3046,10668922,2000
CO,air transportation,0,0,0,0,0,0,0,2000
CO,water transportation,0,0,0,0,0,0,0,2000
CO,public welfare,1801,6378714,202,314237,17054,1897,6692951,2000
CO,health,1023,4491643,168,362689,15938,1113,4854332,2000
CO,hospitals,3221,9916964,959,1844662,110628,3846,11761626,2000
CO,social insurance administration,868,3321252,55,70772,4539,894,3392024,2000
CO,solid waste management,0,0,0,0,0,0,0,2000
CO,sewage disposal,0,0,0,0,0,0,0,2000
CO,parks and recreation,192,691239,113,88753,5917,225,779992,2000
CO,housing and community development,0,0,0,0,0,0,0,2000
CO,natural resources,1290,4642111,285,332703,15235,1376,4974814,2000
CO,water transport and terminals,0,0,0,0,0,0,0,2000
CO,electric power,0,0,0,0,0,0,0,2000
CO,gas supply,0,0,0,0,0,0,0,2000
CO,transit,0,0,0,0,0,0,0,2000
CO,elem and sec instruction,0,0,0,0,0,0,0,2000
CO,elem and sec admin/cler,0,0,0,0,0,0,0,2000
CO,elem and sec oper/maint,0,0,0,0,0,0,0,2000
CO,elem and sec cafeteria,0,0,0,0,0,0,0,2000
CO,elem and sec bus transit,0,0,0,0,0,0,0,2000
CO,elem and sec health/rec,0,0,0,0,0,0,0,2000
CO,elem and sec student,0,0,0,0,0,0,0,2000
CO,elem and sec unalloc,0,0,0,0,0,0,0,2000
CO,higher ed - instructional,9179,47082660,9867,30142795,753334,13434,77225455,2000
CO,education - higher education other,10312,32232180,21890,32034016,2386612,23797,64266196,2000
CO,education - other,1037,3557987,633,824227,46582,1301,4382214,2000
CO,libraries,0,0,0,0,0,0,0,2000
CO,liquor stores,0,0,0,0,0,0,0,2000
CO,other and unallocable,1468,5688143,89,144159,7643,1511,5832302,2000
CT,total,58270,227772442,15955,19397181,1226251,65820,247169623,2000
CT,financial administration,2708,9375899,60,147019,6821,2751,9522918,2000
CT,other government administration,1019,4072445,253,701251,38143,1238,4773696,2000
CT,judicial and legal,3982,14996431,175,491705,24170,4138,15488136,2000
CT,police arrest,1054,5116014,0,0,0,1054,5116014,2000
CT,police other,616,2251868,64,140446,8372,670,2392314,2000
CT,corrections,8953,31974234,77,193382,7765,9003,32167616,2000
CT,streets and highways,3613,12376510,0,0,0,3613,12376510,2000
CT,air transportation,34,176673,0,0,0,34,176673,2000
CT,water transportation,0,0,0,0,0,0,0,2000
CT,public welfare,4663,17730145,183,467236,21924,4804,18197381,2000
CT,health,2004,7508586,89,230893,10175,2066,7739479,2000
CT,hospitals,9271,37639009,1982,4128901,198874,10501,41767910,2000
CT,social insurance administration,963,3676675,15,46118,1782,974,3722793,2000
CT,solid waste management,50,233617,8,19346,932,56,252963,2000
CT,sewage disposal,0,0,0,0,0,0,0,2000
CT,parks and recreation,131,457262,15,32661,2553,145,489923,2000
CT,housing and community development,0,0,0,0,0,0,0,2000
CT,natural resources,768,2675324,68,143033,8287,818,2818357,2000
CT,water transport and terminals,0,0,0,0,0,0,0,2000
CT,electric power,0,0,0,0,0,0,0,2000
CT,gas supply,0,0,0,0,0,0,0,2000
CT,transit,0,0,0,0,0,0,0,2000
CT,elem and sec instruction,2287,11602956,650,852152,67910,2765,12455108,2000
CT,elem and sec admin/cler,290,1062945,0,0,0,290,1062945,2000
CT,elem and sec oper/maint,248,242731,0,0,0,248,242731,2000
CT,elem and sec cafeteria,101,98854,253,68342,7873,156,167196,2000
CT,elem and sec bus transit,1,1180,0,0,0,1,1180,2000
CT,elem and sec health/rec,53,197962,0,0,0,53,197962,2000
CT,elem and sec student,0,0,60,6448,1027,7,6448,2000
CT,elem and sec unalloc,114,123902,0,0,0,114,123902,2000
CT,higher ed - instructional,3766,20844928,6080,7557681,419454,6292,28402609,2000
CT,education - higher education other,6610,25815636,5546,3471071,359080,8792,29286707,2000
CT,education - other,2583,8746898,243,424585,25093,2745,9171483,2000
CT,libraries,0,0,0,0,0,0,0,2000
CT,liquor stores,0,0,0,0,0,0,0,2000
CT,other and unallocable,2388,8773758,134,274911,16016,2492,9048669,2000
DE,total,20911,67371647,7356,6345291,465149,23743,73716938,2000
DE,financial administration,744,2037409,67,70780,7034,786,2108189,2000
DE,other government administration,238,741131,121,207454,10296,297,948585,2000
DE,judicial and legal,1436,4424305,24,36409,1726,1447,4460714,2000
DE,police arrest,591,2747024,0,0,0,591,2747024,2000
DE,police other,281,793662,50,48196,4834,309,841858,2000
DE,corrections,2307,6996518,153,197058,19862,2423,7193576,2000
DE,streets and highways,1594,4081078,23,17742,1774,1605,4098820,2000
DE,air transportation,0,0,0,0,0,0,0,2000
DE,water transportation,0,0,0,0,0,0,0,2000
DE,public welfare,1598,4481360,144,157736,12618,1675,4639096,2000
DE,health,1617,5626978,257,240168,19568,1735,5867146,2000
DE,hospitals,2159,5115770,136,159072,12350,2234,5274842,2000
DE,social insurance administration,168,457154,4,5694,490,171,462848,2000
DE,solid waste management,81,231354,15,11376,1224,88,242730,2000
DE,sewage disposal,0,0,0,0,0,0,0,2000
DE,parks and recreation,185,490748,135,81184,9132,240,571932,2000
DE,housing and community development,0,0,0,0,0,0,0,2000
DE,natural resources,399,1226104,112,116136,7568,445,1342240,2000
DE,water transport and terminals,0,0,0,0,0,0,0,2000
DE,electric power,0,0,0,0,0,0,0,2000
DE,gas supply,0,0,0,0,0,0,0,2000
DE,transit,535,1674848,23,33191,3313,554,1708039,2000
DE,elem and sec instruction,0,0,0,0,0,0,0,2000
DE,elem and sec admin/cler,0,0,0,0,0,0,0,2000
DE,elem and sec oper/maint,0,0,0,0,0,0,0,2000
DE,elem and sec cafeteria,0,0,0,0,0,0,0,2000
DE,elem and sec bus transit,0,0,0,0,0,0,0,2000
DE,elem and sec health/rec,0,0,0,0,0,0,0,2000
DE,elem and sec student,0,0,0,0,0,0,0,2000
DE,elem and sec unalloc,0,0,0,0,0,0,0,2000
DE,higher ed - instructional,1477,8309514,2224,2638480,149772,2388,10947994,2000
DE,education - higher education other,3634,12059142,3643,2111720,184220,4770,14170862,2000
DE,education - other,319,1204154,6,10948,664,323,1215102,2000
DE,libraries,0,0,0,0,0,0,0,2000
DE,liquor stores,0,0,0,0,0,0,0,2000
DE,other and unallocable,1548,4673394,219,201947,18704,1662,4875341,2000
FL,total,165855,522325512,41575,46175592,3418887,185170,568501104,2000
FL,financial administration,6502,20497793,305,221200,29680,6671,20718993,2000
FL,other government administration,1646,6397199,397,1144903,51743,1937,7542102,2000
FL,judicial and legal,16785,56232774,1247,1854039,169366,17743,58086813,2000
FL,police arrest,2618,7659059,0,0,0,2618,7659059,2000
FL,police other,1786,4035431,123,115770,11332,1850,4151201,2000
FL,corrections,28255,95177759,246,373053,17459,28354,95550812,2000
FL,streets and highways,9892,28738778,432,414198,27812,10050,29152976,2000
FL,air transportation,0,0,0,0,0,0,0,2000
FL,water transportation,0,0,6,4900,240,1,4900,2000
FL,public welfare,13839,33344246,98,102896,8612,13887,33447142,2000
FL,health,18782,46896482,937,1528434,109941,19403,48424916,2000
FL,hospitals,6463,15115386,50,65043,4353,6488,15180429,2000
FL,social insurance administration,3044,9615720,28,40349,2644,3059,9656069,2000
FL,solid waste management,0,0,0,0,0,0,0,2000
FL,sewage disposal,0,0,0,0,0,0,0,2000
FL,parks and recreation,1075,2243733,11,7416,924,1080,2251149,2000
FL,housing and community development,0,0,0,0,0,0,0,2000
FL,natural resources,6914,19019835,3404,3973603,291700,8562,22993438,2000
FL,water transport and terminals,0,0,0,0,0,0,0,2000
FL,electric power,0,0,0,0,0,0,0,2000
FL,gas supply,0,0,0,0,0,0,0,2000
FL,transit,548,1607302,28,28148,1876,559,1635450,2000
FL,elem and sec instruction,0,0,0,0,0,0,0,2000
FL,elem and sec admin/cler,0,0,0,0,0,0,0,2000
FL,elem and sec oper/maint,0,0,0,0,0,0,0,2000
FL,elem and sec cafeteria,0,0,0,0,0,0,0,2000
FL,elem and sec bus transit,0,0,0,0,0,0,0,2000
FL,elem and sec health/rec,0,0,0,0,0,0,0,2000
FL,elem and sec student,0,0,0,0,0,0,0,2000
FL,elem and sec unalloc,0,0,0,0,0,0,0,2000
FL,higher ed - instructional,13717,80569246,15452,20450855,1040535,19594,101020101,2000
FL,education - higher education other,21487,57643947,17974,14942033,1579096,30408,72585980,2000
FL,education - other,2707,7764031,208,194999,19284,2816,7959030,2000
FL,libraries,0,0,0,0,0,0,0,2000
FL,liquor stores,0,0,0,0,0,0,0,2000
FL,other and unallocable,9795,29766791,629,713753,52290,10090,30480544,2000
GA,total,104544,303104603,37923,36043219,2740537,120028,339147822,2000
GA,financial administration,2722,8541667,629,993420,96842,3269,9535087,2000
GA,other government administration,660,2439002,607,1040184,59218,995,3479186,2000
GA,judicial and legal,1237,6170926,175,157778,10192,1294,6328704,2000
GA,police arrest,1192,3961862,0,0,0,1192,3961862,2000
GA,police other,992,2670280,30,52394,4680,1018,2722674,2000
GA,corrections,18994,44065552,563,699326,60540,19336,44764878,2000
GA,streets and highways,5879,14820574,145,291644,18992,5986,15112218,2000
GA,air transportation,0,0,0,0,0,0,0,2000
GA,water transportation,657,2321373,0,0,0,657,2321373,2000
GA,public welfare,9147,21838500,351,603160,46974,9413,22441660,2000
GA,health,3864,12133856,322,642296,43852,4112,12776152,2000
GA,hospitals,10729,26297918,1657,3510836,239860,12085,29808754,2000
GA,social insurance administration,2030,5619774,73,148004,10560,2090,5767778,2000
GA,solid waste management,0,0,0,0,0,0,0,2000
GA,sewage disposal,0,0,0,0,0,0,0,2000
GA,parks and recreation,1137,2492142,947,705725,87534,1631,3197867,2000
GA,housing and community development,0,0,0,0,0,0,0,2000
GA,natural resources,4138,11577435,1164,1136282,114533,4783,12713717,2000
GA,water transport and terminals,0,0,0,0,0,0,0,2000
GA,electric power,0,0,0,0,0,0,0,2000
GA,gas supply,0,0,0,0,0,0,0,2000
GA,transit,0,0,0,0,0,0,0,2000
GA,elem and sec instruction,0,0,0,0,0,0,0,2000
GA,elem and sec admin/cler,0,0,0,0,0,0,0,2000
GA,elem and sec oper/maint,0,0,0,0,0,0,0,2000
GA,elem and sec cafeteria,0,0,0,0,0,0,0,2000
GA,elem and sec bus transit,0,0,0,0,0,0,0,2000
GA,elem and sec health/rec,0,0,0,0,0,0,0,2000
GA,elem and sec student,0,0,0,0,0,0,0,2000
GA,elem and sec unalloc,0,0,0,0,0,0,0,2000
GA,higher ed - instructional,10406,52570723,8925,10922472,531076,13403,63493195,2000
GA,education - higher education other,20682,53224949,17331,10792385,1101875,26911,64017334,2000
GA,education - other,6346,20645882,3708,3809629,253123,7777,24455511,2000
GA,libraries,0,0,0,0,0,0,0,2000
GA,liquor stores,0,0,0,0,0,0,0,2000
GA,other and unallocable,3732,11712188,1296,537684,60686,4076,12249872,2000
HI,total,49090,143643750,18660,15001646,990077,54832,158645396,2000
HI,financial administration,707,2173856,0,0,0,707,2173856,2000
HI,other government administration,561,1883318,28,36796,1549,570,1920114,2000
HI,judicial and legal,2123,6906946,48,102472,2920,2140,7009418,2000
HI,police arrest,0,0,0,0,0,0,0,2000
HI,police other,0,0,0,0,0,0,0,2000
HI,corrections,2383,6420612,18,40088,2186,2396,6460700,2000
HI,streets and highways,950,2748292,0,0,0,950,2748292,2000
HI,air transportation,1140,2691210,2,1114,136,1141,2692324,2000
HI,water transportation,216,571290,0,0,0,216,571290,2000
HI,public welfare,810,2283954,0,0,0,810,2283954,2000
HI,health,2788,8032830,31,59290,3134,2806,8092120,2000
HI,hospitals,3326,8589120,145,325426,12326,3395,8914546,2000
HI,social insurance administration,319,837694,48,69126,5990,353,906820,2000
HI,solid waste management,0,0,0,0,0,0,0,2000
HI,sewage disposal,0,0,0,0,0,0,0,2000
HI,parks and recreation,145,344408,158,87286,8516,193,431694,2000
HI,housing and community development,0,0,0,0,0,0,0,2000
HI,natural resources,1091,3556296,339,418764,26278,1240,3975060,2000
HI,water transport and terminals,0,0,0,0,0,0,0,2000
HI,electric power,0,0,0,0,0,0,0,2000
HI,gas supply,0,0,0,0,0,0,0,2000
HI,transit,0,0,0,0,0,0,0,2000
HI,elem and sec instruction,17924,51315366,6543,4088508,237014,19352,55403874,2000
HI,elem and sec admin/cler,1733,4676460,38,27444,1800,1744,4703904,2000
HI,elem and sec oper/maint,1331,2390874,2040,804926,79304,1809,3195800,2000
HI,elem and sec cafeteria,1379,2513008,0,0,0,1379,2513008,2000
HI,elem and sec bus transit,0,0,0,0,0,0,0,2000
HI,elem and sec health/rec,81,308580,219,472902,21964,213,781482,2000
HI,elem and sec student,0,0,466,60754,10124,61,60754,2000
HI,elem and sec unalloc,59,94044,1435,253582,28176,229,347626,2000
HI,higher ed - instructional,1991,10565908,1359,1967158,72858,2403,12533066,2000
HI,education - higher education other,3536,11967786,5415,5963582,458736,6128,17931368,2000
HI,education - other,130,404084,2,3034,160,131,407118,2000
HI,libraries,490,1190828,231,133562,9122,545,1324390,2000
HI,liquor stores,0,0,0,0,0,0,0,2000
HI,other and unallocable,3877,11176986,95,85832,7784,3921,11262818,2000
ID,total,18067,54599942,11692,9492848,810333,22647,64092790,2000
ID,financial administration,1341,3905702,219,127840,15524,1429,4033542,2000
ID,other government administration,154,527639,271,409941,34094,346,937580,2000
ID,judicial and legal,444,2022584,22,16532,1369,451,2039116,2000
ID,police arrest,255,963568,0,0,0,255,963568,2000
ID,police other,199,566071,18,43211,2400,213,609282,2000
ID,corrections,1578,4233890,129,58609,7326,1619,4292499,2000
ID,streets and highways,1622,4424245,122,80018,8001,1667,4504263,2000
ID,air transportation,0,0,0,0,0,0,0,2000
ID,water transportation,0,0,0,0,0,0,0,2000
ID,public welfare,1566,4306575,308,430386,26659,1716,4736961,2000
ID,health,1124,3026297,214,255172,19354,1234,3281469,2000
ID,hospitals,887,2075993,184,209467,18852,994,2285460,2000
ID,social insurance administration,488,1813869,248,202107,25264,631,2015976,2000
ID,solid waste management,0,0,0,0,0,0,0,2000
ID,sewage disposal,0,0,0,0,0,0,0,2000
ID,parks and recreation,164,419878,95,43027,5378,194,462905,2000
ID,housing and community development,0,0,0,0,0,0,0,2000
ID,natural resources,1411,4311283,1014,1378494,94935,1947,5689777,2000
ID,water transport and terminals,0,0,0,0,0,0,0,2000
ID,electric power,0,0,0,0,0,0,0,2000
ID,gas supply,0,0,0,0,0,0,0,2000
ID,transit,0,0,0,0,0,0,0,2000
ID,elem and sec instruction,0,0,0,0,0,0,0,2000
ID,elem and sec admin/cler,0,0,0,0,0,0,0,2000
ID,elem and sec oper/maint,0,0,0,0,0,0,0,2000
ID,elem and sec cafeteria,0,0,0,0,0,0,0,2000
ID,elem and sec bus transit,0,0,0,0,0,0,0,2000
ID,elem and sec health/rec,0,0,0,0,0,0,0,2000
ID,elem and sec student,0,0,0,0,0,0,0,2000
ID,elem and sec unalloc,0,0,0,0,0,0,0,2000
ID,higher ed - instructional,2260,9198646,1381,2295834,127113,2978,11494480,2000
ID,education - higher education other,3080,8347441,6714,3738450,399382,5336,12085891,2000
ID,education - other,519,1675287,327,88075,11011,582,1763362,2000
ID,libraries,0,0,0,0,0,0,0,2000
ID,liquor stores,121,335293,106,21002,2626,136,356295,2000
ID,other and unallocable,854,2445681,320,94683,11045,919,2540364,2000
IL,total,110318,379631415,40855,29214407,2887980,127661,408845822,2000
IL,financial administration,5874,18589443,234,339853,28632,6047,18929296,2000
IL,other government administration,2417,8695931,46,82058,4638,2445,8777989,2000
IL,judicial and legal,3069,17490570,112,144284,6598,3110,17634854,2000
IL,police arrest,2195,11236232,0,0,0,2195,11236232,2000
IL,police other,1871,6682504,14,22022,1250,1879,6704526,2000
IL,corrections,15751,52274374,23,60332,1588,15761,52334706,2000
IL,streets and highways,7258,27015381,1377,2840212,166584,8246,29855593,2000
IL,air transportation,0,0,0,0,0,0,0,2000
IL,water transportation,97,399802,2,1090,192,98,400892,2000
IL,public welfare,13861,46976044,580,1013978,78160,14331,47990022,2000
IL,health,2928,10421178,10,18979,1230,2936,10440157,2000
IL,hospitals,9980,19287858,308,540922,29460,10157,19828780,2000
IL,social insurance administration,2486,9425874,200,519290,17016,2588,9945164,2000
IL,solid waste management,0,0,0,0,0,0,0,2000
IL,sewage disposal,0,0,0,0,0,0,0,2000
IL,parks and recreation,692,2095862,77,126246,11282,760,2222108,2000
IL,housing and community development,0,0,0,0,0,0,0,2000
IL,natural resources,3274,11227724,1170,1085156,149511,4176,12312880,2000
IL,water transport and terminals,0,0,0,0,0,0,0,2000
IL,electric power,0,0,0,0,0,0,0,2000
IL,gas supply,0,0,0,0,0,0,0,2000
IL,transit,0,0,0,0,0,0,0,2000
IL,elem and sec instruction,0,0,0,0,0,0,0,2000
IL,elem and sec admin/cler,0,0,0,0,0,0,0,2000
IL,elem and sec oper/maint,0,0,0,0,0,0,0,2000
IL,elem and sec cafeteria,0,0,0,0,0,0,0,2000
IL,elem and sec bus transit,0,0,0,0,0,0,0,2000
IL,elem and sec health/rec,0,0,0,0,0,0,0,2000
IL,elem and sec student,0,0,0,0,0,0,0,2000
IL,elem and sec unalloc,0,0,0,0,0,0,0,2000
IL,higher ed - instructional,9143,45851088,10393,10504998,584292,12661,56356086,2000
IL,education - higher education other,19119,55087338,25958,11409352,1778738,29800,66496690,2000
IL,education - other,2976,10399132,32,59750,3002,2993,10458882,2000
IL,libraries,0,0,0,0,0,0,0,2000
IL,liquor stores,0,0,0,0,0,0,0,2000
IL,other and unallocable,7327,26475080,319,445885,25807,7478,26920965,2000
IN,total,70798,211710609,35039,27348959,2071396,82595,239059568,2000
IN,financial administration,2545,6670014,117,72104,8182,2594,6742118,2000
IN,other government administration,418,1326086,128,123323,6410,456,1449409,2000
IN,judicial and legal,1134,5734497,78,61172,2840,1151,5795669,2000
IN,police arrest,1264,4256946,0,0,0,1264,4256946,2000
IN,police other,706,1354793,1,999,106,707,1355792,2000
IN,corrections,6481,15963631,11,24908,1220,6488,15988539,2000
IN,streets and highways,4292,10601677,2,1756,166,4293,10603433,2000
IN,air transportation,0,0,0,0,0,0,0,2000
IN,water transportation,34,121445,1,573,69,34,122018,2000
IN,public welfare,4986,11209727,46,35832,3527,5007,11245559,2000
IN,health,1648,4919415,2,2993,215,1649,4922408,2000
IN,hospitals,5131,12118818,65,77097,5156,5162,12195915,2000
IN,social insurance administration,1383,3550363,185,173196,20154,1505,3723559,2000
IN,solid waste management,0,0,0,0,0,0,0,2000
IN,sewage disposal,0,0,0,0,0,0,0,2000
IN,parks and recreation,90,233948,19,8990,784,94,242938,2000
IN,housing and community development,0,0,0,0,0,0,0,2000
IN,natural resources,2371,6921423,748,559269,56131,2698,7480692,2000
IN,water transport and terminals,0,0,0,0,0,0,0,2000
IN,electric power,0,0,0,0,0,0,0,2000
IN,gas supply,0,0,0,0,0,0,0,2000
IN,transit,0,0,0,0,0,0,0,2000
IN,elem and sec instruction,0,0,0,0,0,0,0,2000
IN,elem and sec admin/cler,0,0,0,0,0,0,0,2000
IN,elem and sec oper/maint,0,0,0,0,0,0,0,2000
IN,elem and sec cafeteria,0,0,0,0,0,0,0,2000
IN,elem and sec bus transit,0,0,0,0,0,0,0,2000
IN,elem and sec health/rec,0,0,0,0,0,0,0,2000
IN,elem and sec student,0,0,0,0,0,0,0,2000
IN,elem and sec unalloc,0,0,0,0,0,0,0,2000
IN,higher ed - instructional,12562,63406578,11939,17221086,916412,17754,80627664,2000
IN,education - higher education other,22994,55480142,21586,8874120,1042781,28937,64354262,2000
IN,education - other,1116,3290227,75,63147,4104,1140,3353374,2000
IN,libraries,0,0,0,0,0,0,0,2000
IN,liquor stores,0,0,0,0,0,0,0,2000
IN,other and unallocable,1643,4550879,36,48394,3139,1662,4599273,2000
IA,total,42534,155524348,23927,32199281,2241745,55200,187723629,2000
IA,financial administration,1417,4479795,149,201411,18762,1523,4681206,2000
IA,other government administration,528,2080916,318,619591,52454,825,2700507,2000
IA,judicial and legal,2345,8615568,218,321980,23383,2477,8937548,2000
IA,police arrest,668,2613184,0,0,0,668,2613184,2000
IA,police other,315,1054606,41,21580,2095,327,1076186,2000
IA,corrections,3286,10160404,145,285015,14815,3368,10445419,2000
IA,streets and highways,2918,8163800,2,3062,266,2920,8166862,2000
IA,air transportation,0,0,0,0,0,0,0,2000
IA,water transportation,0,0,0,0,0,0,0,2000
IA,public welfare,2778,8576726,84,149744,9967,2834,8726470,2000
IA,health,353,1332018,17,18308,1063,359,1350326,2000
IA,hospitals,6032,21744782,2735,6746876,336143,7931,28491658,2000
IA,social insurance administration,345,966976,4,5663,177,346,972639,2000
IA,solid waste management,0,0,0,0,0,0,0,2000
IA,sewage disposal,0,0,0,0,0,0,0,2000
IA,parks and recreation,107,339081,6,3768,396,109,342849,2000
IA,housing and community development,0,0,0,0,0,0,0,2000
IA,natural resources,2206,7282559,1476,2143346,143384,3016,9425905,2000
IA,water transport and terminals,0,0,0,0,0,0,0,2000
IA,electric power,0,0,0,0,0,0,0,2000
IA,gas supply,0,0,0,0,0,0,0,2000
IA,transit,0,0,0,0,0,0,0,2000
IA,elem and sec instruction,0,0,0,0,0,0,0,2000
IA,elem and sec admin/cler,0,0,0,0,0,0,0,2000
IA,elem and sec oper/maint,0,0,0,0,0,0,0,2000
IA,elem and sec cafeteria,0,0,0,0,0,0,0,2000
IA,elem and sec bus transit,0,0,0,0,0,0,0,2000
IA,elem and sec health/rec,0,0,0,0,0,0,0,2000
IA,elem and sec student,0,0,0,0,0,0,0,2000
IA,elem and sec unalloc,0,0,0,0,0,0,0,2000
IA,higher ed - instructional,4486,28374656,3792,9890551,439564,6970,38265207,2000
IA,education - higher education other,10537,35547883,14575,11272173,1164939,17119,46820056,2000
IA,education - other,1145,3834416,81,90006,6143,1181,3924422,2000
IA,libraries,0,0,0,0,0,0,0,2000
IA,liquor stores,0,0,0,0,0,0,0,2000
IA,other and unallocable,3068,10356978,284,426207,28194,3227,10783185,2000
KS,total,36444,111910671,16282,11832806,1087277,42588,123743477,2000
KS,financial administration,1966,5514854,69,77563,7061,2006,5592417,2000
KS,other government administration,292,1009430,278,362801,25521,438,1372231,2000
KS,judicial and legal,2011,6019417,211,135437,14860,2095,6154854,2000
KS,police arrest,615,2041570,0,0,0,615,2041570,2000
KS,police other,369,839016,20,13544,1424,377,852560,2000
KS,corrections,3582,9105757,23,27657,1914,3594,9133414,2000
KS,streets and highways,3376,9811944,124,109053,10625,3436,9920997,2000
KS,air transportation,0,0,0,0,0,0,0,2000
KS,water transportation,0,0,0,0,0,0,0,2000
KS,public welfare,2656,7308467,10,5659,742,2660,7314126,2000
KS,health,957,3034726,18,29592,2072,969,3064318,2000
KS,hospitals,2789,6985111,175,90210,9087,2841,7075321,2000
KS,social insurance administration,130,329439,0,0,0,130,329439,2000
KS,solid waste management,0,0,0,0,0,0,0,2000
KS,sewage disposal,0,0,0,0,0,0,0,2000
KS,parks and recreation,382,1089153,184,130907,19299,491,1220060,2000
KS,housing and community development,0,0,0,0,0,0,0,2000
KS,natural resources,844,2548601,93,63718,6722,881,2612319,2000
KS,water transport and terminals,0,0,0,0,0,0,0,2000
KS,electric power,0,0,0,0,0,0,0,2000
KS,gas supply,0,0,0,0,0,0,0,2000
KS,transit,0,0,0,0,0,0,0,2000
KS,elem and sec instruction,0,0,0,0,0,0,0,2000
KS,elem and sec admin/cler,0,0,0,0,0,0,0,2000
KS,elem and sec oper/maint,0,0,0,0,0,0,0,2000
KS,elem and sec cafeteria,0,0,0,0,0,0,0,2000
KS,elem and sec bus transit,0,0,0,0,0,0,0,2000
KS,elem and sec health/rec,0,0,0,0,0,0,0,2000
KS,elem and sec student,0,0,0,0,0,0,0,2000
KS,elem and sec unalloc,0,0,0,0,0,0,0,2000
KS,higher ed - instructional,3789,21129314,3168,4625311,193798,4884,25754625,2000
KS,education - higher education other,8826,24092639,11604,5944623,772648,13191,30037262,2000
KS,education - other,592,1833195,35,26126,2298,605,1859321,2000
KS,libraries,0,0,0,0,0,0,0,2000
KS,liquor stores,0,0,0,0,0,0,0,2000
KS,other and unallocable,3268,9218038,270,190605,19206,3375,9408643,2000
KY,total,65413,199606366,26209,18303171,1492329,74137,217909537,2000
KY,financial administration,2935,7916240,193,186398,23368,3076,8102638,2000
KY,other government administration,1096,4105278,534,935848,51804,1409,5041126,2000
KY,judicial and legal,3981,11985826,847,1200492,107058,4627,13186318,2000
KY,police arrest,960,3570568,3,7274,428,963,3577842,2000
KY,police other,1093,3140044,20,21984,2322,1107,3162028,2000
KY,corrections,3643,8699598,143,113514,7916,3691,8813112,2000
KY,streets and highways,5409,15104298,179,284160,22866,5548,15388458,2000
KY,air transportation,0,0,0,0,0,0,0,2000
KY,water transportation,0,0,0,0,0,0,0,2000
KY,public welfare,6675,17378620,51,71556,6342,6712,17450176,2000
KY,health,2078,6033823,48,76250,4935,2109,6110073,2000
KY,hospitals,4971,13769817,406,712664,47666,5243,14482481,2000
KY,social insurance administration,1081,3167518,24,28996,3218,1100,3196514,2000
KY,solid waste management,0,0,0,0,0,0,0,2000
KY,sewage disposal,0,0,0,0,0,0,0,2000
KY,parks and recreation,1612,3073430,173,139530,23196,1752,3212960,2000
KY,housing and community development,0,0,0,0,0,0,0,2000
KY,natural resources,3356,9434698,765,510915,64898,3742,9945613,2000
KY,water transport and terminals,0,0,0,0,0,0,0,2000
KY,electric power,0,0,0,0,0,0,0,2000
KY,gas supply,0,0,0,0,0,0,0,2000
KY,transit,0,0,0,0,0,0,0,2000
KY,elem and sec instruction,0,0,0,0,0,0,0,2000
KY,elem and sec admin/cler,0,0,0,0,0,0,0,2000
KY,elem and sec oper/maint,0,0,0,0,0,0,0,2000
KY,elem and sec cafeteria,0,0,0,0,0,0,0,2000
KY,elem and sec bus transit,0,0,0,0,0,0,0,2000
KY,elem and sec health/rec,0,0,0,0,0,0,0,2000
KY,elem and sec student,0,0,0,0,0,0,0,2000
KY,elem and sec unalloc,0,0,0,0,0,0,0,2000
KY,higher ed - instructional,6716,35896921,5168,6121404,373932,8862,42018325,2000
KY,education - higher education other,12292,32695927,15744,5880105,687498,16292,38576032,2000
KY,education - other,3817,12080696,1697,1880045,54218,4144,13960741,2000
KY,libraries,0,0,0,0,0,0,0,2000
KY,liquor stores,0,0,0,0,0,0,0,2000
KY,other and unallocable,3698,11553064,214,132036,10664,3760,11685100,2000
LA,total,86099,241652952,26405,17335513,1539244,94796,258988465,2000
LA,financial administration,2538,6669489,241,364412,27341,2693,7033901,2000
LA,other government administration,1081,3753817,620,698722,46451,1345,4452539,2000
LA,judicial and legal,1712,6544952,65,41756,4810,1739,6586708,2000
LA,police arrest,979,3486302,0,0,0,979,3486302,2000
LA,police other,667,1514974,11,5466,717,671,1520440,2000
LA,corrections,7427,17677298,391,731169,56242,7745,18408467,2000
LA,streets and highways,5661,13794018,23,19829,3317,5679,13813847,2000
LA,air transportation,0,0,0,0,0,0,0,2000
LA,water transportation,394,1264613,3,2082,221,396,1266695,2000
LA,public welfare,5517,13709935,7,13426,303,5519,13723361,2000
LA,health,5244,16374642,267,331287,20346,5359,16705929,2000
LA,hospitals,19059,45239303,2296,3394432,276345,20620,48633735,2000
LA,social insurance administration,947,2551754,110,80616,7273,988,2632370,2000
LA,solid waste management,0,0,0,0,0,0,0,2000
LA,sewage disposal,0,0,0,0,0,0,0,2000
LA,parks and recreation,997,2261587,441,253432,35418,1198,2515019,2000
LA,housing and community development,0,0,0,0,0,0,0,2000
LA,natural resources,4596,12343614,891,534851,65622,4966,12878465,2000
LA,water transport and terminals,0,0,0,0,0,0,0,2000
LA,electric power,0,0,0,0,0,0,0,2000
LA,gas supply,0,0,0,0,0,0,0,2000
LA,transit,0,0,0,0,0,0,0,2000
LA,elem and sec instruction,0,0,0,0,0,0,0,2000
LA,elem and sec admin/cler,0,0,0,0,0,0,0,2000
LA,elem and sec oper/maint,0,0,0,0,0,0,0,2000
LA,elem and sec cafeteria,0,0,0,0,0,0,0,2000
LA,elem and sec bus transit,0,0,0,0,0,0,0,2000
LA,elem and sec health/rec,0,0,0,0,0,0,0,2000
LA,elem and sec student,0,0,0,0,0,0,0,2000
LA,elem and sec unalloc,0,0,0,0,0,0,0,2000
LA,higher ed - instructional,6831,30558915,4183,3764241,232544,8145,34323156,2000
LA,education - higher education other,16415,47184815,15883,6508643,709618,20424,53693458,2000
LA,education - other,3208,9321145,582,343962,25649,3354,9665107,2000
LA,libraries,0,0,0,0,0,0,0,2000
LA,liquor stores,0,0,0,0,0,0,0,2000
LA,other and unallocable,2826,7401779,391,247187,27027,2976,7648966,2000
ME,total,18008,53717581,7062,5179377,451263,20568,58896958,2000
ME,financial administration,1074,3004882,27,37226,3011,1092,3042108,2000
ME,other government administration,323,1141320,210,249468,15358,411,1390788,2000
ME,judicial and legal,553,1924612,50,62295,6379,592,1986907,2000
ME,police arrest,325,1209324,0,0,0,325,1209324,2000
ME,police other,57,124053,2,2170,217,58,126223,2000
ME,corrections,1164,2899885,12,13682,976,1170,2913567,2000
ME,streets and highways,2528,6835222,164,337822,27974,2686,7173044,2000
ME,air transportation,0,0,0,0,0,0,0,2000
ME,water transportation,52,141563,17,23019,1849,62,164582,2000
ME,public welfare,1998,5245154,61,91145,6075,2033,5336299,2000
ME,health,1186,4299870,45,93437,5311,1216,4393307,2000
ME,hospitals,374,1052207,20,22658,1297,382,1074865,2000
ME,social insurance administration,508,1462058,26,22395,2187,520,1484453,2000
ME,solid waste management,0,0,0,0,0,0,0,2000
ME,sewage disposal,0,0,0,0,0,0,0,2000
ME,parks and recreation,137,391662,24,24013,1884,148,415675,2000
ME,housing and community development,0,0,0,0,0,0,0,2000
ME,natural resources,1144,3343048,263,267018,20143,1258,3610066,2000
ME,water transport and terminals,0,0,0,0,0,0,0,2000
ME,electric power,0,0,0,0,0,0,0,2000
ME,gas supply,0,0,0,0,0,0,0,2000
ME,transit,0,0,0,0,0,0,0,2000
ME,elem and sec instruction,27,81657,9,13238,1395,36,94895,2000
ME,elem and sec admin/cler,1,1810,2,2035,177,2,3845,2000
ME,elem and sec oper/maint,0,0,2,1521,142,1,1521,2000
ME,elem and sec cafeteria,0,0,6,9159,875,6,9159,2000
ME,elem and sec bus transit,5,9691,16,20897,2480,21,30588,2000
ME,elem and sec health/rec,0,0,0,0,0,0,0,2000
ME,elem and sec student,0,0,0,0,0,0,0,2000
ME,elem and sec unalloc,0,0,0,0,0,0,0,2000
ME,higher ed - instructional,1072,4767561,174,255659,14475,1153,5023220,2000
ME,education - higher education other,3183,9133615,5507,3334350,316750,4973,12467965,2000
ME,education - other,1126,3213624,392,256089,19217,1235,3469713,2000
ME,libraries,0,0,0,0,0,0,0,2000
ME,liquor stores,119,282989,13,11660,1198,126,294649,2000
ME,other and unallocable,1052,3151774,20,28421,1893,1062,3180195,2000
MD,total,81831,271052893,15802,26123888,1709443,91487,297176781,2000
MD,financial administration,3515,11399928,122,245746,15978,3605,11645674,2000
MD,other government administration,1368,4861338,385,613812,21903,1492,5475150,2000
MD,judicial and legal,3617,12515214,559,982250,79480,4067,13497464,2000
MD,police arrest,1616,8053071,0,0,0,1616,8053071,2000
MD,police other,774,2183917,28,61162,3631,795,2245079,2000
MD,corrections,11124,35085520,580,1117334,91504,11641,36202854,2000
MD,streets and highways,4748,16925040,0,0,0,4748,16925040,2000
MD,air transportation,462,1823735,0,0,0,462,1823735,2000
MD,water transportation,295,1141810,0,0,0,295,1141810,2000
MD,public welfare,6799,19725287,648,1308099,101061,7370,21033386,2000
MD,health,5587,18026268,991,1524703,115626,6240,19550971,2000
MD,hospitals,5453,15489547,614,714061,56046,5769,16203608,2000
MD,social insurance administration,1057,3413907,169,325777,25027,1198,3739684,2000
MD,solid waste management,0,0,0,0,0,0,0,2000
MD,sewage disposal,0,0,0,0,0,0,0,2000
MD,parks and recreation,491,1792667,112,138353,16426,584,1931020,2000
MD,housing and community development,0,0,0,0,0,0,0,2000
MD,natural resources,2110,7417880,118,175866,13248,2185,7593746,2000
MD,water transport and terminals,0,0,0,0,0,0,0,2000
MD,electric power,0,0,0,0,0,0,0,2000
MD,gas supply,0,0,0,0,0,0,0,2000
MD,transit,2000,7902922,232,287278,26012,2147,8190200,2000
MD,elem and sec instruction,0,0,0,0,0,0,0,2000
MD,elem and sec admin/cler,0,0,0,0,0,0,0,2000
MD,elem and sec oper/maint,0,0,0,0,0,0,0,2000
MD,elem and sec cafeteria,0,0,0,0,0,0,0,2000
MD,elem and sec bus transit,0,0,0,0,0,0,0,2000
MD,elem and sec health/rec,0,0,0,0,0,0,0,2000
MD,elem and sec student,0,0,0,0,0,0,0,2000
MD,elem and sec unalloc,0,0,0,0,0,0,0,2000
MD,higher ed - instructional,11139,41787712,3510,8665512,313728,12912,50453224,2000
MD,education - higher education other,10823,32553934,6571,8195563,695728,14752,40749497,2000
MD,education - other,1897,6677621,222,349619,22346,2023,7027240,2000
MD,libraries,0,0,0,0,0,0,0,2000
MD,liquor stores,0,0,0,0,0,0,0,2000
MD,other and unallocable,6956,22275575,941,1418753,111699,7586,23694328,2000
MA,total,86113,317176857,28011,28080287,1629345,95582,345257144,2000
MA,financial administration,4494,16321036,375,776778,41794,4730,17097814,2000
MA,other government administration,1979,6275740,280,487926,15287,2068,6763666,2000
MA,judicial and legal,10062,36304731,348,478690,28415,10228,36783421,2000
MA,police arrest,4606,18050711,37,52760,3133,4624,18103471,2000
MA,police other,838,2088223,17,14220,1209,845,2102443,2000
MA,corrections,6970,27730046,73,151844,10364,7029,27881890,2000
MA,streets and highways,4100,16636548,232,529360,29636,4267,17165908,2000
MA,air transportation,1111,5958179,158,229869,11954,1179,6188048,2000
MA,water transportation,159,750603,7,9692,735,163,760295,2000
MA,public welfare,7057,24569742,670,1490656,82148,7521,26060398,2000
MA,health,7012,23574080,1094,2564520,151403,7868,26138600,2000
MA,hospitals,8008,24144993,1130,1824957,115877,8663,25969950,2000
MA,social insurance administration,1441,5283301,173,316716,18613,1547,5600017,2000
MA,solid waste management,3,15476,0,0,0,3,15476,2000
MA,sewage disposal,1200,4925055,48,143715,5846,1233,5068770,2000
MA,parks and recreation,920,2646820,106,81553,8460,968,2728373,2000
MA,housing and community development,0,0,0,0,0,0,0,2000
MA,natural resources,1165,4965471,104,277253,11834,1236,5242724,2000
MA,water transport and terminals,700,2717176,38,71405,3940,722,2788581,2000
MA,electric power,0,0,0,0,0,0,0,2000
MA,gas supply,0,0,0,0,0,0,0,2000
MA,transit,0,0,0,0,0,0,0,2000
MA,elem and sec instruction,0,0,0,0,0,0,0,2000
MA,elem and sec admin/cler,0,0,0,0,0,0,0,2000
MA,elem and sec oper/maint,0,0,0,0,0,0,0,2000
MA,elem and sec cafeteria,0,0,0,0,0,0,0,2000
MA,elem and sec bus transit,0,0,0,0,0,0,0,2000
MA,elem and sec health/rec,0,0,0,0,0,0,0,2000
MA,elem and sec student,0,0,0,0,0,0,0,2000
MA,elem and sec unalloc,0,0,0,0,0,0,0,2000
MA,higher ed - instructional,6641,32877159,9386,11051140,587768,10101,43928299,2000
MA,education - higher education other,12751,41522633,13559,7163721,481538,15579,48686354,2000
MA,education - other,1037,4122129,102,207349,10488,1099,4329478,2000
MA,libraries,0,0,0,0,0,0,0,2000
MA,liquor stores,0,0,0,0,0,0,0,2000
MA,other and unallocable,3859,15697005,74,156163,8903,3909,15853168,2000
MI,total,111884,440155051,67216,63587443,5311526,141891,503742494,2000
MI,financial administration,2476,9346704,906,1490440,81548,2936,10837144,2000
MI,other government administration,1501,5176152,18,24121,1403,1509,5200273,2000
MI,judicial and legal,1991,8513433,54,61979,3855,2013,8575412,2000
MI,police arrest,2139,9580647,0,0,0,2139,9580647,2000
MI,police other,1002,3568452,153,150514,12675,1074,3718966,2000
MI,corrections,18295,66816884,221,463142,19151,18403,67280026,2000
MI,streets and highways,3043,11430003,140,196780,10767,3104,11626783,2000
MI,air transportation,0,0,0,0,0,0,0,2000
MI,water transportation,0,0,0,0,0,0,0,2000
MI,public welfare,13251,45972094,264,435786,23825,13385,46407880,2000
MI,health,1729,6789549,226,290331,17097,1825,7079880,2000
MI,hospitals,10312,36100355,3855,7070533,501923,13148,43170888,2000
MI,social insurance administration,1171,4172934,51,38154,1842,1181,4211088,2000
MI,solid waste management,0,0,0,0,0,0,0,2000
MI,sewage disposal,0,0,0,0,0,0,0,2000
MI,parks and recreation,384,1147149,75,137219,8438,432,1284368,2000
MI,housing and community development,0,0,0,0,0,0,0,2000
MI,natural resources,4291,16342144,1185,1188280,116855,4950,17530424,2000
MI,water transport and terminals,0,0,0,0,0,0,0,2000
MI,electric power,0,0,0,0,0,0,0,2000
MI,gas supply,0,0,0,0,0,0,0,2000
MI,transit,0,0,0,0,0,0,0,2000
MI,elem and sec instruction,354,981502,63,66419,4756,382,1047921,2000
MI,elem and sec admin/cler,42,124693,50,20152,2212,54,144845,2000
MI,elem and sec oper/maint,15,29907,2,1048,134,16,30955,2000
MI,elem and sec cafeteria,12,27018,14,7745,1125,18,34763,2000
MI,elem and sec bus transit,5,11435,2,1529,177,6,12964,2000
MI,elem and sec health/rec,5,14687,1,551,24,5,15238,2000
MI,elem and sec student,0,0,3,1373,211,1,1373,2000
MI,elem and sec unalloc,8,33688,1,886,44,8,34574,2000
MI,higher ed - instructional,13647,88287243,15431,22863873,1317796,21093,111151116,2000
MI,education - higher education other,28893,96853590,43009,28101685,3133241,46594,124955275,2000
MI,education - other,361,1499569,58,96774,3923,383,1596343,2000
MI,libraries,0,0,0,0,0,0,0,2000
MI,liquor stores,0,0,0,0,0,0,0,2000
MI,other and unallocable,6957,27335219,1434,878129,48504,7232,28213348,2000
MN,total,58945,229435628,29209,29564998,2561252,73421,259000626,2000
MN,financial administration,2460,9070966,144,226786,19256,2569,9297752,2000
MN,other government administration,1225,4518312,243,467706,30264,1397,4986018,2000
MN,judicial and legal,1778,7857572,359,1029888,52394,2074,8887460,2000
MN,police arrest,541,2671714,0,0,0,541,2671714,2000
MN,police other,380,1281273,28,40614,2980,397,1321887,2000
MN,corrections,3612,12498034,128,268571,17570,3711,12766605,2000
MN,streets and highways,5041,18757398,192,300170,22970,5171,19057568,2000
MN,air transportation,0,0,0,0,0,0,0,2000
MN,water transportation,0,0,0,0,0,0,0,2000
MN,public welfare,1691,5997928,1029,1787431,165596,2627,7785359,2000
MN,health,2094,8274913,186,401361,21784,2218,8676274,2000
MN,hospitals,3637,13413455,1326,2499001,218373,4871,15912456,2000
MN,social insurance administration,1152,4234771,103,202193,12164,1221,4436964,2000
MN,solid waste management,0,0,0,0,0,0,0,2000
MN,sewage disposal,0,0,0,0,0,0,0,2000
MN,parks and recreation,492,1814098,144,190920,14069,572,2005018,2000
MN,housing and community development,0,0,0,0,0,0,0,2000
MN,natural resources,2754,10350051,740,884175,70419,3153,11234226,2000
MN,water transport and terminals,0,0,0,0,0,0,0,2000
MN,electric power,0,0,0,0,0,0,0,2000
MN,gas supply,0,0,0,0,0,0,0,2000
MN,transit,0,0,0,0,0,0,0,2000
MN,elem and sec instruction,0,0,0,0,0,0,0,2000
MN,elem and sec admin/cler,0,0,0,0,0,0,0,2000
MN,elem and sec oper/maint,0,0,0,0,0,0,0,2000
MN,elem and sec cafeteria,0,0,0,0,0,0,0,2000
MN,elem and sec bus transit,0,0,0,0,0,0,0,2000
MN,elem and sec health/rec,0,0,0,0,0,0,0,2000
MN,elem and sec student,0,0,0,0,0,0,0,2000
MN,elem and sec unalloc,0,0,0,0,0,0,0,2000
MN,higher ed - instructional,9364,53192388,8453,10414919,667959,13140,63607307,2000
MN,education - higher education other,15551,48802487,14606,8993232,1130146,21932,57795719,2000
MN,education - other,3933,14530409,1302,1504207,90819,4447,16034616,2000
MN,libraries,0,0,0,0,0,0,0,2000
MN,liquor stores,0,0,0,0,0,0,0,2000
MN,other and unallocable,3240,12169859,226,353824,24489,3380,12523683,2000
MS,total,50594,139230813,13162,8730799,864793,55541,147961612,2000
MS,financial administration,1190,3403551,16,20690,1516,1199,3424241,2000
MS,other government administration,448,1394812,97,102272,7942,492,1497084,2000
MS,judicial and legal,646,2959699,0,0,0,646,2959699,2000
MS,police arrest,666,1934761,0,0,0,666,1934761,2000
MS,police other,516,1255391,0,0,0,516,1255391,2000
MS,corrections,4227,8099225,23,24640,2622,4242,8123865,2000
MS,streets and highways,3287,7544626,7,7800,942,3292,7552426,2000
MS,air transportation,0,0,0,0,0,0,0,2000
MS,water transportation,63,177018,0,0,0,63,177018,2000
MS,public welfare,3089,6624586,0,0,0,3089,6624586,2000
MS,health,3014,7837065,80,173585,9532,3068,8010650,2000
MS,hospitals,10705,23862614,400,873695,50450,10990,24736309,2000
MS,social insurance administration,825,2260352,189,351441,31027,1001,2611793,2000
MS,solid waste management,0,0,0,0,0,0,0,2000
MS,sewage disposal,0,0,0,0,0,0,0,2000
MS,parks and recreation,324,608443,259,135028,20832,442,743471,2000
MS,housing and community development,0,0,0,0,0,0,0,2000
MS,natural resources,3181,7914505,902,547507,65483,3549,8462012,2000
MS,water transport and terminals,0,0,0,0,0,0,0,2000
MS,electric power,0,0,0,0,0,0,0,2000
MS,gas supply,0,0,0,0,0,0,0,2000
MS,transit,0,0,0,0,0,0,0,2000
MS,elem and sec instruction,0,0,0,0,0,0,0,2000
MS,elem and sec admin/cler,0,0,0,0,0,0,0,2000
MS,elem and sec oper/maint,0,0,0,0,0,0,0,2000
MS,elem and sec cafeteria,0,0,0,0,0,0,0,2000
MS,elem and sec bus transit,0,0,0,0,0,0,0,2000
MS,elem and sec health/rec,0,0,0,0,0,0,0,2000
MS,elem and sec student,0,0,0,0,0,0,0,2000
MS,elem and sec unalloc,0,0,0,0,0,0,0,2000
MS,higher ed - instructional,5200,27211877,2311,2048887,148405,6043,29260764,2000
MS,education - higher education other,8637,24422309,8728,4301814,512617,11591,28724123,2000
MS,education - other,1620,4451846,50,47889,5488,1651,4499735,2000
MS,libraries,0,0,0,0,0,0,0,2000
MS,liquor stores,125,283121,0,0,0,125,283121,2000
MS,other and unallocable,2831,6985012,100,95551,7937,2876,7080563,2000
MO,total,82232,220205948,27231,16600977,1626284,91425,236806925,2000
MO,financial administration,2509,6000788,80,90415,7171,2548,6091203,2000
MO,other government administration,1027,2585694,148,144377,11798,1096,2730071,2000
MO,judicial and legal,3628,11329144,388,451397,43296,3872,11780541,2000
MO,police arrest,1162,3919205,0,0,0,1162,3919205,2000
MO,police other,1084,2689302,5,1992,285,1085,2691294,2000
MO,corrections,11376,23563088,506,394450,29679,11544,23957538,2000
MO,streets and highways,6318,17611558,274,186700,21659,6440,17798258,2000
MO,air transportation,0,0,0,0,0,0,0,2000
MO,water transportation,0,0,0,0,0,0,0,2000
MO,public welfare,7884,16760356,592,491227,50680,8170,17251583,2000
MO,health,3345,8458466,288,344300,25663,3490,8802766,2000
MO,hospitals,12625,29574791,1982,1783195,164850,13556,31357986,2000
MO,social insurance administration,623,1633463,12,11698,971,628,1645161,2000
MO,solid waste management,0,0,0,0,0,0,0,2000
MO,sewage disposal,0,0,0,0,0,0,0,2000
MO,parks and recreation,468,1118913,269,115657,23191,599,1234570,2000
MO,housing and community development,0,0,0,0,0,0,0,2000
MO,natural resources,2347,6486732,563,496820,50201,2629,6983552,2000
MO,water transport and terminals,0,0,0,0,0,0,0,2000
MO,electric power,0,0,0,0,0,0,0,2000
MO,gas supply,0,0,0,0,0,0,0,2000
MO,transit,0,0,0,0,0,0,0,2000
MO,elem and sec instruction,0,0,0,0,0,0,0,2000
MO,elem and sec admin/cler,0,0,0,0,0,0,0,2000
MO,elem and sec oper/maint,0,0,0,0,0,0,0,2000
MO,elem and sec cafeteria,0,0,0,0,0,0,0,2000
MO,elem and sec bus transit,0,0,0,0,0,0,0,2000
MO,elem and sec health/rec,0,0,0,0,0,0,0,2000
MO,elem and sec student,0,0,0,0,0,0,0,2000
MO,elem and sec unalloc,0,0,0,0,0,0,0,2000
MO,higher ed - instructional,8100,35766681,7247,5824894,476905,10795,41591575,2000
MO,education - higher education other,12895,34429273,13917,5551311,671358,16697,39980584,2000
MO,education - other,2071,5082463,435,254515,10627,2131,5336978,2000
MO,libraries,0,0,0,0,0,0,0,2000
MO,liquor stores,0,0,0,0,0,0,0,2000
MO,other and unallocable,4770,13196031,525,458029,37950,4983,13654060,2000
MT,total,15447,45270115,7779,5764097,437427,17920,51034212,2000
MT,financial administration,851,2133677,114,119197,12004,919,2252874,2000
MT,other government administration,267,815904,49,47726,3823,289,863630,2000
MT,judicial and legal,164,705013,77,147923,5998,198,852936,2000
MT,police arrest,187,540457,3,4337,288,189,544794,2000
MT,police other,205,593126,31,21387,1639,215,614513,2000
MT,corrections,1032,2622005,58,67244,5362,1062,2689249,2000
MT,streets and highways,1895,5517149,172,201009,16961,1991,5718158,2000
MT,air transportation,0,0,0,0,0,0,0,2000
MT,water transportation,0,0,0,0,0,0,0,2000
MT,public welfare,1386,3570130,219,289841,24241,1523,3859971,2000
MT,health,791,1996968,116,151148,13041,865,2148116,2000
MT,hospitals,503,1237263,104,117067,11586,568,1354330,2000
MT,social insurance administration,659,1724396,39,51624,4718,685,1776020,2000
MT,solid waste management,0,0,0,0,0,0,0,2000
MT,sewage disposal,0,0,0,0,0,0,0,2000
MT,parks and recreation,56,142697,25,10027,1025,62,152724,2000
MT,housing and community development,0,0,0,0,0,0,0,2000
MT,natural resources,1215,3447372,223,226528,20456,1331,3673900,2000
MT,water transport and terminals,0,0,0,0,0,0,0,2000
MT,electric power,0,0,0,0,0,0,0,2000
MT,gas supply,0,0,0,0,0,0,0,2000
MT,transit,0,0,0,0,0,0,0,2000
MT,elem and sec instruction,0,0,0,0,0,0,0,2000
MT,elem and sec admin/cler,0,0,0,0,0,0,0,2000
MT,elem and sec oper/maint,0,0,0,0,0,0,0,2000
MT,elem and sec cafeteria,0,0,0,0,0,0,0,2000
MT,elem and sec bus transit,0,0,0,0,0,0,0,2000
MT,elem and sec health/rec,0,0,0,0,0,0,0,2000
MT,elem and sec student,0,0,0,0,0,0,0,2000
MT,elem and sec unalloc,0,0,0,0,0,0,0,2000
MT,higher ed - instructional,1589,7532064,1270,2289191,101485,2162,9821255,2000
MT,education - higher education other,3071,8370874,4954,1687897,186186,4122,10058771,2000
MT,education - other,498,1300138,239,210165,19356,608,1510303,2000
MT,libraries,0,0,0,0,0,0,0,2000
MT,liquor stores,77,185166,1,1032,111,78,186198,2000
MT,other and unallocable,1001,2835716,85,120754,9147,1053,2956470,2000
NE,total,26025,65430784,9827,5874217,668089,29797,71305001,2000
NE,financial administration,560,1579576,18,17474,1902,570,1597050,2000
NE,other government administration,327,987904,107,99213,8067,373,1087117,2000
NE,judicial and legal,699,2388143,81,65679,5406,729,2453822,2000
NE,police arrest,470,1625810,2,689,75,470,1626499,2000
NE,police other,208,529644,7,8001,762,212,537645,2000
NE,corrections,1962,4881603,57,56125,5105,1992,4937728,2000
NE,streets and highways,2236,5904417,13,16935,1315,2243,5921352,2000
NE,air transportation,30,87331,0,0,0,30,87331,2000
NE,water transportation,0,0,0,0,0,0,0,2000
NE,public welfare,2730,6121368,127,41318,9296,2783,6162686,2000
NE,health,734,2053654,80,97227,8192,781,2150881,2000
NE,hospitals,3962,8663828,944,1278394,117592,4626,9942222,2000
NE,social insurance administration,257,725096,16,19888,1680,266,744984,2000
NE,solid waste management,0,0,0,0,0,0,0,2000
NE,sewage disposal,0,0,0,0,0,0,0,2000
NE,parks and recreation,226,546624,178,116445,18865,333,663069,2000
NE,housing and community development,0,0,0,0,0,0,0,2000
NE,natural resources,1404,3119515,677,401299,51714,1696,3520814,2000
NE,water transport and terminals,0,0,0,0,0,0,0,2000
NE,electric power,0,0,0,0,0,0,0,2000
NE,gas supply,0,0,0,0,0,0,0,2000
NE,transit,0,0,0,0,0,0,0,2000
NE,elem and sec instruction,0,0,0,0,0,0,0,2000
NE,elem and sec admin/cler,0,0,0,0,0,0,0,2000
NE,elem and sec oper/maint,0,0,0,0,0,0,0,2000
NE,elem and sec cafeteria,0,0,0,0,0,0,0,2000
NE,elem and sec bus transit,0,0,0,0,0,0,0,2000
NE,elem and sec health/rec,0,0,0,0,0,0,0,2000
NE,elem and sec student,0,0,0,0,0,0,0,2000
NE,elem and sec unalloc,0,0,0,0,0,0,0,2000
NE,higher ed - instructional,2514,8668562,992,897803,56385,2832,9566365,2000
NE,education - higher education other,5300,10448490,6058,2273710,331807,7175,12722200,2000
NE,education - other,529,1649859,20,23894,1872,539,1673753,2000
NE,libraries,0,0,0,0,0,0,0,2000
NE,liquor stores,0,0,0,0,0,0,0,2000
NE,other and unallocable,1877,5449360,450,460123,48054,2147,5909483,2000
NV,total,19430,66922348,6347,6738471,533790,22444,73660819,2000
NV,financial administration,1053,3104631,22,23772,1073,1059,3128403,2000
NV,other government administration,836,2892231,45,48626,2584,850,2940857,2000
NV,judicial and legal,661,2924717,30,49007,1325,668,2973724,2000
NV,police arrest,465,1692388,0,0,0,465,1692388,2000
NV,police other,394,1243469,0,0,0,394,1243469,2000
NV,corrections,2913,9750204,64,134299,3691,2935,9884503,2000
NV,streets and highways,1612,5550870,7,2801,443,1615,5553671,2000
NV,air transportation,0,0,0,0,0,0,0,2000
NV,water transportation,0,0,0,0,0,0,0,2000
NV,public welfare,1002,3285672,11,16510,602,1006,3302182,2000
NV,health,1130,3848315,64,97429,4074,1153,3945744,2000
NV,hospitals,946,3255897,128,240352,10539,1006,3496249,2000
NV,social insurance administration,443,1331650,6,7273,434,445,1338923,2000
NV,solid waste management,0,0,0,0,0,0,0,2000
NV,sewage disposal,0,0,0,0,0,0,0,2000
NV,parks and recreation,185,511031,9,13432,673,189,524463,2000
NV,housing and community development,0,0,0,0,0,0,0,2000
NV,natural resources,905,2849870,389,340880,18634,1009,3190750,2000
NV,water transport and terminals,11,44256,1,1742,44,11,45998,2000
NV,electric power,10,40231,1,1740,44,10,41971,2000
NV,gas supply,0,0,0,0,0,0,0,2000
NV,transit,0,0,0,0,0,0,0,2000
NV,elem and sec instruction,0,0,0,0,0,0,0,2000
NV,elem and sec admin/cler,0,0,0,0,0,0,0,2000
NV,elem and sec oper/maint,0,0,0,0,0,0,0,2000
NV,elem and sec cafeteria,0,0,0,0,0,0,0,2000
NV,elem and sec bus transit,0,0,0,0,0,0,0,2000
NV,elem and sec health/rec,0,0,0,0,0,0,0,2000
NV,elem and sec student,0,0,0,0,0,0,0,2000
NV,elem and sec unalloc,0,0,0,0,0,0,0,2000
NV,higher ed - instructional,1718,9335832,2095,2825101,152727,2581,12160933,2000
NV,education - higher education other,2944,7699828,3389,2846762,332489,4823,10546590,2000
NV,education - other,129,455997,15,25051,1047,135,481048,2000
NV,libraries,0,0,0,0,0,0,0,2000
NV,liquor stores,0,0,0,0,0,0,0,2000
NV,other and unallocable,2073,7105259,71,63694,3367,2090,7168953,2000
NH,total,15769,48549807,8811,6626882,502644,18776,55176689,2000
NH,financial administration,459,1226412,35,29734,4113,484,1256146,2000
NH,other government administration,281,841776,76,76476,6454,319,918252,2000
NH,judicial and legal,912,2925386,1,1078,120,913,2926464,2000
NH,police arrest,303,1174888,0,0,0,303,1174888,2000
NH,police other,118,336098,17,11703,1441,126,347801,2000
NH,corrections,1215,3414904,52,73952,5272,1245,3488856,2000
NH,streets and highways,1802,5108933,249,203015,20398,1917,5311948,2000
NH,air transportation,0,0,0,0,0,0,0,2000
NH,water transportation,5,12788,5,4003,410,7,16791,2000
NH,public welfare,1415,3726671,77,72154,5388,1446,3798825,2000
NH,health,856,2616290,76,71167,6186,893,2687457,2000
NH,hospitals,749,1878756,68,87256,1109,756,1966012,2000
NH,social insurance administration,321,851294,38,42941,3113,340,894235,2000
NH,solid waste management,0,0,0,0,0,0,0,2000
NH,sewage disposal,0,0,0,0,0,0,0,2000
NH,parks and recreation,72,179870,200,119810,16205,169,299680,2000
NH,housing and community development,0,0,0,0,0,0,0,2000
NH,natural resources,498,1411400,200,134090,12482,573,1545490,2000
NH,water transport and terminals,0,0,0,0,0,0,0,2000
NH,electric power,0,0,0,0,0,0,0,2000
NH,gas supply,0,0,0,0,0,0,0,2000
NH,transit,0,0,0,0,0,0,0,2000
NH,elem and sec instruction,0,0,0,0,0,0,0,2000
NH,elem and sec admin/cler,0,0,0,0,0,0,0,2000
NH,elem and sec oper/maint,0,0,0,0,0,0,0,2000
NH,elem and sec cafeteria,0,0,0,0,0,0,0,2000
NH,elem and sec bus transit,0,0,0,0,0,0,0,2000
NH,elem and sec health/rec,0,0,0,0,0,0,0,2000
NH,elem and sec student,0,0,0,0,0,0,0,2000
NH,elem and sec unalloc,0,0,0,0,0,0,0,2000
NH,higher ed - instructional,1421,6058364,1619,2029961,79374,1900,8088325,2000
NH,education - higher education other,3033,10325271,5410,3219903,285425,4757,13545174,2000
NH,education - other,305,836797,15,20473,1430,313,857270,2000
NH,libraries,0,0,0,0,0,0,0,2000
NH,liquor stores,307,786220,380,215453,31049,482,1001673,2000
NH,other and unallocable,1697,4837689,293,213713,22675,1833,5051402,2000
NJ,total,124116,505761526,26061,22388264,1450939,133126,528149790,2000
NJ,financial administration,4815,17855765,402,607328,55341,5172,18463093,2000
NJ,other government administration,1347,6025945,52,56705,5203,1380,6082650,2000
NJ,judicial and legal,13395,51870495,189,225453,20681,13529,52095948,2000
NJ,police arrest,1115,3433062,18,29127,2672,1132,3462189,2000
NJ,police other,2599,15756008,0,0,0,2599,15756008,2000
NJ,corrections,9465,37368592,28,34109,3128,9485,37402701,2000
NJ,streets and highways,6839,28026398,1185,1099633,108393,7452,29126031,2000
NJ,air transportation,0,0,0,0,0,0,0,2000
NJ,water transportation,133,511381,8,10891,957,138,522272,2000
NJ,public welfare,5903,21472439,172,269315,22582,6049,21741754,2000
NJ,health,2683,11147068,414,266836,24480,2841,11413904,2000
NJ,hospitals,14415,46602397,1413,1508865,113607,15138,48111262,2000
NJ,social insurance administration,1416,5134149,365,671712,48048,1726,5805861,2000
NJ,solid waste management,652,3036063,3,2489,228,653,3038552,2000
NJ,sewage disposal,0,0,0,0,0,0,0,2000
NJ,parks and recreation,1692,6436228,1065,1001793,19440,1809,7438021,2000
NJ,housing and community development,0,0,0,0,0,0,0,2000
NJ,natural resources,2614,10461837,523,569737,26707,2777,11031574,2000
NJ,water transport and terminals,111,378116,2,979,71,111,379095,2000
NJ,electric power,0,0,0,0,0,0,0,2000
NJ,gas supply,0,0,0,0,0,0,0,2000
NJ,transit,9528,37960999,890,820711,65208,9896,38781710,2000
NJ,elem and sec instruction,8653,41683519,411,328781,12458,8741,42012300,2000
NJ,elem and sec admin/cler,1286,3449789,3,3755,336,1288,3453544,2000
NJ,elem and sec oper/maint,1745,5230268,108,193322,10498,1814,5423590,2000
NJ,elem and sec cafeteria,407,1043080,395,179871,23040,566,1222951,2000
NJ,elem and sec bus transit,19,57930,10,4013,328,21,61943,2000
NJ,elem and sec health/rec,107,593666,0,0,0,107,593666,2000
NJ,elem and sec student,0,0,49,17253,3268,23,17253,2000
NJ,elem and sec unalloc,0,0,365,359089,35378,228,359089,2000
NJ,higher ed - instructional,6851,47944899,4980,5908394,197453,8070,53853293,2000
NJ,education - higher education other,16407,60715054,12541,7399252,593147,20086,68114306,2000
NJ,education - other,3510,14562342,325,628108,42020,3781,15190450,2000
NJ,libraries,0,0,0,0,0,0,0,2000
NJ,liquor stores,0,0,0,0,0,0,0,2000
NJ,other and unallocable,6409,27004037,145,190743,16267,6514,27194780,2000
NM,total,42064,118252012,15836,12767656,1016227,47813,131019668,2000
NM,financial administration,2008,5316165,13,24248,1566,2017,5340413,2000
NM,other government administration,205,656089,38,56141,3463,225,712230,2000
NM,judicial and legal,2658,8190291,129,146609,11865,2726,8336900,2000
NM,police arrest,462,1617410,0,0,0,462,1617410,2000
NM,police other,171,601964,0,0,0,171,601964,2000
NM,corrections,3972,10256787,38,62769,5290,4002,10319556,2000
NM,streets and highways,2325,5751020,0,0,0,2325,5751020,2000
NM,air transportation,6,21268,0,0,0,6,21268,2000
NM,water transportation,0,0,0,0,0,0,0,2000
NM,public welfare,1553,3609420,4,7370,505,1556,3616790,2000
NM,health,2486,6827219,200,231559,13235,2561,7058778,2000
NM,hospitals,5573,14256289,1609,1961317,133473,6327,16217606,2000
NM,social insurance administration,688,1699729,18,20526,1691,698,1720255,2000
NM,solid waste management,0,0,0,0,0,0,0,2000
NM,sewage disposal,0,0,0,0,0,0,0,2000
NM,parks and recreation,691,1637833,48,98995,6956,730,1736828,2000
NM,housing and community development,0,0,0,0,0,0,0,2000
NM,natural resources,1613,4627656,352,286561,28607,1776,4914217,2000
NM,water transport and terminals,0,0,0,0,0,0,0,2000
NM,electric power,0,0,0,0,0,0,0,2000
NM,gas supply,0,0,0,0,0,0,0,2000
NM,transit,0,0,0,0,0,0,0,2000
NM,elem and sec instruction,0,0,0,0,0,0,0,2000
NM,elem and sec admin/cler,0,0,0,0,0,0,0,2000
NM,elem and sec oper/maint,0,0,0,0,0,0,0,2000
NM,elem and sec cafeteria,0,0,0,0,0,0,0,2000
NM,elem and sec bus transit,0,0,0,0,0,0,0,2000
NM,elem and sec health/rec,0,0,0,0,0,0,0,2000
NM,elem and sec student,0,0,0,0,0,0,0,2000
NM,elem and sec unalloc,0,0,0,0,0,0,0,2000
NM,higher ed - instructional,4374,15614015,3502,3923957,214765,5589,19537972,2000
NM,education - higher education other,10997,31226300,9628,5760938,576606,14254,36987238,2000
NM,education - other,859,2336193,101,103167,11590,925,2439360,2000
NM,libraries,0,0,0,0,0,0,0,2000
NM,liquor stores,0,0,0,0,0,0,0,2000
NM,other and unallocable,1423,4006364,156,83499,6615,1463,4089863,2000
NY,total,234724,905907306,45264,45181132,2776922,250974,951088438,2000
NY,financial administration,13304,44106274,457,716048,30795,13483,44822322,2000
NY,other government administration,4766,16019621,937,773124,93634,5295,16792745,2000
NY,judicial and legal,17899,83604011,517,1107328,54911,18209,84711339,2000
NY,police arrest,4064,21968563,0,0,0,4064,21968563,2000
NY,police other,1520,4588763,151,140037,13313,1595,4728800,2000
NY,corrections,35386,126266276,440,917263,43120,35629,127183539,2000
NY,streets and highways,12645,44167373,1012,1065911,85150,13124,45233284,2000
NY,air transportation,126,444007,9,15788,1550,135,459795,2000
NY,water transportation,817,3357088,35,65076,3084,834,3422164,2000
NY,public welfare,6448,21480157,443,735551,43822,6698,22215708,2000
NY,health,9114,36541430,411,937991,44662,9367,37479421,2000
NY,hospitals,45044,150084015,4783,8675771,435294,47521,158759786,2000
NY,social insurance administration,8432,28603914,112,228976,14446,8514,28832890,2000
NY,solid waste management,0,0,0,0,0,0,0,2000
NY,sewage disposal,0,0,0,0,0,0,0,2000
NY,parks and recreation,1864,5939913,1095,1414392,157145,2752,7354305,2000
NY,housing and community development,0,0,0,0,0,0,0,2000
NY,natural resources,3235,11854552,68,127633,7490,3277,11982185,2000
NY,water transport and terminals,0,0,0,0,0,0,0,2000
NY,electric power,3243,21183138,60,112814,5712,3277,21295952,2000
NY,gas supply,0,0,0,0,0,0,0,2000
NY,transit,14518,70879606,459,495280,49878,14799,71374886,2000
NY,elem and sec instruction,0,0,0,0,0,0,0,2000
NY,elem and sec admin/cler,0,0,0,0,0,0,0,2000
NY,elem and sec oper/maint,0,0,0,0,0,0,0,2000
NY,elem and sec cafeteria,0,0,0,0,0,0,0,2000
NY,elem and sec bus transit,0,0,0,0,0,0,0,2000
NY,elem and sec health/rec,0,0,0,0,0,0,0,2000
NY,elem and sec student,0,0,0,0,0,0,0,2000
NY,elem and sec unalloc,0,0,0,0,0,0,0,2000
NY,higher ed - instructional,13190,74290141,15566,15827208,820868,18061,90117349,2000
NY,education - higher education other,23519,81299055,17879,10472629,804356,28363,91771684,2000
NY,education - other,4495,16559761,262,431613,22889,4625,16991374,2000
NY,libraries,0,0,0,0,0,0,0,2000
NY,liquor stores,0,0,0,0,0,0,0,2000
NY,other and unallocable,11095,42669648,568,920699,44803,11352,43590347,2000
NC,total,112475,338761668,29106,23638942,1916945,123302,362400610,2000
NC,financial administration,3073,8359407,46,70653,5108,3103,8430060,2000
NC,other government administration,715,2545097,343,484090,33361,903,3029187,2000
NC,judicial and legal,5885,19325197,248,368353,17117,5982,19693550,2000
NC,police arrest,2280,8370302,8,12443,1200,2287,8382745,2000
NC,police other,1063,3008374,12,22318,1890,1074,3030692,2000
NC,corrections,19087,50719857,131,87581,5952,19121,50807438,2000
NC,streets and highways,11898,29151585,5,11652,620,11902,29163237,2000
NC,air transportation,0,0,0,0,0,0,0,2000
NC,water transportation,276,958880,7,6614,570,279,965494,2000
NC,public welfare,1381,3987579,65,34018,2085,1393,4021597,2000
NC,health,2668,8769597,245,261527,24143,2804,9031124,2000
NC,hospitals,15210,41524188,1060,1016665,122333,15901,42540853,2000
NC,social insurance administration,2509,6440882,329,383565,27582,2665,6824447,2000
NC,solid waste management,321,1013427,0,0,0,321,1013427,2000
NC,sewage disposal,0,0,0,0,0,0,0,2000
NC,parks and recreation,1065,2463844,17,22590,2630,1080,2486434,2000
NC,housing and community development,0,0,0,0,0,0,0,2000
NC,natural resources,3459,10254747,1146,1189219,81424,3919,11443966,2000
NC,water transport and terminals,0,0,0,0,0,0,0,2000
NC,electric power,0,0,0,0,0,0,0,2000
NC,gas supply,0,0,0,0,0,0,0,2000
NC,transit,0,0,0,0,0,0,0,2000
NC,elem and sec instruction,0,0,0,0,0,0,0,2000
NC,elem and sec admin/cler,0,0,0,0,0,0,0,2000
NC,elem and sec oper/maint,0,0,0,0,0,0,0,2000
NC,elem and sec cafeteria,0,0,0,0,0,0,0,2000
NC,elem and sec bus transit,0,0,0,0,0,0,0,2000
NC,elem and sec health/rec,0,0,0,0,0,0,0,2000
NC,elem and sec student,0,0,0,0,0,0,0,2000
NC,elem and sec unalloc,0,0,0,0,0,0,0,2000
NC,higher ed - instructional,12258,56192075,9657,11310373,712730,16284,67502448,2000
NC,education - higher education other,21922,62081870,15511,8104045,857592,26765,70185915,2000
NC,education - other,2886,8687021,100,92468,7910,2931,8779489,2000
NC,libraries,0,0,0,0,0,0,0,2000
NC,liquor stores,0,0,0,0,0,0,0,2000
NC,other and unallocable,4519,14907739,176,160768,12698,4588,15068507,2000
ND,total,13118,37076609,7570,5487329,470824,15772,42563938,2000
ND,financial administration,581,1420470,74,69243,10491,639,1489713,2000
ND,other government administration,177,449652,129,461853,16569,270,911505,2000
ND,judicial and legal,397,1349440,43,13177,1619,406,1362617,2000
ND,police arrest,125,381746,0,0,0,125,381746,2000
ND,police other,94,214387,1,1148,164,95,215535,2000
ND,corrections,551,1250087,37,21861,2593,565,1271948,2000
ND,streets and highways,907,2343468,36,28116,3160,925,2371584,2000
ND,air transportation,0,0,0,0,0,0,0,2000
ND,water transportation,0,0,0,0,0,0,0,2000
ND,public welfare,422,982522,42,35917,1348,429,1018439,2000
ND,health,1208,3093864,164,136757,4456,1233,3230621,2000
ND,hospitals,1025,2102620,192,36014,6007,1059,2138634,2000
ND,social insurance administration,402,1021839,48,43219,4269,426,1065058,2000
ND,solid waste management,0,0,0,0,0,0,0,2000
ND,sewage disposal,0,0,0,0,0,0,0,2000
ND,parks and recreation,96,223209,21,14111,1768,106,237320,2000
ND,housing and community development,0,0,0,0,0,0,0,2000
ND,natural resources,967,2987813,587,456679,78845,1413,3444492,2000
ND,water transport and terminals,0,0,0,0,0,0,0,2000
ND,electric power,0,0,0,0,0,0,0,2000
ND,gas supply,0,0,0,0,0,0,0,2000
ND,transit,0,0,0,0,0,0,0,2000
ND,elem and sec instruction,0,0,0,0,0,0,0,2000
ND,elem and sec admin/cler,0,0,0,0,0,0,0,2000
ND,elem and sec oper/maint,0,0,0,0,0,0,0,2000
ND,elem and sec cafeteria,0,0,0,0,0,0,0,2000
ND,elem and sec bus transit,0,0,0,0,0,0,0,2000
ND,elem and sec health/rec,0,0,0,0,0,0,0,2000
ND,elem and sec student,0,0,0,0,0,0,0,2000
ND,elem and sec unalloc,0,0,0,0,0,0,0,2000
ND,higher ed - instructional,1811,8002836,1894,2837718,158977,2709,10840554,2000
ND,education - higher education other,2897,7298716,4143,1235341,171521,3866,8534057,2000
ND,education - other,340,864501,45,22024,2024,350,886525,2000
ND,libraries,0,0,0,0,0,0,0,2000
ND,liquor stores,0,0,0,0,0,0,0,2000
ND,other and unallocable,1118,3089439,114,74151,7013,1156,3163590,2000
OH,total,113804,383366023,59912,51217048,3989231,136346,434583071,2000
OH,financial administration,7949,29288090,558,704172,55610,8265,29992262,2000
OH,other government administration,774,2694046,168,115837,11869,840,2809883,2000
OH,judicial and legal,2450,9822858,439,912139,50151,2733,10734997,2000
OH,police arrest,1391,6075791,0,0,0,1391,6075791,2000
OH,police other,1196,3431880,14,16358,1793,1206,3448238,2000
OH,corrections,18085,58670708,94,167379,10909,18147,58838087,2000
OH,streets and highways,6968,25019033,412,513705,40910,7199,25532738,2000
OH,air transportation,0,0,0,0,0,0,0,2000
OH,water transportation,0,0,0,0,0,0,0,2000
OH,public welfare,1984,7713076,202,216222,24538,2122,7929298,2000
OH,health,3419,13869397,282,247450,20516,3536,14116847,2000
OH,hospitals,9995,25517751,3184,6013309,367121,12069,31531060,2000
OH,social insurance administration,2844,9941236,110,184012,13525,2920,10125248,2000
OH,solid waste management,0,0,0,0,0,0,0,2000
OH,sewage disposal,0,0,0,0,0,0,0,2000
OH,parks and recreation,614,1992407,276,331972,29572,781,2324379,2000
OH,housing and community development,0,0,0,0,0,0,0,2000
OH,natural resources,3330,10319553,848,1141302,85881,3814,11460855,2000
OH,water transport and terminals,0,0,0,0,0,0,0,2000
OH,electric power,0,0,0,0,0,0,0,2000
OH,gas supply,0,0,0,0,0,0,0,2000
OH,transit,0,0,0,0,0,0,0,2000
OH,elem and sec instruction,0,0,0,0,0,0,0,2000
OH,elem and sec admin/cler,0,0,0,0,0,0,0,2000
OH,elem and sec oper/maint,0,0,0,0,0,0,0,2000
OH,elem and sec cafeteria,0,0,0,0,0,0,0,2000
OH,elem and sec bus transit,0,0,0,0,0,0,0,2000
OH,elem and sec health/rec,0,0,0,0,0,0,0,2000
OH,elem and sec student,0,0,0,0,0,0,0,2000
OH,elem and sec unalloc,0,0,0,0,0,0,0,2000
OH,higher ed - instructional,15982,74499017,16784,19310345,980481,21523,93809362,2000
OH,education - higher education other,30026,78277188,36084,20755440,2260008,42795,99032628,2000
OH,education - other,2212,8508943,126,203312,9976,2268,8712255,2000
OH,libraries,0,0,0,0,0,0,0,2000
OH,liquor stores,0,0,0,0,0,0,0,2000
OH,other and unallocable,4585,17725049,331,384094,26371,4737,18109143,2000
OK,total,56743,160082611,23430,16699937,1347497,64419,176782548,2000
OK,financial administration,1716,4925365,102,123675,8074,1761,5049040,2000
OK,other government administration,816,2546741,187,258871,22012,940,2805612,2000
OK,judicial and legal,2522,8705909,199,208276,16009,2613,8914185,2000
OK,police arrest,966,3242064,0,0,0,966,3242064,2000
OK,police other,815,1864865,24,16154,1677,824,1881019,2000
OK,corrections,5930,14126117,375,392314,27636,6086,14518431,2000
OK,streets and highways,2956,7159822,126,116365,10848,3017,7276187,2000
OK,air transportation,0,0,0,0,0,0,0,2000
OK,water transportation,0,0,0,0,0,0,0,2000
OK,public welfare,6144,17322560,238,179985,21293,6264,17502545,2000
OK,health,3506,9564137,332,434304,33393,3695,9998441,2000
OK,hospitals,3019,9103665,82,96437,7450,3061,9200102,2000
OK,social insurance administration,1211,3257943,122,113442,10398,1269,3371385,2000
OK,solid waste management,74,208379,3,5365,328,76,213744,2000
OK,sewage disposal,0,0,0,0,0,0,0,2000
OK,parks and recreation,862,1856174,416,274861,38764,1080,2131035,2000
OK,housing and community development,0,0,0,0,0,0,0,2000
OK,natural resources,1850,4535288,855,579306,51680,2141,5114594,2000
OK,water transport and terminals,0,0,0,0,0,0,0,2000
OK,electric power,483,1899798,0,0,0,483,1899798,2000
OK,gas supply,0,0,0,0,0,0,0,2000
OK,transit,0,0,0,0,0,0,0,2000
OK,elem and sec instruction,0,0,0,0,0,0,0,2000
OK,elem and sec admin/cler,0,0,0,0,0,0,0,2000
OK,elem and sec oper/maint,0,0,0,0,0,0,0,2000
OK,elem and sec cafeteria,0,0,0,0,0,0,0,2000
OK,elem and sec bus transit,0,0,0,0,0,0,0,2000
OK,elem and sec health/rec,0,0,0,0,0,0,0,2000
OK,elem and sec student,0,0,0,0,0,0,0,2000
OK,elem and sec unalloc,0,0,0,0,0,0,0,2000
OK,higher ed - instructional,6084,27345154,5356,7149051,379668,8242,34494205,2000
OK,education - higher education other,13320,29808861,14699,6411301,693452,17296,36220162,2000
OK,education - other,2086,5696342,160,149703,10298,2143,5846045,2000
OK,libraries,0,0,0,0,0,0,0,2000
OK,liquor stores,0,0,0,0,0,0,0,2000
OK,other and unallocable,2383,6913427,154,190527,14517,2462,7103954,2000
OR,total,45092,147403008,20996,19818356,1461021,53343,167221364,2000
OR,financial administration,3836,13053877,517,675981,59139,4170,13729858,2000
OR,other government administration,1081,3365063,201,333413,19273,1190,3698476,2000
OR,judicial and legal,2640,8743143,473,1126842,70189,3037,9869985,2000
OR,police arrest,841,3316524,56,166937,9617,895,3483461,2000
OR,police other,476,1348063,123,123192,9122,528,1471255,2000
OR,corrections,4334,14398781,290,443312,35820,4536,14842093,2000
OR,streets and highways,3274,10308318,434,789468,45753,3532,11097786,2000
OR,air transportation,15,47197,0,0,0,15,47197,2000
OR,water transportation,0,0,0,0,0,0,0,2000
OR,public welfare,5226,15336098,748,2000792,79909,5678,17336890,2000
OR,health,2263,7173060,328,663324,30246,2434,7836384,2000
OR,hospitals,3355,9098016,1798,3562804,301823,5060,12660820,2000
OR,social insurance administration,2214,7759024,70,175854,8085,2260,7934878,2000
OR,solid waste management,0,0,0,0,0,0,0,2000
OR,sewage disposal,0,0,0,0,0,0,0,2000
OR,parks and recreation,390,1067029,39,76304,3432,409,1143333,2000
OR,housing and community development,0,0,0,0,0,0,0,2000
OR,natural resources,2691,8913432,548,445500,40485,2919,9358932,2000
OR,water transport and terminals,0,0,0,0,0,0,0,2000
OR,electric power,0,0,0,0,0,0,0,2000
OR,gas supply,0,0,0,0,0,0,0,2000
OR,transit,0,0,0,0,0,0,0,2000
OR,elem and sec instruction,0,0,0,0,0,0,0,2000
OR,elem and sec admin/cler,0,0,0,0,0,0,0,2000
OR,elem and sec oper/maint,0,0,0,0,0,0,0,2000
OR,elem and sec cafeteria,0,0,0,0,0,0,0,2000
OR,elem and sec bus transit,0,0,0,0,0,0,0,2000
OR,elem and sec health/rec,0,0,0,0,0,0,0,2000
OR,elem and sec student,0,0,0,0,0,0,0,2000
OR,elem and sec unalloc,0,0,0,0,0,0,0,2000
OR,higher ed - instructional,4998,20828313,7018,4882654,343803,6940,25710967,2000
OR,education - higher education other,4810,14072750,7933,3706357,364853,6871,17779107,2000
OR,education - other,869,2731378,210,463989,27189,1022,3195367,2000
OR,libraries,0,0,0,0,0,0,0,2000
OR,liquor stores,170,503736,1,1667,88,170,505403,2000
OR,other and unallocable,1609,5339206,209,179966,12195,1677,5519172,2000
PA,total,132972,456952845,48320,46840115,2856111,149721,503792960,2000
PA,financial administration,6945,23179670,636,901908,90720,7491,24081578,2000
PA,other government administration,2881,9103133,1241,2142016,123161,3611,11245149,2000
PA,judicial and legal,2615,13286564,46,127933,4367,2643,13414497,2000
PA,police arrest,4399,17948001,0,0,0,4399,17948001,2000
PA,police other,1149,4687483,95,150988,14987,1239,4838471,2000
PA,corrections,14714,46748127,326,618610,40467,14958,47366737,2000
PA,streets and highways,12803,39429398,1152,2156484,168731,13810,41585882,2000
PA,air transportation,35,127480,0,0,0,35,127480,2000
PA,water transportation,73,323970,0,0,0,73,323970,2000
PA,public welfare,11685,38198585,335,763781,48187,11975,38962366,2000
PA,health,1383,4953341,14,15750,850,1387,4969091,2000
PA,hospitals,13429,36636290,802,1187181,71796,13855,37823471,2000
PA,social insurance administration,4365,15270086,237,537052,35619,4580,15807138,2000
PA,solid waste management,0,0,0,0,0,0,0,2000
PA,sewage disposal,0,0,0,0,0,0,0,2000
PA,parks and recreation,891,2896620,353,632290,46454,1171,3528910,2000
PA,housing and community development,0,0,0,0,0,0,0,2000
PA,natural resources,6205,22062981,1110,1784895,74221,6643,23847876,2000
PA,water transport and terminals,0,0,0,0,0,0,0,2000
PA,electric power,0,0,0,0,0,0,0,2000
PA,gas supply,0,0,0,0,0,0,0,2000
PA,transit,0,0,0,0,0,0,0,2000
PA,elem and sec instruction,0,0,0,0,0,0,0,2000
PA,elem and sec admin/cler,0,0,0,0,0,0,0,2000
PA,elem and sec oper/maint,0,0,0,0,0,0,0,2000
PA,elem and sec cafeteria,0,0,0,0,0,0,0,2000
PA,elem and sec bus transit,0,0,0,0,0,0,0,2000
PA,elem and sec health/rec,0,0,0,0,0,0,0,2000
PA,elem and sec student,0,0,0,0,0,0,0,2000
PA,elem and sec unalloc,0,0,0,0,0,0,0,2000
PA,higher ed - instructional,12968,75731765,10171,19151468,736050,17189,94883233,2000
PA,education - higher education other,25861,71974014,30354,15456755,1286436,33403,87430769,2000
PA,education - other,3123,10380165,207,345479,26448,3282,10725644,2000
PA,libraries,0,0,0,0,0,0,0,2000
PA,liquor stores,2706,7325546,918,402806,46580,2987,7728352,2000
PA,other and unallocable,4742,16689626,323,464719,41037,4990,17154345,2000
RI,total,17702,66776843,6345,4615351,314852,19569,71392194,2000
RI,financial administration,859,2939625,9,13598,715,863,2953223,2000
RI,other government administration,682,2065571,205,22202,1107,689,2087773,2000
RI,judicial and legal,1133,4344662,22,42409,1179,1140,4387071,2000
RI,police arrest,197,1001343,0,0,0,197,1001343,2000
RI,police other,106,327807,5,4385,212,107,332192,2000
RI,corrections,1822,7497581,0,0,0,1822,7497581,2000
RI,streets and highways,830,2910068,10,10774,438,832,2920842,2000
RI,air transportation,0,0,0,0,0,0,0,2000
RI,water transportation,0,0,0,0,0,0,0,2000
RI,public welfare,1528,6699378,60,98463,5147,1562,6797841,2000
RI,health,1384,5364031,57,45677,1554,1394,5409708,2000
RI,hospitals,1172,4331304,24,62831,2730,1187,4394135,2000
RI,social insurance administration,633,1992599,42,70867,5302,667,2063466,2000
RI,solid waste management,100,453379,1,664,89,101,454043,2000
RI,sewage disposal,233,752503,0,0,0,233,752503,2000
RI,parks and recreation,70,195912,6,5898,281,72,201810,2000
RI,housing and community development,0,0,0,0,0,0,0,2000
RI,natural resources,525,1907029,28,31614,2531,539,1938643,2000
RI,water transport and terminals,0,0,0,0,0,0,0,2000
RI,electric power,0,0,0,0,0,0,0,2000
RI,gas supply,0,0,0,0,0,0,0,2000
RI,transit,601,2228775,33,58388,5833,634,2287163,2000
RI,elem and sec instruction,349,1467032,65,68355,3522,375,1535387,2000
RI,elem and sec admin/cler,33,100157,5,5903,405,36,106060,2000
RI,elem and sec oper/maint,28,66719,0,0,0,28,66719,2000
RI,elem and sec cafeteria,0,0,27,9981,1672,13,9981,2000
RI,elem and sec bus transit,4,7519,26,22899,2763,25,30418,2000
RI,elem and sec health/rec,0,0,0,0,0,0,0,2000
RI,elem and sec student,0,0,0,0,0,0,0,2000
RI,elem and sec unalloc,9,19490,19,8198,1187,18,27688,2000
RI,higher ed - instructional,1759,7783056,2455,2506036,125502,2507,10289092,2000
RI,education - higher education other,2012,6121545,3090,1277183,138668,2805,7398728,2000
RI,education - other,532,2291103,87,178399,10340,599,2469502,2000
RI,libraries,0,0,0,0,0,0,0,2000
RI,liquor stores,0,0,0,0,0,0,0,2000
RI,other and unallocable,1101,3908655,69,70627,3675,1124,3979282,2000
SC,total,72854,199706795,17420,11799669,985944,78697,211506464,2000
SC,financial administration,2223,6939608,25,26902,2578,2237,6966510,2000
SC,other government administration,526,1557720,567,312600,29939,703,1870320,2000
SC,judicial and legal,689,2681658,11,11406,1054,695,2693064,2000
SC,police arrest,1495,4596472,0,0,0,1495,4596472,2000
SC,police other,1807,3990698,9,9746,466,1810,4000444,2000
SC,corrections,9092,20883210,10,12368,678,9096,20895578,2000
SC,streets and highways,4939,11359948,10,10992,510,4942,11370940,2000
SC,air transportation,0,0,0,0,0,0,0,2000
SC,water transportation,526,1992210,11,11159,930,531,2003369,2000
SC,public welfare,5031,11824780,17,22588,864,5036,11847368,2000
SC,health,7734,19991765,225,388957,16539,7832,20380722,2000
SC,hospitals,8622,16982585,280,450374,36713,8834,17432959,2000
SC,social insurance administration,1301,3442180,5,7908,92,1302,3450088,2000
SC,solid waste management,0,0,0,0,0,0,0,2000
SC,sewage disposal,0,0,0,0,0,0,0,2000
SC,parks and recreation,644,1402604,7,3156,425,646,1405760,2000
SC,housing and community development,0,0,0,0,0,0,0,2000
SC,natural resources,2481,7128421,110,119867,5520,2515,7248288,2000
SC,water transport and terminals,0,0,0,0,0,0,0,2000
SC,electric power,1644,6731136,23,58109,2774,1660,6789245,2000
SC,gas supply,0,0,0,0,0,0,0,2000
SC,transit,0,0,0,0,0,0,0,2000
SC,elem and sec instruction,0,0,0,0,0,0,0,2000
SC,elem and sec admin/cler,0,0,0,0,0,0,0,2000
SC,elem and sec oper/maint,0,0,0,0,0,0,0,2000
SC,elem and sec cafeteria,0,0,0,0,0,0,0,2000
SC,elem and sec bus transit,0,0,0,0,0,0,0,2000
SC,elem and sec health/rec,0,0,0,0,0,0,0,2000
SC,elem and sec student,0,0,0,0,0,0,0,2000
SC,elem and sec unalloc,0,0,0,0,0,0,0,2000
SC,higher ed - instructional,7652,36890618,4241,3700809,219062,8953,40591427,2000
SC,education - higher education other,12232,29304390,11817,6582300,665614,16181,35886690,2000
SC,education - other,2757,7518114,31,40374,1076,2764,7558488,2000
SC,libraries,0,0,0,0,0,0,0,2000
SC,liquor stores,0,0,0,0,0,0,0,2000
SC,other and unallocable,1459,4488678,21,30054,1110,1465,4518732,2000
SD,total,11584,32168331,5590,2611097,317300,13376,34779428,2000
SD,financial administration,328,900846,9,11186,1016,333,912032,2000
SD,other government administration,301,831318,49,25777,2484,315,857095,2000
SD,judicial and legal,481,1503990,80,67476,5938,515,1571466,2000
SD,police arrest,181,594079,2,1459,82,181,595538,2000
SD,police other,94,216465,6,6197,611,97,222662,2000
SD,corrections,847,1900240,41,35692,3543,867,1935932,2000
SD,streets and highways,949,2521520,92,63455,7065,989,2584975,2000
SD,air transportation,0,0,0,0,0,0,0,2000
SD,water transportation,0,0,0,0,0,0,0,2000
SD,public welfare,954,2143553,52,48263,5608,986,2191816,2000
SD,health,496,1349891,67,61912,5190,525,1411803,2000
SD,hospitals,978,2010436,241,117457,11821,1045,2127893,2000
SD,social insurance administration,282,617912,8,8460,744,286,626372,2000
SD,solid waste management,0,0,0,0,0,0,0,2000
SD,sewage disposal,0,0,0,0,0,0,0,2000
SD,parks and recreation,107,252181,18,13649,1612,116,265830,2000
SD,housing and community development,0,0,0,0,0,0,0,2000
SD,natural resources,725,1970730,307,118910,16507,819,2089640,2000
SD,water transport and terminals,0,0,0,0,0,0,0,2000
SD,electric power,0,0,0,0,0,0,0,2000
SD,gas supply,0,0,0,0,0,0,0,2000
SD,transit,0,0,0,0,0,0,0,2000
SD,elem and sec instruction,0,0,0,0,0,0,0,2000
SD,elem and sec admin/cler,0,0,0,0,0,0,0,2000
SD,elem and sec oper/maint,0,0,0,0,0,0,0,2000
SD,elem and sec cafeteria,0,0,0,0,0,0,0,2000
SD,elem and sec bus transit,0,0,0,0,0,0,0,2000
SD,elem and sec health/rec,0,0,0,0,0,0,0,2000
SD,elem and sec student,0,0,0,0,0,0,0,2000
SD,elem and sec unalloc,0,0,0,0,0,0,0,2000
SD,higher ed - instructional,1277,6542890,904,840347,71758,1682,7383237,2000
SD,education - higher education other,2144,4829880,3374,1049543,166069,3085,5879423,2000
SD,education - other,364,909919,226,65513,8966,414,975432,2000
SD,libraries,0,0,0,0,0,0,0,2000
SD,liquor stores,0,0,0,0,0,0,0,2000
SD,other and unallocable,1076,3072481,114,75801,8286,1121,3148282,2000
TN,total,70175,195491123,24195,23467833,1868273,81075,218958956,2000
TN,financial administration,2561,7527016,40,45888,4184,2586,7572904,2000
TN,other government administration,680,2011124,87,108084,7196,723,2119208,2000
TN,judicial and legal,1958,7491310,46,55744,4488,1985,7547054,2000
TN,police arrest,1103,3629424,0,0,0,1103,3629424,2000
TN,police other,740,1614542,8,3832,570,743,1618374,2000
TN,corrections,6187,13963334,113,159656,9128,6242,14122990,2000
TN,streets and highways,4565,10189526,0,0,0,4565,10189526,2000
TN,air transportation,0,0,0,0,0,0,0,2000
TN,water transportation,0,0,0,0,0,0,0,2000
TN,public welfare,5309,13232234,20,18638,1834,5320,13250872,2000
TN,health,2942,7891126,135,178201,12537,3015,8069327,2000
TN,hospitals,9167,25406927,450,930272,63096,9525,26337199,2000
TN,social insurance administration,1392,3454260,178,229560,21354,1521,3683820,2000
TN,solid waste management,0,0,0,0,0,0,0,2000
TN,sewage disposal,0,0,0,0,0,0,0,2000
TN,parks and recreation,1044,1814768,115,81766,13546,1126,1896534,2000
TN,housing and community development,0,0,0,0,0,0,0,2000
TN,natural resources,2965,7690334,641,673588,71181,3378,8363922,2000
TN,water transport and terminals,0,0,0,0,0,0,0,2000
TN,electric power,0,0,0,0,0,0,0,2000
TN,gas supply,0,0,0,0,0,0,0,2000
TN,transit,0,0,0,0,0,0,0,2000
TN,elem and sec instruction,0,0,0,0,0,0,0,2000
TN,elem and sec admin/cler,0,0,0,0,0,0,0,2000
TN,elem and sec oper/maint,0,0,0,0,0,0,0,2000
TN,elem and sec cafeteria,0,0,0,0,0,0,0,2000
TN,elem and sec bus transit,0,0,0,0,0,0,0,2000
TN,elem and sec health/rec,0,0,0,0,0,0,0,2000
TN,elem and sec student,0,0,0,0,0,0,0,2000
TN,elem and sec unalloc,0,0,0,0,0,0,0,2000
TN,higher ed - instructional,8746,40268946,7372,9262914,505652,11723,49531860,2000
TN,education - higher education other,16118,37002624,14780,11605802,1143979,22766,48608426,2000
TN,education - other,2019,5349392,148,87748,7286,2061,5437140,2000
TN,libraries,0,0,0,0,0,0,0,2000
TN,liquor stores,0,0,0,0,0,0,0,2000
TN,other and unallocable,2679,6954236,62,26140,2242,2693,6980376,2000
TX,total,242883,751773728,60912,61526402,4609164,268924,813300130,2000
TX,financial administration,8842,27435265,220,287575,20706,8958,27722840,2000
TX,other government administration,1921,6094697,625,570236,47364,2188,6664933,2000
TX,judicial and legal,5004,19277164,91,150627,9092,5054,19427791,2000
TX,police arrest,2009,7945884,0,0,0,2009,7945884,2000
TX,police other,1608,4159608,36,35301,2880,1624,4194909,2000
TX,corrections,47392,107031893,307,306549,26902,47544,107338442,2000
TX,streets and highways,15062,41196091,627,560001,49216,15340,41756092,2000
TX,air transportation,0,0,0,0,0,0,0,2000
TX,water transportation,0,0,0,0,0,0,0,2000
TX,public welfare,20667,50333241,140,198036,13672,20744,50531277,2000
TX,health,13355,42113661,825,1312190,77157,13790,43425851,2000
TX,hospitals,31964,100220825,1600,2462688,159539,32866,102683513,2000
TX,social insurance administration,4438,12472019,64,89759,6646,4476,12561778,2000
TX,solid waste management,0,0,0,0,0,0,0,2000
TX,sewage disposal,0,0,0,0,0,0,0,2000
TX,parks and recreation,928,2127410,171,126766,16890,1023,2254176,2000
TX,housing and community development,0,0,0,0,0,0,0,2000
TX,natural resources,10326,33059472,3035,2229390,254599,11765,35288862,2000
TX,water transport and terminals,0,0,0,0,0,0,0,2000
TX,electric power,0,0,0,0,0,0,0,2000
TX,gas supply,0,0,0,0,0,0,0,2000
TX,transit,0,0,0,0,0,0,0,2000
TX,elem and sec instruction,13,40000,0,0,0,13,40000,2000
TX,elem and sec admin/cler,0,0,0,0,0,0,0,2000
TX,elem and sec oper/maint,0,0,0,0,0,0,0,2000
TX,elem and sec cafeteria,0,0,0,0,0,0,0,2000
TX,elem and sec bus transit,0,0,0,0,0,0,0,2000
TX,elem and sec health/rec,0,0,0,0,0,0,0,2000
TX,elem and sec student,0,0,0,0,0,0,0,2000
TX,elem and sec unalloc,0,0,0,0,0,0,0,2000
TX,higher ed - instructional,19340,120274508,21029,30175979,1704763,28972,150450487,2000
TX,education - higher education other,48921,144440022,30988,21505022,2105521,60818,165945044,2000
TX,education - other,4350,12854506,565,925160,62126,4701,13779666,2000
TX,libraries,0,0,0,0,0,0,0,2000
TX,liquor stores,0,0,0,0,0,0,0,2000
TX,other and unallocable,6743,20697462,589,591123,52091,7039,21288585,2000
UT,total,42396,122089691,17467,13332818,1227991,49331,135422509,2000
UT,financial administration,1509,4501098,265,224374,26780,1660,4725472,2000
UT,other government administration,184,705435,43,45813,2722,199,751248,2000
UT,judicial and legal,1461,4835586,228,323078,17867,1562,5158664,2000
UT,police arrest,404,1373293,0,0,0,404,1373293,2000
UT,police other,353,1085998,51,46631,4481,378,1132629,2000
UT,corrections,2811,7982633,374,312690,30199,2982,8295323,2000
UT,streets and highways,1744,5830102,48,69869,6097,1778,5899971,2000
UT,air transportation,0,0,0,0,0,0,0,2000
UT,water transportation,0,0,0,0,0,0,0,2000
UT,public welfare,2981,8314847,383,472609,35673,3181,8787456,2000
UT,health,1770,5445417,243,383978,22873,1899,5829395,2000
UT,hospitals,4935,11478011,358,295606,31450,5112,11773617,2000
UT,social insurance administration,691,1985453,55,68829,4924,719,2054282,2000
UT,solid waste management,0,0,0,0,0,0,0,2000
UT,sewage disposal,0,0,0,0,0,0,0,2000
UT,parks and recreation,260,782816,63,53353,6230,296,836169,2000
UT,housing and community development,0,0,0,0,0,0,0,2000
UT,natural resources,990,3101177,254,250726,18514,1095,3351903,2000
UT,water transport and terminals,0,0,0,0,0,0,0,2000
UT,electric power,0,0,0,0,0,0,0,2000
UT,gas supply,0,0,0,0,0,0,0,2000
UT,transit,0,0,0,0,0,0,0,2000
UT,elem and sec instruction,0,0,0,0,0,0,0,2000
UT,elem and sec admin/cler,0,0,0,0,0,0,0,2000
UT,elem and sec oper/maint,0,0,0,0,0,0,0,2000
UT,elem and sec cafeteria,0,0,0,0,0,0,0,2000
UT,elem and sec bus transit,0,0,0,0,0,0,0,2000
UT,elem and sec health/rec,0,0,0,0,0,0,0,2000
UT,elem and sec student,0,0,0,0,0,0,0,2000
UT,elem and sec unalloc,0,0,0,0,0,0,0,2000
UT,higher ed - instructional,4763,24878925,3625,3402210,206789,5931,28281135,2000
UT,education - higher education other,14915,31710874,10472,6616042,743734,19115,38326916,2000
UT,education - other,852,2538344,431,403108,34043,1045,2941452,2000
UT,libraries,0,0,0,0,0,0,0,2000
UT,liquor stores,214,476161,216,102052,14147,294,578213,2000
UT,other and unallocable,1559,5063521,358,261850,21468,1681,5325371,2000
VT,total,12600,39723224,2661,2597786,176621,13632,42321010,2000
VT,financial administration,528,1555421,6,8610,919,533,1564031,2000
VT,other government administration,447,1219937,205,484883,28938,610,1704820,2000
VT,judicial and legal,548,1917556,75,134807,7623,591,2052363,2000
VT,police arrest,322,1471573,31,15686,877,327,1487259,2000
VT,police other,165,531356,42,37253,3073,182,568609,2000
VT,corrections,974,2835224,18,28629,2506,988,2863853,2000
VT,streets and highways,995,3019471,19,37104,2442,1009,3056575,2000
VT,air transportation,0,0,0,0,0,0,0,2000
VT,water transportation,0,0,0,0,0,0,0,2000
VT,public welfare,1084,3176353,88,167739,12884,1157,3344092,2000
VT,health,490,1596726,106,217408,11998,558,1814134,2000
VT,hospitals,163,425989,5,8132,565,166,434121,2000
VT,social insurance administration,346,999617,18,35424,2360,359,1035041,2000
VT,solid waste management,0,0,0,0,0,0,0,2000
VT,sewage disposal,0,0,0,0,0,0,0,2000
VT,parks and recreation,122,380874,10,21252,1691,132,402126,2000
VT,housing and community development,0,0,0,0,0,0,0,2000
VT,natural resources,558,1992091,16,15777,1450,566,2007868,2000
VT,water transport and terminals,0,0,0,0,0,0,0,2000
VT,electric power,0,0,0,0,0,0,0,2000
VT,gas supply,0,0,0,0,0,0,0,2000
VT,transit,0,0,0,0,0,0,0,2000
VT,elem and sec instruction,0,0,0,0,0,0,0,2000
VT,elem and sec admin/cler,0,0,0,0,0,0,0,2000
VT,elem and sec oper/maint,0,0,0,0,0,0,0,2000
VT,elem and sec cafeteria,0,0,0,0,0,0,0,2000
VT,elem and sec bus transit,0,0,0,0,0,0,0,2000
VT,elem and sec health/rec,0,0,0,0,0,0,0,2000
VT,elem and sec student,0,0,0,0,0,0,0,2000
VT,elem and sec unalloc,0,0,0,0,0,0,0,2000
VT,higher ed - instructional,1229,6412589,415,571778,23554,1371,6984367,2000
VT,education - higher education other,3147,7571961,1507,685825,66902,3550,8257786,2000
VT,education - other,454,1443426,32,41785,2989,472,1485211,2000
VT,libraries,0,0,0,0,0,0,0,2000
VT,liquor stores,54,178947,1,968,100,55,179915,2000
VT,other and unallocable,974,2994113,67,84726,5750,1006,3078839,2000
VA,total,101169,326695709,46293,40832987,3077651,118588,367528696,2000
VA,financial administration,3716,12085102,713,693963,75379,4142,12779065,2000
VA,other government administration,519,1968877,624,1000446,72610,951,2969323,2000
VA,judicial and legal,3227,12625117,492,536157,33878,3419,13161274,2000
VA,police arrest,1793,7427478,0,0,0,1793,7427478,2000
VA,police other,719,1918336,190,184726,16120,810,2103062,2000
VA,corrections,15440,36354453,601,599113,41296,15674,36953566,2000
VA,streets and highways,10217,29306546,721,432481,38546,10435,29739027,2000
VA,air transportation,0,0,0,0,0,0,0,2000
VA,water transportation,139,474032,3,3238,346,141,477270,2000
VA,public welfare,1954,5955230,248,358472,17794,2054,6313702,2000
VA,health,4769,15365908,713,897854,69306,5161,16263762,2000
VA,hospitals,12644,34840590,1440,2061606,123212,13342,36902196,2000
VA,social insurance administration,1144,3542596,416,508871,44682,1397,4051467,2000
VA,solid waste management,0,0,0,0,0,0,0,2000
VA,sewage disposal,0,0,0,0,0,0,0,2000
VA,parks and recreation,606,1624400,797,446756,51981,900,2071156,2000
VA,housing and community development,0,0,0,0,0,0,0,2000
VA,natural resources,2827,9873072,602,519034,48549,3103,10392106,2000
VA,water transport and terminals,0,0,0,0,0,0,0,2000
VA,electric power,0,0,0,0,0,0,0,2000
VA,gas supply,0,0,0,0,0,0,0,2000
VA,transit,0,0,0,0,0,0,0,2000
VA,elem and sec instruction,0,0,0,0,0,0,0,2000
VA,elem and sec admin/cler,0,0,0,0,0,0,0,2000
VA,elem and sec oper/maint,0,0,0,0,0,0,0,2000
VA,elem and sec cafeteria,0,0,0,0,0,0,0,2000
VA,elem and sec bus transit,0,0,0,0,0,0,0,2000
VA,elem and sec health/rec,0,0,0,0,0,0,0,2000
VA,elem and sec student,0,0,0,0,0,0,0,2000
VA,elem and sec unalloc,0,0,0,0,0,0,0,2000
VA,higher ed - instructional,12702,69452998,12229,16230700,791465,17177,85683698,2000
VA,education - higher education other,22134,61496599,24366,14188734,1446163,30305,75685333,2000
VA,education - other,2571,8388482,660,687884,65710,2943,9076366,2000
VA,libraries,0,0,0,0,0,0,0,2000
VA,liquor stores,668,1650042,808,736786,82612,1135,2386828,2000
VA,other and unallocable,3380,12345851,670,746166,58002,3706,13092017,2000
WA,total,90893,322780762,54240,50361011,3814509,112476,373141773,2000
WA,financial administration,2463,8828239,218,418683,24844,2602,9246922,2000
WA,other government administration,1357,4317698,277,239064,24182,1494,4556762,2000
WA,judicial and legal,1605,7261702,219,308478,15840,1695,7570180,2000
WA,police arrest,1004,4425968,0,0,0,1004,4425968,2000
WA,police other,1216,3902522,0,0,0,1216,3902522,2000
WA,corrections,6737,22724608,2068,3215020,237442,8078,25939628,2000
WA,streets and highways,6350,24787114,429,817988,37642,6563,25605102,2000
WA,air transportation,0,0,0,0,0,0,0,2000
WA,water transportation,0,0,0,0,0,0,0,2000
WA,public welfare,5256,17342102,542,876680,45062,5539,18218782,2000
WA,health,5312,16728277,789,1385418,72755,5724,18113695,2000
WA,hospitals,7524,26086200,2557,5605738,205950,8688,31691938,2000
WA,social insurance administration,6928,22447342,846,983986,76762,7362,23431328,2000
WA,solid waste management,145,547321,14,47202,2352,158,594523,2000
WA,sewage disposal,0,0,0,0,0,0,0,2000
WA,parks and recreation,513,1654370,138,174968,17300,611,1829338,2000
WA,housing and community development,0,0,0,0,0,0,0,2000
WA,natural resources,4781,16706697,1203,1505757,116580,5439,18212454,2000
WA,water transport and terminals,0,0,0,0,0,0,0,2000
WA,electric power,0,0,0,0,0,0,0,2000
WA,gas supply,0,0,0,0,0,0,0,2000
WA,transit,0,0,0,0,0,0,0,2000
WA,elem and sec instruction,0,0,0,0,0,0,0,2000
WA,elem and sec admin/cler,0,0,0,0,0,0,0,2000
WA,elem and sec oper/maint,0,0,0,0,0,0,0,2000
WA,elem and sec cafeteria,0,0,0,0,0,0,0,2000
WA,elem and sec bus transit,0,0,0,0,0,0,0,2000
WA,elem and sec health/rec,0,0,0,0,0,0,0,2000
WA,elem and sec student,0,0,0,0,0,0,0,2000
WA,elem and sec unalloc,0,0,0,0,0,0,0,2000
WA,higher ed - instructional,10387,49435560,11238,15014670,650575,14062,64450230,2000
WA,education - higher education other,20497,66336562,29419,15759540,2030715,31972,82096102,2000
WA,education - other,3163,10740870,3397,2694983,160453,4073,13435853,2000
WA,libraries,0,0,0,0,0,0,0,2000
WA,liquor stores,492,1426508,469,682912,55432,805,2109420,2000
WA,other and unallocable,5163,17081102,417,629924,40623,5391,17711026,2000
WV,total,29116,78445934,9253,6392536,492253,32034,84838470,2000
WV,financial administration,2022,4370884,38,22658,2374,2036,4393542,2000
WV,other government administration,269,748831,301,865619,28919,453,1614450,2000
WV,judicial and legal,1229,3554393,29,23382,2460,1244,3577775,2000
WV,police arrest,679,2239276,0,0,0,679,2239276,2000
WV,police other,382,661106,12,8416,1018,388,669522,2000
WV,corrections,1263,2533722,4,5802,417,1266,2539524,2000
WV,streets and highways,5031,12384661,28,55268,4973,5059,12439929,2000
WV,air transportation,0,0,0,0,0,0,0,2000
WV,water transportation,0,0,0,0,0,0,0,2000
WV,public welfare,78,120788,0,0,0,78,120788,2000
WV,health,757,1811878,22,20646,1056,763,1832524,2000
WV,hospitals,1611,2979690,79,73656,6696,1649,3053346,2000
WV,social insurance administration,795,1743430,0,0,0,795,1743430,2000
WV,solid waste management,12,31596,0,0,0,12,31596,2000
WV,sewage disposal,0,0,0,0,0,0,0,2000
WV,parks and recreation,427,727408,316,192628,33500,616,920036,2000
WV,housing and community development,0,0,0,0,0,0,0,2000
WV,natural resources,1881,5181610,202,127501,17763,1985,5309111,2000
WV,water transport and terminals,0,0,0,0,0,0,0,2000
WV,electric power,0,0,0,0,0,0,0,2000
WV,gas supply,0,0,0,0,0,0,0,2000
WV,transit,0,0,0,0,0,0,0,2000
WV,elem and sec instruction,0,0,0,0,0,0,0,2000
WV,elem and sec admin/cler,0,0,0,0,0,0,0,2000
WV,elem and sec oper/maint,0,0,0,0,0,0,0,2000
WV,elem and sec cafeteria,0,0,0,0,0,0,0,2000
WV,elem and sec bus transit,0,0,0,0,0,0,0,2000
WV,elem and sec health/rec,0,0,0,0,0,0,0,2000
WV,elem and sec student,0,0,0,0,0,0,0,2000
WV,elem and sec unalloc,0,0,0,0,0,0,0,2000
WV,higher ed - instructional,3014,13616856,4000,3036053,143796,3870,16652909,2000
WV,education - higher education other,6333,16713725,3975,1804052,236096,7732,18517777,2000
WV,education - other,1404,3831403,118,83216,4900,1434,3914619,2000
WV,libraries,0,0,0,0,0,0,0,2000
WV,liquor stores,59,122978,0,0,0,59,122978,2000
WV,other and unallocable,1870,5071699,129,73639,8285,1916,5145338,2000
WI,total,53120,197065590,24412,33504538,1872284,63697,230570128,2000
WI,financial administration,2536,8732825,633,902897,68147,2921,9635722,2000
WI,other government administration,755,2765895,345,595009,27221,909,3360904,2000
WI,judicial and legal,1832,9415881,329,723161,33002,2018,10139042,2000
WI,police arrest,606,2002377,0,0,0,606,2002377,2000
WI,police other,281,741611,36,34538,3027,298,776149,2000
WI,corrections,8817,25794938,918,1644230,99861,9381,27439168,2000
WI,streets and highways,1816,6400065,285,293749,22324,1942,6693814,2000
WI,air transportation,0,0,0,0,0,0,0,2000
WI,water transportation,0,0,0,0,0,0,0,2000
WI,public welfare,1177,3837498,322,492789,35466,1378,4330287,2000
WI,health,1659,6075442,589,960056,44109,1909,7035498,2000
WI,hospitals,3140,10012435,1448,2178356,129006,3867,12190791,2000
WI,social insurance administration,849,2632671,31,56873,3527,869,2689544,2000
WI,solid waste management,0,0,0,0,0,0,0,2000
WI,sewage disposal,0,0,0,0,0,0,0,2000
WI,parks and recreation,135,421256,135,147100,10404,194,568356,2000
WI,housing and community development,0,0,0,0,0,0,0,2000
WI,natural resources,2021,6807708,1416,1638306,143598,2832,8446014,2000
WI,water transport and terminals,0,0,0,0,0,0,0,2000
WI,electric power,0,0,0,0,0,0,0,2000
WI,gas supply,0,0,0,0,0,0,0,2000
WI,transit,0,0,0,0,0,0,0,2000
WI,elem and sec instruction,0,0,0,0,0,0,0,2000
WI,elem and sec admin/cler,0,0,0,0,0,0,0,2000
WI,elem and sec oper/maint,0,0,0,0,0,0,0,2000
WI,elem and sec cafeteria,0,0,0,0,0,0,0,2000
WI,elem and sec bus transit,0,0,0,0,0,0,0,2000
WI,elem and sec health/rec,0,0,0,0,0,0,0,2000
WI,elem and sec student,0,0,0,0,0,0,0,2000
WI,elem and sec unalloc,0,0,0,0,0,0,0,2000
WI,higher ed - instructional,7440,40168132,6647,9055864,508957,10315,49223996,2000
WI,education - higher education other,14084,49297748,9251,12016272,558512,17239,61314020,2000
WI,education - other,1009,3535277,339,463906,27573,1165,3999183,2000
WI,libraries,0,0,0,0,0,0,0,2000
WI,liquor stores,0,0,0,0,0,0,0,2000
WI,other and unallocable,4963,18423831,1688,2301432,157550,5854,20725263,2000
WY,total,10038,25989749,3665,2447046,207901,11204,28436795,2000
WY,financial administration,509,1291563,4,4544,347,511,1296107,2000
WY,other government administration,100,290417,192,250354,9225,152,540771,2000
WY,judicial and legal,374,1039858,20,24717,1734,383,1064575,2000
WY,police arrest,109,374096,0,0,0,109,374096,2000
WY,police other,81,227824,0,0,0,81,227824,2000
WY,corrections,801,1664565,5,3863,433,803,1668428,2000
WY,streets and highways,1685,4354174,104,104134,12622,1756,4458308,2000
WY,air transportation,0,0,0,0,0,0,0,2000
WY,water transportation,0,0,0,0,0,0,0,2000
WY,public welfare,742,1729768,91,121613,10147,799,1851381,2000
WY,health,489,1265638,92,169908,12719,560,1435546,2000
WY,hospitals,981,1858347,9,1462,152,982,1859809,2000
WY,social insurance administration,331,777778,33,27496,2860,347,805274,2000
WY,solid waste management,0,0,0,0,0,0,0,2000
WY,sewage disposal,0,0,0,0,0,0,0,2000
WY,parks and recreation,89,191480,4,2160,347,91,193640,2000
WY,housing and community development,0,0,0,0,0,0,0,2000
WY,natural resources,673,1892647,17,15011,1332,680,1907658,2000
WY,water transport and terminals,0,0,0,0,0,0,0,2000
WY,electric power,0,0,0,0,0,0,0,2000
WY,gas supply,0,0,0,0,0,0,0,2000
WY,transit,0,0,0,0,0,0,0,2000
WY,elem and sec instruction,0,0,0,0,0,0,0,2000
WY,elem and sec admin/cler,0,0,0,0,0,0,0,2000
WY,elem and sec oper/maint,0,0,0,0,0,0,0,2000
WY,elem and sec cafeteria,0,0,0,0,0,0,0,2000
WY,elem and sec bus transit,0,0,0,0,0,0,0,2000
WY,elem and sec health/rec,0,0,0,0,0,0,0,2000
WY,elem and sec student,0,0,0,0,0,0,0,2000
WY,elem and sec unalloc,0,0,0,0,0,0,0,2000
WY,higher ed - instructional,766,3382662,788,725132,45321,1022,4107794,2000
WY,education - higher education other,1479,3668309,2241,945231,105026,2072,4613540,2000
WY,education - other,168,417096,13,9801,1127,174,426897,2000
WY,libraries,0,0,0,0,0,0,0,2000
WY,liquor stores,32,55831,0,0,0,32,55831,2000
WY,other and unallocable,629,1507696,52,41620,4509,650,1549316,2000
