state,government_function,full_time_employees,full_time_pay,part_time_employees,part_time_pay,part_time_hours,full_time_equivalent_employees,total_march_pay,year
US,total,3636974,12805324526,1347640,1330927952,93825101,4173400,14136252478,2001
US,financial administration,157593,532091674,14384,19645660,1482268,166119,551737334,2001
US,other government administration,49643,175267100,12549,20478708,1134309,56177,195745808,2001
US,judicial and legal,153068,621212276,9914,17570810,996624,158794,638783086,2001
US,police protection - officers,62725,273215219,347,536343,22629,62856,273751562,2001
US,police protection - other,39251,130283649,2334,2541985,180907,40285,132825634,2001
US,corrections,459472,1442699835,13896,24951496,1572819,468405,1467651331,2001
US,streets and highways,243532,820533100,10578,17675938,1116866,249896,838209038,2001
US,air transportation,3062,12294594,202,303067,16391,3155,12597661,2001
US,water transport and terminals,4515,17282192,119,143783,9984,4568,17425975,2001
US,public welfare,232916,693146459,9548,15019971,1044080,238930,708166430,2001
US,health,165112,549924789,13658,21912399,1274265,172414,571837188,2001
US,hospitals,378491,1177628038,54926,98377113,5617312,410469,1276005151,2001
US,social insurance administration,81623,275067731,7753,13521574,906301,86843,288589305,2001
US,solid waste management,1773,7683733,108,267081,12094,1843,7950814,2001
US,sewerage,1431,5780519,51,153999,6178,1466,5934518,2001
US,parks and recreation,28223,79940758,13806,14374438,1368768,36051,94315196,2001
US,housing and community development,0,0,0,0,0,0,0,2001
US,natural resources,134360,450174812,34832,36985936,3281611,153023,487160748,2001
US,water transport and terminals,830,3203546,40,73490,4011,852,3277036,2001
US,electric power,3688,19337978,99,231914,14530,3769,19569892,2001
US,gas supply,0,0,0,0,0,0,0,2001
US,transit,28139,130962839,1524,1782198,150720,28990,132745037,2001
US,education - elementary and secondary instructional,33192,121464454,8649,5878314,358052,35381,127342768,2001
US,education - elementary and secondary total,10065,24632907,6128,2982778,260048,11733,27615685,2001
US,education - higher education instructional,348962,1909806348,351027,484756234,23915428,485778,2394562582,2001
US,education - higher education other,716922,2249298425,739307,480900533,45916324,979068,2730198958,2001
US,education - other,94810,319814174,19988,21143786,1377347,102732,340957960,2001
US,libraries,484,1182880,228,138036,17242,588,1320916,2001
US,liquor stores,5773,15336573,3034,2332373,244088,7182,17668946,2001
US,other and unallocable,197319,746057924,18611,26247995,1523905,206033,772305919,2001
AL,total,74000,231806135,25791,23276649,1795057,84308,255082784,2001
AL,financial administration,2541,7780515,54,40638,5947,2575,7821153,2001
AL,other government administration,555,1939806,88,78786,5399,587,2018592,2001
AL,judicial and legal,3380,11748701,148,177385,14168,3461,11926086,2001
AL,police protection - officers,719,2700234,0,0,0,719,2700234,2001
AL,police protection - other,606,1482534,26,15862,1392,614,1498396,2001
AL,corrections,4573,13907750,13,14278,1875,4584,13922028,2001
AL,streets and highways,3797,10264332,54,42000,4782,3824,10306332,2001
AL,air transportation,0,0,0,0,0,0,0,2001
AL,water transport and terminals,426,1184745,2,1650,20,426,1186395,2001
AL,public welfare,3787,10248488,28,39064,2714,3802,10287552,2001
AL,health,4782,13198516,457,409046,55073,5094,13607562,2001
AL,hospitals,10280,29599086,1157,1700398,86771,10770,31299484,2001
AL,social insurance administration,1361,3567234,41,22747,3511,1381,3589981,2001
AL,solid waste management,0,0,0,0,0,0,0,2001
AL,sewerage,0,0,0,0,0,0,0,2001
AL,parks and recreation,408,892324,461,375975,28346,568,1268299,2001
AL,housing and community development,0,0,0,0,0,0,0,2001
AL,natural resources,2030,6166142,351,320419,49470,2309,6486561,2001
AL,water transport and terminals,0,0,0,0,0,0,0,2001
AL,electric power,0,0,0,0,0,0,0,2001
AL,gas supply,0,0,0,0,0,0,0,2001
AL,transit,0,0,0,0,0,0,0,2001
AL,education - elementary and secondary instructional,0,0,0,0,0,0,0,2001
AL,education - elementary and secondary total,0,0,0,0,0,0,0,2001
AL,education - higher education instructional,8903,43897843,7197,9800434,448097,11493,53698277,2001
AL,education - higher education other,20468,57102591,15091,9781198,1047542,26491,66883789,2001
AL,education - other,2703,8468239,130,95155,7689,2749,8563394,2001
AL,libraries,0,0,0,0,0,0,0,2001
AL,liquor stores,630,1350737,5,6531,620,634,1357268,2001
AL,other and unallocable,2051,6306318,488,355083,31641,2227,6661401,2001
AK,total,21839,84531914,5671,5045558,345400,23937,89577472,2001
AK,financial administration,939,3644236,24,36480,1930,952,3680716,2001
AK,other government administration,578,2070077,41,40930,2828,595,2111007,2001
AK,judicial and legal,1198,4938216,80,129683,5906,1234,5067899,2001
AK,police protection - officers,247,1458814,0,0,0,247,1458814,2001
AK,police protection - other,193,625458,77,23290,1903,204,648748,2001
AK,corrections,1655,6597625,25,37931,3156,1674,6635556,2001
AK,streets and highways,2833,11680672,26,31604,2538,2848,11712276,2001
AK,air transportation,0,0,0,0,0,0,0,2001
AK,water transport and terminals,0,0,0,0,0,0,0,2001
AK,public welfare,1626,5193328,157,187976,19440,1743,5381304,2001
AK,health,676,2603559,36,54438,3137,695,2657997,2001
AK,hospitals,246,853577,11,21132,1156,253,874709,2001
AK,social insurance administration,446,1516143,3,4340,257,448,1520483,2001
AK,solid waste management,0,0,0,0,0,0,0,2001
AK,sewerage,0,0,0,0,0,0,0,2001
AK,parks and recreation,84,289173,0,0,0,84,289173,2001
AK,housing and community development,0,0,0,0,0,0,0,2001
AK,natural resources,2077,7804129,61,60783,4541,2104,7864912,2001
AK,water transport and terminals,0,0,0,0,0,0,0,2001
AK,electric power,0,0,0,0,0,0,0,2001
AK,gas supply,0,0,0,0,0,0,0,2001
AK,transit,0,0,0,0,0,0,0,2001
AK,education - elementary and secondary instructional,1879,7037971,762,689764,49399,2209,7727735,2001
AK,education - elementary and secondary total,736,1991454,777,746908,60428,1151,2738362,2001
AK,education - higher education instructional,1073,6204385,1440,1495577,46374,1335,7699962,2001
AK,education - higher education other,2555,8536303,2050,1367977,134777,3316,9904280,2001
AK,education - other,361,1324671,47,55046,3822,384,1379717,2001
AK,libraries,0,0,0,0,0,0,0,2001
AK,liquor stores,0,0,0,0,0,0,0,2001
AK,other and unallocable,2437,10162123,54,61699,3808,2461,10223822,2001
AZ,total,56061,179302568,23516,20001455,1614849,65185,199304023,2001
AZ,financial administration,3594,9924084,45,80605,3845,3616,10004689,2001
AZ,other government administration,593,1816225,138,248949,7696,637,2065174,2001
AZ,judicial and legal,1374,5788273,76,159481,7594,1417,5947754,2001
AZ,police protection - officers,1032,4198698,1,1103,66,1032,4199801,2001
AZ,police protection - other,839,2653897,5,7069,461,842,2660966,2001
AZ,corrections,9515,26979262,94,193262,10361,9574,27172524,2001
AZ,streets and highways,3039,9486448,0,0,0,3039,9486448,2001
AZ,air transportation,0,0,0,0,0,0,0,2001
AZ,water transport and terminals,0,0,0,0,0,0,0,2001
AZ,public welfare,5564,13809151,120,188980,9026,5615,13998131,2001
AZ,health,2218,6229007,34,62397,3828,2239,6291404,2001
AZ,hospitals,694,2225615,62,107124,5635,726,2332739,2001
AZ,social insurance administration,2163,4957117,11,12607,1269,2170,4969724,2001
AZ,solid waste management,0,0,0,0,0,0,0,2001
AZ,sewerage,0,0,0,0,0,0,0,2001
AZ,parks and recreation,396,1021013,103,50105,8610,444,1071118,2001
AZ,housing and community development,0,0,0,0,0,0,0,2001
AZ,natural resources,2029,6692771,639,575871,48541,2303,7268642,2001
AZ,water transport and terminals,0,0,0,0,0,0,0,2001
AZ,electric power,8,34432,0,0,0,8,34432,2001
AZ,gas supply,0,0,0,0,0,0,0,2001
AZ,transit,0,0,0,0,0,0,0,2001
AZ,education - elementary and secondary instructional,0,0,0,0,0,0,0,2001
AZ,education - elementary and secondary total,0,0,0,0,0,0,0,2001
AZ,education - higher education instructional,4995,28811252,6283,7759572,488681,7756,36570824,2001
AZ,education - higher education other,11869,37880075,15340,9937111,968271,17340,47817186,2001
AZ,education - other,2786,7254496,423,489281,42911,3028,7743777,2001
AZ,libraries,0,0,0,0,0,0,0,2001
AZ,liquor stores,0,0,0,0,0,0,0,2001
AZ,other and unallocable,3353,9540752,142,127938,8054,3399,9668690,2001
AR,total,46455,134948819,14133,9337818,842744,51230,144286637,2001
AR,financial administration,1848,4625203,86,76602,8173,1895,4701805,2001
AR,other government administration,529,1707323,78,137932,9605,584,1845255,2001
AR,judicial and legal,1202,3946549,114,279286,10851,1263,4225835,2001
AR,police protection - officers,568,1718484,0,0,0,568,1718484,2001
AR,police protection - other,606,1539706,4,5938,572,610,1545644,2001
AR,corrections,4218,8924630,19,24883,2183,4230,8949513,2001
AR,streets and highways,3407,8430086,62,62638,8639,3456,8492724,2001
AR,air transportation,0,0,0,0,0,0,0,2001
AR,water transport and terminals,0,0,0,0,0,0,0,2001
AR,public welfare,2159,5449928,0,0,0,2159,5449928,2001
AR,health,4612,11605451,292,385011,31603,4791,11990462,2001
AR,hospitals,4121,11292239,149,200305,8473,4169,11492544,2001
AR,social insurance administration,875,2643226,229,232946,25992,1022,2876172,2001
AR,solid waste management,0,0,0,0,0,0,0,2001
AR,sewerage,0,0,0,0,0,0,0,2001
AR,parks and recreation,610,1285513,257,142373,24148,746,1427886,2001
AR,housing and community development,0,0,0,0,0,0,0,2001
AR,natural resources,1797,4451445,504,283460,31823,1977,4734905,2001
AR,water transport and terminals,0,0,0,0,0,0,0,2001
AR,electric power,0,0,0,0,0,0,0,2001
AR,gas supply,0,0,0,0,0,0,0,2001
AR,transit,0,0,0,0,0,0,0,2001
AR,education - elementary and secondary instructional,0,0,0,0,0,0,0,2001
AR,education - elementary and secondary total,0,0,0,0,0,0,0,2001
AR,education - higher education instructional,5239,28340098,3812,3552119,222799,6501,31892217,2001
AR,education - higher education other,9788,25326840,7519,3082281,393659,12020,28409121,2001
AR,education - other,2551,7132299,783,655377,46814,2816,7787676,2001
AR,libraries,0,0,0,0,0,0,0,2001
AR,liquor stores,0,0,0,0,0,0,0,2001
AR,other and unallocable,2325,6529799,225,216667,17410,2423,6746466,2001
CA,total,317300,1504017404,145172,183243414,9801255,372678,1687260818,2001
CA,financial administration,19883,76572132,3951,5517858,394131,22110,82089990,2001
CA,other government administration,3632,17119355,418,878342,31706,3820,17997697,2001
CA,judicial and legal,3631,20700818,368,671708,28819,3795,21372526,2001
CA,police protection - officers,7449,42767623,216,251453,6174,7484,43019076,2001
CA,police protection - other,5181,18806926,846,914001,51755,5474,19720927,2001
CA,corrections,46373,205085671,3411,8428431,446713,48896,213514102,2001
CA,streets and highways,22054,123665521,1291,4149196,161601,22967,127814717,2001
CA,air transportation,0,0,0,0,0,0,0,2001
CA,water transport and terminals,74,318083,14,12413,745,78,330496,2001
CA,public welfare,3572,14496193,281,549484,24674,3710,15045677,2001
CA,health,11290,51410274,1641,3151173,143860,12102,54561447,2001
CA,hospitals,32050,144904998,8140,16760464,745833,36265,161665462,2001
CA,social insurance administration,15497,62301513,2569,5518547,314980,17277,67820060,2001
CA,solid waste management,392,1868150,60,178314,7059,432,2046464,2001
CA,sewerage,0,0,0,0,0,0,0,2001
CA,parks and recreation,2333,9443169,1733,2670255,212168,3532,12113424,2001
CA,housing and community development,0,0,0,0,0,0,0,2001
CA,natural resources,11961,55035467,3740,5198769,484643,14698,60234236,2001
CA,water transport and terminals,0,0,0,0,0,0,0,2001
CA,electric power,0,0,0,0,0,0,0,2001
CA,gas supply,0,0,0,0,0,0,0,2001
CA,transit,0,0,0,0,0,0,0,2001
CA,education - elementary and secondary instructional,0,0,0,0,0,0,0,2001
CA,education - elementary and secondary total,0,0,0,0,0,0,0,2001
CA,education - higher education instructional,20287,141856135,27077,42374737,1678008,29767,184230872,2001
CA,education - higher education other,72901,316504944,84460,74553289,4601412,98898,391058233,2001
CA,education - other,4521,18615739,706,1231186,65983,4893,19846925,2001
CA,libraries,0,0,0,0,0,0,0,2001
CA,liquor stores,0,0,0,0,0,0,0,2001
CA,other and unallocable,34219,182544693,4250,10233794,400991,36480,192778487,2001
CO,total,46760,181997224,35650,72905329,3640606,67328,254902553,2001
CO,financial administration,2103,7932909,160,251827,13524,2178,8184736,2001
CO,other government administration,452,1414705,119,292516,19615,563,1707221,2001
CO,judicial and legal,3047,11847774,845,1728948,88224,3546,13576722,2001
CO,police protection - officers,764,3754403,1,2544,37,764,3756947,2001
CO,police protection - other,403,1538332,20,24681,1620,412,1563013,2001
CO,corrections,6440,22392236,74,184315,9638,6494,22576551,2001
CO,streets and highways,2973,10929858,180,345274,18899,3080,11275132,2001
CO,air transportation,0,0,0,0,0,0,0,2001
CO,water transport and terminals,0,0,0,0,0,0,0,2001
CO,public welfare,1838,6761671,241,389731,20872,1956,7151402,2001
CO,health,1045,4738654,157,323172,13979,1124,5061826,2001
CO,hospitals,3095,9758043,888,1540772,90594,3606,11298815,2001
CO,social insurance administration,827,3266131,60,101568,6418,863,3367699,2001
CO,solid waste management,0,0,0,0,0,0,0,2001
CO,sewerage,0,0,0,0,0,0,0,2001
CO,parks and recreation,211,884660,108,98867,6494,248,983527,2001
CO,housing and community development,0,0,0,0,0,0,0,2001
CO,natural resources,1281,5497246,283,398686,17958,1383,5895932,2001
CO,water transport and terminals,0,0,0,0,0,0,0,2001
CO,electric power,0,0,0,0,0,0,0,2001
CO,gas supply,0,0,0,0,0,0,0,2001
CO,transit,0,0,0,0,0,0,0,2001
CO,education - elementary and secondary instructional,0,0,0,0,0,0,0,2001
CO,education - elementary and secondary total,0,0,0,0,0,0,0,2001
CO,education - higher education instructional,9457,47699241,10137,33104906,909386,14596,80804147,2001
CO,education - higher education other,10390,34103657,21716,33127253,2369602,23777,67230910,2001
CO,education - other,1034,3721101,563,808989,44586,1285,4530090,2001
CO,libraries,0,0,0,0,0,0,0,2001
CO,liquor stores,0,0,0,0,0,0,0,2001
CO,other and unallocable,1400,5756603,98,181280,9160,1453,5937883,2001
CT,total,58251,240567354,17620,22018671,1312514,66200,262586025,2001
CT,financial administration,2616,10522925,80,188432,8493,2672,10711357,2001
CT,other government administration,1036,4258968,229,826548,35379,1237,5085516,2001
CT,judicial and legal,4090,17815038,207,787924,30175,4285,18602962,2001
CT,police protection - officers,1245,5844362,0,0,0,1245,5844362,2001
CT,police protection - other,538,1968844,43,78559,4641,567,2047403,2001
CT,corrections,8651,31731718,76,206287,7977,8702,31938005,2001
CT,streets and highways,3619,12583019,0,0,0,3619,12583019,2001
CT,air transportation,33,148244,0,0,0,33,148244,2001
CT,water transport and terminals,0,0,0,0,0,0,0,2001
CT,public welfare,4576,18177266,182,491082,22132,4718,18668348,2001
CT,health,2083,8215979,104,289009,12103,2156,8504988,2001
CT,hospitals,9068,38890544,2063,4547848,215797,10400,43438392,2001
CT,social insurance administration,911,3705326,25,82066,2845,929,3787392,2001
CT,solid waste management,50,237122,8,19636,932,56,256758,2001
CT,sewerage,0,0,0,0,0,0,0,2001
CT,parks and recreation,131,464121,15,33150,2553,145,497271,2001
CT,housing and community development,0,0,0,0,0,0,0,2001
CT,natural resources,577,2084797,35,81863,4343,603,2166660,2001
CT,water transport and terminals,0,0,0,0,0,0,0,2001
CT,electric power,0,0,0,0,0,0,0,2001
CT,gas supply,0,0,0,0,0,0,0,2001
CT,transit,0,0,0,0,0,0,0,2001
CT,education - elementary and secondary instructional,2287,11777000,650,864934,67910,2671,12641934,2001
CT,education - elementary and secondary total,807,1753488,313,75912,8900,857,1829400,2001
CT,education - higher education instructional,3821,22585337,6120,8217004,409345,6271,30802341,2001
CT,education - higher education other,7058,28757986,6961,4266538,423130,9620,33024524,2001
CT,education - other,2631,9351148,296,569884,33803,2849,9921032,2001
CT,libraries,0,0,0,0,0,0,0,2001
CT,liquor stores,0,0,0,0,0,0,0,2001
CT,other and unallocable,2423,9694122,213,391995,22056,2565,10086117,2001
DE,total,21227,72336459,7793,7472665,513758,24324,79809124,2001
DE,financial administration,683,2192920,73,155972,8170,732,2348892,2001
DE,other government administration,220,756062,116,207502,9750,275,963564,2001
DE,judicial and legal,1451,4678726,21,30176,1606,1460,4708902,2001
DE,police protection - officers,591,2788230,0,0,0,591,2788230,2001
DE,police protection - other,280,807012,50,46218,4600,306,853230,2001
DE,corrections,2322,7176243,160,230121,22473,2454,7406364,2001
DE,streets and highways,1678,4719108,26,29584,2316,1692,4748692,2001
DE,air transportation,0,0,0,0,0,0,0,2001
DE,water transport and terminals,0,0,0,0,0,0,0,2001
DE,public welfare,1636,5109935,157,299445,19463,1753,5409380,2001
DE,health,1672,6074066,227,219897,18787,1786,6293963,2001
DE,hospitals,2217,5919286,185,170412,11375,2285,6089698,2001
DE,social insurance administration,170,471234,3,3768,268,172,475002,2001
DE,solid waste management,88,263497,14,13083,1483,97,276580,2001
DE,sewerage,0,0,0,0,0,0,0,2001
DE,parks and recreation,188,527046,135,82520,9048,242,609566,2001
DE,housing and community development,0,0,0,0,0,0,0,2001
DE,natural resources,405,1319772,125,122068,7563,451,1441840,2001
DE,water transport and terminals,0,0,0,0,0,0,0,2001
DE,electric power,0,0,0,0,0,0,0,2001
DE,gas supply,0,0,0,0,0,0,0,2001
DE,transit,552,1983971,30,48099,4008,575,2032070,2001
DE,education - elementary and secondary instructional,0,0,0,0,0,0,0,2001
DE,education - elementary and secondary total,0,0,0,0,0,0,0,2001
DE,education - higher education instructional,1516,8761562,2613,3271293,178873,2595,12032855,2001
DE,education - higher education other,3646,12404580,3609,2333465,196019,4836,14738045,2001
DE,education - other,338,1413824,7,15514,862,343,1429338,2001
DE,libraries,0,0,0,0,0,0,0,2001
DE,liquor stores,0,0,0,0,0,0,0,2001
DE,other and unallocable,1574,4969385,242,193528,17094,1679,5162913,2001
FL,total,172584,535355548,38932,41538999,2649018,187552,576894547,2001
FL,financial administration,6718,21055958,223,167020,24337,6854,21222978,2001
FL,other government administration,2053,6925352,33,35650,2341,2066,6961002,2001
FL,judicial and legal,17715,60506623,432,762776,45111,17973,61269399,2001
FL,police protection - officers,2200,7889609,0,0,0,2200,7889609,2001
FL,police protection - other,2019,5474586,22,24002,1931,2030,5498588,2001
FL,corrections,28007,76009839,30,44766,2997,28024,76054605,2001
FL,streets and highways,9750,29663200,40,46211,3600,9770,29709411,2001
FL,air transportation,0,0,0,0,0,0,0,2001
FL,water transport and terminals,0,0,6,4974,240,1,4974,2001
FL,public welfare,13795,35402901,89,103354,8103,13841,35506255,2001
FL,health,19725,53290070,1011,1723147,138273,20506,55013217,2001
FL,hospitals,5688,14718636,42,67485,3870,5710,14786121,2001
FL,social insurance administration,3581,9910519,46,66532,4161,3605,9977051,2001
FL,solid waste management,0,0,0,0,0,0,0,2001
FL,sewerage,0,0,0,0,0,0,0,2001
FL,parks and recreation,1326,2568597,77,51327,7638,1369,2619924,2001
FL,housing and community development,0,0,0,0,0,0,0,2001
FL,natural resources,10306,27481458,2114,1812129,136786,11080,29293587,2001
FL,water transport and terminals,0,0,0,0,0,0,0,2001
FL,electric power,0,0,0,0,0,0,0,2001
FL,gas supply,0,0,0,0,0,0,0,2001
FL,transit,534,1727274,32,34382,3372,553,1761656,2001
FL,education - elementary and secondary instructional,0,0,0,0,0,0,0,2001
FL,education - elementary and secondary total,0,0,0,0,0,0,0,2001
FL,education - higher education instructional,13996,84102634,15969,20987467,1064078,20007,105090101,2001
FL,education - higher education other,23368,65961541,18410,15287326,1173731,29999,81248867,2001
FL,education - other,3318,8594211,72,66929,5385,3348,8661140,2001
FL,libraries,0,0,0,0,0,0,0,2001
FL,liquor stores,0,0,0,0,0,0,0,2001
FL,other and unallocable,8485,24072540,284,253522,23064,8616,24326062,2001
GA,total,107626,325862909,35213,28406026,2399005,121180,354268935,2001
GA,financial administration,2793,9208841,450,523276,51552,3085,9732117,2001
GA,other government administration,1032,3486877,608,1145874,67888,1416,4632751,2001
GA,judicial and legal,1462,6725978,10,20208,848,1467,6746186,2001
GA,police protection - officers,1185,3862558,0,0,0,1185,3862558,2001
GA,police protection - other,1107,3060870,18,17008,1700,1117,3077878,2001
GA,corrections,19660,46826058,661,533026,62276,20012,47359084,2001
GA,streets and highways,6050,15499030,31,17048,1064,6056,15516078,2001
GA,air transportation,0,0,0,0,0,0,0,2001
GA,water transport and terminals,675,2812105,0,0,0,675,2812105,2001
GA,public welfare,9486,23368235,177,164314,18266,9589,23532549,2001
GA,health,3815,12248037,189,148313,19146,3924,12396350,2001
GA,hospitals,9644,22405156,324,257721,13640,9720,22662877,2001
GA,social insurance administration,2015,5691722,28,11330,1680,2024,5703052,2001
GA,solid waste management,0,0,0,0,0,0,0,2001
GA,sewerage,0,0,0,0,0,0,0,2001
GA,parks and recreation,1256,2914005,2936,2754600,330562,3123,5668605,2001
GA,housing and community development,0,0,0,0,0,0,0,2001
GA,natural resources,4348,12339850,915,707172,70806,4747,13047022,2001
GA,water transport and terminals,0,0,0,0,0,0,0,2001
GA,electric power,0,0,0,0,0,0,0,2001
GA,gas supply,0,0,0,0,0,0,0,2001
GA,transit,0,0,0,0,0,0,0,2001
GA,education - elementary and secondary instructional,0,0,0,0,0,0,0,2001
GA,education - elementary and secondary total,0,0,0,0,0,0,0,2001
GA,education - higher education instructional,10223,54821170,8348,9316369,460828,12825,64137539,2001
GA,education - higher education other,21977,64382257,16311,9355761,1024846,27766,73738018,2001
GA,education - other,6669,22502455,3745,3234698,248108,8071,25737153,2001
GA,libraries,0,0,0,0,0,0,0,2001
GA,liquor stores,0,0,0,0,0,0,0,2001
GA,other and unallocable,4229,13707705,462,199308,25795,4378,13907013,2001
HI,total,49771,146703862,18682,13670994,883650,54890,160374856,2001
HI,financial administration,673,2052414,6,2290,468,676,2054704,2001
HI,other government administration,607,2046764,10,16348,812,611,2063112,2001
HI,judicial and legal,2199,7375620,71,85168,3318,2218,7460788,2001
HI,police protection - officers,0,0,0,0,0,0,0,2001
HI,police protection - other,0,0,0,0,0,0,0,2001
HI,corrections,2448,6879414,24,56408,2616,2463,6935822,2001
HI,streets and highways,909,2818750,12,7922,936,914,2826672,2001
HI,air transportation,1099,2903974,26,42766,2008,1110,2946740,2001
HI,water transport and terminals,208,582074,3,1614,232,209,583688,2001
HI,public welfare,797,2282596,45,24232,3430,816,2306828,2001
HI,health,2412,7295472,86,128638,6084,2446,7424110,2001
HI,hospitals,3527,10942726,280,550698,29506,3696,11493424,2001
HI,social insurance administration,423,1068390,56,68906,4520,449,1137296,2001
HI,solid waste management,0,0,0,0,0,0,0,2001
HI,sewerage,0,0,0,0,0,0,0,2001
HI,parks and recreation,160,412004,167,81404,8120,205,493408,2001
HI,housing and community development,0,0,0,0,0,0,0,2001
HI,natural resources,1009,3520804,354,458246,28808,1172,3979050,2001
HI,water transport and terminals,0,0,0,0,0,0,0,2001
HI,electric power,0,0,0,0,0,0,0,2001
HI,gas supply,0,0,0,0,0,0,0,2001
HI,transit,0,0,0,0,0,0,0,2001
HI,education - elementary and secondary instructional,18742,51696884,6601,3743960,213832,20030,55440844,2001
HI,education - elementary and secondary total,4682,10374884,3937,1285918,110584,5348,11660802,2001
HI,education - higher education instructional,2000,9574210,1419,2142166,78168,2442,11716376,2001
HI,education - higher education other,3639,12376402,5258,4743538,364888,5700,17119940,2001
HI,education - other,140,418186,3,3748,240,141,421934,2001
HI,libraries,484,1182880,228,138036,17242,588,1320916,2001
HI,liquor stores,0,0,0,0,0,0,0,2001
HI,other and unallocable,3613,10899414,96,88988,7838,3656,10988402,2001
ID,total,17929,56080437,12528,10239793,936082,23215,66320230,2001
ID,financial administration,1336,4226865,245,129300,15734,1424,4356165,2001
ID,other government administration,159,567340,263,419712,24580,297,987052,2001
ID,judicial and legal,457,2177717,16,9133,1142,463,2186850,2001
ID,police protection - officers,273,1083124,0,0,0,273,1083124,2001
ID,police protection - other,213,636164,6,6669,370,215,642833,2001
ID,corrections,1607,4389153,130,77220,11314,1671,4466373,2001
ID,streets and highways,1620,4768112,155,217541,20170,1734,4985653,2001
ID,air transportation,0,0,0,0,0,0,0,2001
ID,water transport and terminals,0,0,0,0,0,0,0,2001
ID,public welfare,1705,4272886,262,344670,17798,1805,4617556,2001
ID,health,989,3030205,151,187386,10607,1049,3217591,2001
ID,hospitals,889,2306835,253,186791,15826,978,2493626,2001
ID,social insurance administration,494,1876283,257,209247,26154,641,2085530,2001
ID,solid waste management,0,0,0,0,0,0,0,2001
ID,sewerage,0,0,0,0,0,0,0,2001
ID,parks and recreation,182,443787,204,52556,6569,219,496343,2001
ID,housing and community development,0,0,0,0,0,0,0,2001
ID,natural resources,1389,4374443,1066,1478762,130656,2125,5853205,2001
ID,water transport and terminals,0,0,0,0,0,0,0,2001
ID,electric power,0,0,0,0,0,0,0,2001
ID,gas supply,0,0,0,0,0,0,0,2001
ID,transit,0,0,0,0,0,0,0,2001
ID,education - elementary and secondary instructional,0,0,0,0,0,0,0,2001
ID,education - elementary and secondary total,0,0,0,0,0,0,0,2001
ID,education - higher education instructional,1909,8144613,1785,2162943,146655,2737,10307556,2001
ID,education - higher education other,3175,9036180,6789,4516929,479444,5883,13553109,2001
ID,education - other,524,1731582,452,126798,15849,615,1858380,2001
ID,libraries,0,0,0,0,0,0,0,2001
ID,liquor stores,120,346630,127,21471,2683,135,368101,2001
ID,other and unallocable,888,2668518,367,92665,10531,951,2761183,2001
IL,total,112033,408518582,39859,31258715,3050742,129842,439777297,2001
IL,financial administration,5861,19293459,295,403119,33812,6066,19696578,2001
IL,other government administration,2456,9306626,47,67978,3653,2479,9374604,2001
IL,judicial and legal,3161,18158539,80,106926,6388,3198,18265465,2001
IL,police protection - officers,2315,10547108,0,0,0,2315,10547108,2001
IL,police protection - other,1975,7482652,3,4004,340,1977,7486656,2001
IL,corrections,15763,53092995,25,63973,1858,15775,53156968,2001
IL,streets and highways,7296,28440600,1380,2952332,168269,8246,31392932,2001
IL,air transportation,0,0,0,0,0,0,0,2001
IL,water transport and terminals,98,432244,5,4486,450,101,436730,2001
IL,public welfare,15065,53625388,138,304516,18742,15177,53929904,2001
IL,health,3194,12195262,21,47400,1940,3207,12242662,2001
IL,hospitals,9608,28141158,128,292804,19520,9726,28433962,2001
IL,social insurance administration,2288,8858380,381,1074386,50743,2594,9932766,2001
IL,solid waste management,0,0,0,0,0,0,0,2001
IL,sewerage,0,0,0,0,0,0,0,2001
IL,parks and recreation,733,2343002,80,143484,10962,799,2486486,2001
IL,housing and community development,0,0,0,0,0,0,0,2001
IL,natural resources,3149,11538371,1230,1288891,180598,4176,12827262,2001
IL,water transport and terminals,0,0,0,0,0,0,0,2001
IL,electric power,0,0,0,0,0,0,0,2001
IL,gas supply,0,0,0,0,0,0,0,2001
IL,transit,0,0,0,0,0,0,0,2001
IL,education - elementary and secondary instructional,0,0,0,0,0,0,0,2001
IL,education - elementary and secondary total,0,0,0,0,0,0,0,2001
IL,education - higher education instructional,9347,46499501,10640,11940340,638422,13141,58439841,2001
IL,education - higher education other,19721,61465890,25050,11974015,1881478,30665,73439905,2001
IL,education - other,2547,9496690,77,200293,9882,2607,9696983,2001
IL,libraries,0,0,0,0,0,0,0,2001
IL,liquor stores,0,0,0,0,0,0,0,2001
IL,other and unallocable,7456,27600717,279,389768,23685,7593,27990485,2001
IN,total,73621,231696701,34316,28339602,2272753,86609,260036303,2001
IN,financial administration,2568,7048821,115,66411,7985,2616,7115232,2001
IN,other government administration,535,1696792,132,128482,6520,575,1825274,2001
IN,judicial and legal,1296,6357926,24,40621,2557,1312,6398547,2001
IN,police protection - officers,1281,5439194,0,0,0,1281,5439194,2001
IN,police protection - other,770,2058433,1,1063,106,771,2059496,2001
IN,corrections,8278,24825591,17,42670,1767,8290,24868261,2001
IN,streets and highways,4267,10832750,1,1204,93,4268,10833954,2001
IN,air transportation,0,0,0,0,0,0,0,2001
IN,water transport and terminals,34,123267,1,582,69,34,123849,2001
IN,public welfare,4954,11316773,39,37297,3633,4976,11354070,2001
IN,health,1761,5696716,7,11110,580,1764,5707826,2001
IN,hospitals,4736,12447490,81,117872,6870,4778,12565362,2001
IN,social insurance administration,1391,3607932,180,174419,19512,1509,3782351,2001
IN,solid waste management,0,0,0,0,0,0,0,2001
IN,sewerage,0,0,0,0,0,0,0,2001
IN,parks and recreation,90,233574,74,52313,6604,130,285887,2001
IN,housing and community development,0,0,0,0,0,0,0,2001
IN,natural resources,2393,6854466,794,633144,76195,2840,7487610,2001
IN,water transport and terminals,0,0,0,0,0,0,0,2001
IN,electric power,0,0,0,0,0,0,0,2001
IN,gas supply,0,0,0,0,0,0,0,2001
IN,transit,0,0,0,0,0,0,0,2001
IN,education - elementary and secondary instructional,0,0,0,0,0,0,0,2001
IN,education - elementary and secondary total,0,0,0,0,0,0,0,2001
IN,education - higher education instructional,12900,66190520,12183,17969011,1073098,18974,84159531,2001
IN,education - higher education other,23534,58779437,20576,8951317,1060842,29620,67730754,2001
IN,education - other,1134,3353051,72,79154,4502,1161,3432205,2001
IN,libraries,0,0,0,0,0,0,0,2001
IN,liquor stores,0,0,0,0,0,0,0,2001
IN,other and unallocable,1699,4833968,19,32932,1820,1710,4866900,2001
IA,total,42869,162578068,23815,30220569,2096982,54718,192798637,2001
IA,financial administration,1364,4727834,166,220519,19140,1470,4948353,2001
IA,other government administration,435,1930090,407,643550,47816,706,2573640,2001
IA,judicial and legal,2328,8877285,227,368073,25322,2471,9245358,2001
IA,police protection - officers,652,2605650,0,0,0,652,2605650,2001
IA,police protection - other,368,1081189,63,38934,3253,386,1120123,2001
IA,corrections,3362,10695255,134,257539,15269,3449,10952794,2001
IA,streets and highways,2871,9107298,2,5555,292,2873,9112853,2001
IA,air transportation,0,0,0,0,0,0,0,2001
IA,water transport and terminals,0,0,0,0,0,0,0,2001
IA,public welfare,2831,9186421,95,186585,11050,2894,9373006,2001
IA,health,375,1494632,25,35991,2331,388,1530623,2001
IA,hospitals,5660,20933977,2806,6300967,313616,7433,27234944,2001
IA,social insurance administration,346,1096376,1,686,60,346,1097062,2001
IA,solid waste management,0,0,0,0,0,0,0,2001
IA,sewerage,0,0,0,0,0,0,0,2001
IA,parks and recreation,105,351984,11,10350,1227,112,362334,2001
IA,housing and community development,0,0,0,0,0,0,0,2001
IA,natural resources,2305,7821367,1340,1962771,133225,3057,9784138,2001
IA,water transport and terminals,0,0,0,0,0,0,0,2001
IA,electric power,0,0,0,0,0,0,0,2001
IA,gas supply,0,0,0,0,0,0,0,2001
IA,transit,0,0,0,0,0,0,0,2001
IA,education - elementary and secondary instructional,0,0,0,0,0,0,0,2001
IA,education - elementary and secondary total,0,0,0,0,0,0,0,2001
IA,education - higher education instructional,4623,29436952,3802,9134005,407277,6925,38570957,2001
IA,education - higher education other,10957,38252790,14379,10527476,1081933,17069,48780266,2001
IA,education - other,1144,4036749,81,84918,6479,1181,4121667,2001
IA,libraries,0,0,0,0,0,0,0,2001
IA,liquor stores,0,0,0,0,0,0,0,2001
IA,other and unallocable,3143,10942219,276,442650,28692,3306,11384869,2001
KS,total,38183,119924833,17364,13011929,1038740,44053,132936762,2001
KS,financial administration,2055,5651758,62,77984,5741,2087,5729742,2001
KS,other government administration,364,1181211,393,627481,34781,561,1808692,2001
KS,judicial and legal,2030,6437896,213,154012,11306,2094,6591908,2001
KS,police protection - officers,586,2113394,0,0,0,586,2113394,2001
KS,police protection - other,469,1169663,10,9595,773,474,1179258,2001
KS,corrections,3628,9200978,27,33145,2117,3640,9234123,2001
KS,streets and highways,3518,9936917,125,114771,10740,3579,10051688,2001
KS,air transportation,0,0,0,0,0,0,0,2001
KS,water transport and terminals,0,0,0,0,0,0,0,2001
KS,public welfare,2873,7540508,7,4672,620,2877,7545180,2001
KS,health,978,3091580,33,35202,1762,988,3126782,2001
KS,hospitals,2690,6853961,403,177005,6517,2726,7030966,2001
KS,social insurance administration,130,334381,0,0,0,130,334381,2001
KS,solid waste management,0,0,0,0,0,0,0,2001
KS,sewerage,0,0,0,0,0,0,0,2001
KS,parks and recreation,540,1240548,30,17867,1636,549,1258415,2001
KS,housing and community development,0,0,0,0,0,0,0,2001
KS,natural resources,834,2552932,98,70753,7231,875,2623685,2001
KS,water transport and terminals,0,0,0,0,0,0,0,2001
KS,electric power,0,0,0,0,0,0,0,2001
KS,gas supply,0,0,0,0,0,0,0,2001
KS,transit,0,0,0,0,0,0,0,2001
KS,education - elementary and secondary instructional,0,0,0,0,0,0,0,2001
KS,education - elementary and secondary total,0,0,0,0,0,0,0,2001
KS,education - higher education instructional,4137,24607765,3347,4908236,216318,5359,29516001,2001
KS,education - higher education other,9397,26531646,12235,6491793,714416,13434,33023439,2001
KS,education - other,584,1834384,67,57709,2581,598,1892093,2001
KS,libraries,0,0,0,0,0,0,0,2001
KS,liquor stores,0,0,0,0,0,0,0,2001
KS,other and unallocable,3370,9645311,314,231704,22201,3496,9877015,2001
KY,total,68325,215045203,24903,17783119,1458638,76906,232828322,2001
KY,financial administration,2948,8686580,231,241744,28478,3119,8928324,2001
KY,other government administration,1075,4538112,527,976642,50634,1379,5514754,2001
KY,judicial and legal,4114,13108304,819,1206564,105006,4747,14314868,2001
KY,police protection - officers,1031,3800038,2,4886,284,1033,3804924,2001
KY,police protection - other,1165,3514972,29,40074,3756,1188,3555046,2001
KY,corrections,3783,9261374,135,106480,2368,3797,9367854,2001
KY,streets and highways,5464,16200298,185,108838,8268,5513,16309136,2001
KY,air transportation,0,0,0,0,0,0,0,2001
KY,water transport and terminals,0,0,0,0,0,0,0,2001
KY,public welfare,6903,18781192,75,81788,7752,6949,18862980,2001
KY,health,2126,6434048,45,71498,4648,2154,6505546,2001
KY,hospitals,5062,14626030,381,832706,51539,5356,15458736,2001
KY,social insurance administration,1032,3125492,73,98044,8180,1081,3223536,2001
KY,solid waste management,0,0,0,0,0,0,0,2001
KY,sewerage,0,0,0,0,0,0,0,2001
KY,parks and recreation,1620,3245364,123,106366,16222,1718,3351730,2001
KY,housing and community development,0,0,0,0,0,0,0,2001
KY,natural resources,3344,9646477,840,717863,86099,3846,10364340,2001
KY,water transport and terminals,0,0,0,0,0,0,0,2001
KY,electric power,0,0,0,0,0,0,0,2001
KY,gas supply,0,0,0,0,0,0,0,2001
KY,transit,0,0,0,0,0,0,0,2001
KY,education - elementary and secondary instructional,0,0,0,0,0,0,0,2001
KY,education - elementary and secondary total,0,0,0,0,0,0,0,2001
KY,education - higher education instructional,6873,35665783,5788,6356048,402919,9227,42021831,2001
KY,education - higher education other,13904,38098019,14385,5762868,612715,17502,43860887,2001
KY,education - other,4061,13836492,1033,896572,57442,4407,14733064,2001
KY,libraries,0,0,0,0,0,0,0,2001
KY,liquor stores,0,0,0,0,0,0,0,2001
KY,other and unallocable,3820,12476628,232,174138,12328,3890,12650766,2001
LA,total,85203,245063189,25885,16920674,1542270,93919,261983863,2001
LA,financial administration,2556,6810177,262,380204,29476,2723,7190381,2001
LA,other government administration,1310,4383727,370,405918,25910,1455,4789645,2001
LA,judicial and legal,1715,6787527,51,41446,2440,1729,6828973,2001
LA,police protection - officers,1020,3683618,0,0,0,1020,3683618,2001
LA,police protection - other,441,1112557,5,2586,301,443,1115143,2001
LA,corrections,7536,20662534,391,742137,56242,7854,21404671,2001
LA,streets and highways,5392,13831930,12,11225,1853,5403,13843155,2001
LA,air transportation,0,0,0,0,0,0,0,2001
LA,water transport and terminals,394,1221452,7,6880,400,396,1228332,2001
LA,public welfare,5389,14100803,8,11028,266,5391,14111831,2001
LA,health,4712,14042112,259,198636,13211,4787,14240748,2001
LA,hospitals,18478,45785668,3018,3266441,271864,20013,49052109,2001
LA,social insurance administration,947,2590030,110,81825,7273,988,2671855,2001
LA,solid waste management,0,0,0,0,0,0,0,2001
LA,sewerage,0,0,0,0,0,0,0,2001
LA,parks and recreation,1003,2272202,457,262507,35776,1205,2534709,2001
LA,housing and community development,0,0,0,0,0,0,0,2001
LA,natural resources,4798,12688187,955,620517,68182,5184,13308704,2001
LA,water transport and terminals,0,0,0,0,0,0,0,2001
LA,electric power,0,0,0,0,0,0,0,2001
LA,gas supply,0,0,0,0,0,0,0,2001
LA,transit,0,0,0,0,0,0,0,2001
LA,education - elementary and secondary instructional,0,0,0,0,0,0,0,2001
LA,education - elementary and secondary total,0,0,0,0,0,0,0,2001
LA,education - higher education instructional,7558,40421336,4239,4357943,254709,8998,44779279,2001
LA,education - higher education other,16038,37391160,14719,5779339,713439,20069,43170499,2001
LA,education - other,3235,9770286,708,468968,32414,3418,10239254,2001
LA,libraries,0,0,0,0,0,0,0,2001
LA,liquor stores,0,0,0,0,0,0,0,2001
LA,other and unallocable,2681,7507883,314,283074,28514,2843,7790957,2001
ME,total,18602,59986499,7595,6766360,520395,21544,66752859,2001
ME,financial administration,1117,3256654,78,130204,9064,1169,3386858,2001
ME,other government administration,376,1411253,232,454139,34539,571,1865392,2001
ME,judicial and legal,637,2474857,77,101107,6226,672,2575964,2001
ME,police protection - officers,330,1289544,0,0,0,330,1289544,2001
ME,police protection - other,186,424982,0,0,0,186,424982,2001
ME,corrections,1183,3871102,73,131634,8415,1232,4002736,2001
ME,streets and highways,2494,7657189,165,344470,28063,2653,8001659,2001
ME,air transportation,0,0,0,0,0,0,0,2001
ME,water transport and terminals,57,168928,14,14309,1333,65,183237,2001
ME,public welfare,2036,5656332,63,91796,6423,2072,5748128,2001
ME,health,1194,3933817,76,175786,9589,1248,4109603,2001
ME,hospitals,557,1808964,125,301126,15613,645,2110090,2001
ME,social insurance administration,473,1485198,39,73151,4298,497,1558349,2001
ME,solid waste management,0,0,0,0,0,0,0,2001
ME,sewerage,0,0,0,0,0,0,0,2001
ME,parks and recreation,141,429743,14,16479,1315,149,446222,2001
ME,housing and community development,0,0,0,0,0,0,0,2001
ME,natural resources,1156,3848995,291,330904,22720,1285,4179899,2001
ME,water transport and terminals,0,0,0,0,0,0,0,2001
ME,electric power,0,0,0,0,0,0,0,2001
ME,gas supply,0,0,0,0,0,0,0,2001
ME,transit,0,0,0,0,0,0,0,2001
ME,education - elementary and secondary instructional,25,83716,15,14674,1249,32,98390,2001
ME,education - elementary and secondary total,6,11792,40,37262,3173,24,49054,2001
ME,education - higher education instructional,1391,6159731,405,554981,28012,1549,6714712,2001
ME,education - higher education other,3666,10988482,5740,3782304,326608,5511,14770786,2001
ME,education - other,374,1187265,69,84249,5446,405,1271514,2001
ME,libraries,0,0,0,0,0,0,0,2001
ME,liquor stores,88,226499,12,11342,1072,94,237841,2001
ME,other and unallocable,1115,3611456,67,116443,7237,1155,3727899,2001
MD,total,81712,298198648,15889,27647252,1694971,91288,325845900,2001
MD,financial administration,3550,12676368,145,293826,18266,3652,12970194,2001
MD,other government administration,1395,5091156,349,607474,19614,1506,5698630,2001
MD,judicial and legal,3774,13516183,518,869821,71045,4175,14386004,2001
MD,police protection - officers,1616,8079400,0,0,0,1616,8079400,2001
MD,police protection - other,766,2883875,33,73554,4326,790,2957429,2001
MD,corrections,11424,38380002,441,847477,69189,11815,39227479,2001
MD,streets and highways,4748,17178915,0,0,0,4748,17178915,2001
MD,air transportation,462,1851091,0,0,0,462,1851091,2001
MD,water transport and terminals,295,1158937,0,0,0,295,1158937,2001
MD,public welfare,7047,22313040,327,657450,51155,7337,22970490,2001
MD,health,5922,20847708,911,1538515,115001,6572,22386223,2001
MD,hospitals,5341,16478498,627,828529,61865,5693,17307027,2001
MD,social insurance administration,1045,3639109,102,213128,16131,1136,3852237,2001
MD,solid waste management,0,0,0,0,0,0,0,2001
MD,sewerage,0,0,0,0,0,0,0,2001
MD,parks and recreation,478,1894464,160,207742,24299,615,2102206,2001
MD,housing and community development,0,0,0,0,0,0,0,2001
MD,natural resources,2081,7836485,122,207465,15642,2170,8043950,2001
MD,water transport and terminals,0,0,0,0,0,0,0,2001
MD,electric power,0,0,0,0,0,0,0,2001
MD,gas supply,0,0,0,0,0,0,0,2001
MD,transit,2016,8147518,222,281769,26990,2168,8429287,2001
MD,education - elementary and secondary instructional,0,0,0,0,0,0,0,2001
MD,education - elementary and secondary total,0,0,0,0,0,0,0,2001
MD,education - higher education instructional,9484,48731933,3494,8942197,325956,11325,57674130,2001
MD,education - higher education other,11037,35290829,7257,10195523,731699,15170,45486352,2001
MD,education - other,1960,7403543,315,586442,38907,2179,7989985,2001
MD,libraries,0,0,0,0,0,0,0,2001
MD,liquor stores,0,0,0,0,0,0,0,2001
MD,other and unallocable,7271,24799594,866,1296340,104886,7864,26095934,2001
MA,total,86591,337734087,27034,28672306,1464234,95259,366406393,2001
MA,financial administration,4499,17752688,354,783922,41178,4747,18536610,2001
MA,other government administration,2031,6877728,265,533685,16091,2123,7411413,2001
MA,judicial and legal,10087,40523667,381,823999,20931,10212,41347666,2001
MA,police protection - officers,5140,24612429,24,36823,1050,5146,24649252,2001
MA,police protection - other,552,2166752,9,12702,547,555,2179454,2001
MA,corrections,7108,27181411,70,137959,7435,7153,27319370,2001
MA,streets and highways,4110,16402993,212,486674,24607,4250,16889667,2001
MA,air transportation,1110,6035019,158,233317,11954,1178,6268336,2001
MA,water transport and terminals,159,761862,7,9837,735,163,771699,2001
MA,public welfare,7101,25696295,692,1509747,83647,7605,27206042,2001
MA,health,7447,26446076,1334,2656504,104367,8075,29102580,2001
MA,hospitals,7406,22128973,879,1523037,76000,7835,23652010,2001
MA,social insurance administration,1378,5205227,154,313994,19365,1495,5519221,2001
MA,solid waste management,3,16133,0,0,0,3,16133,2001
MA,sewerage,1200,4998931,48,145871,5846,1233,5144802,2001
MA,parks and recreation,920,2686522,106,82777,8460,968,2769299,2001
MA,housing and community development,0,0,0,0,0,0,0,2001
MA,natural resources,1139,4823212,128,305216,12963,1217,5128428,2001
MA,water transport and terminals,700,2757934,38,72476,3940,722,2830410,2001
MA,electric power,0,0,0,0,0,0,0,2001
MA,gas supply,0,0,0,0,0,0,0,2001
MA,transit,0,0,0,0,0,0,0,2001
MA,education - elementary and secondary instructional,0,0,0,0,0,0,0,2001
MA,education - elementary and secondary total,0,0,0,0,0,0,0,2001
MA,education - higher education instructional,6592,34141398,8833,11212870,558174,9916,45354268,2001
MA,education - higher education other,12968,45691044,13093,7138592,446996,15607,52829636,2001
MA,education - other,1062,4239605,98,225436,8082,1111,4465041,2001
MA,libraries,0,0,0,0,0,0,0,2001
MA,liquor stores,0,0,0,0,0,0,0,2001
MA,other and unallocable,3879,16588188,151,426868,11866,3945,17015056,2001
MI,total,114551,462972406,65694,60550112,4747216,141375,523522518,2001
MI,financial administration,2488,9585721,855,1512768,80726,2945,11098489,2001
MI,other government administration,1515,5387661,34,28213,1816,1525,5415874,2001
MI,judicial and legal,2000,9601335,53,67368,3934,2022,9668703,2001
MI,police protection - officers,2178,9684620,0,0,0,2178,9684620,2001
MI,police protection - other,1030,3860155,142,162826,12226,1099,4022981,2001
MI,corrections,18876,70147550,182,350113,15174,18961,70497663,2001
MI,streets and highways,3091,12059454,155,175393,11243,3155,12234847,2001
MI,air transportation,0,0,0,0,0,0,0,2001
MI,water transport and terminals,0,0,0,0,0,0,0,2001
MI,public welfare,13364,48933640,296,468151,27675,13520,49401791,2001
MI,health,1763,7118687,224,306398,14328,1844,7425085,2001
MI,hospitals,10132,36579640,3532,6433302,454574,12700,43012942,2001
MI,social insurance administration,1145,4230394,30,49496,1917,1156,4279890,2001
MI,solid waste management,0,0,0,0,0,0,0,2001
MI,sewerage,0,0,0,0,0,0,0,2001
MI,parks and recreation,236,803720,178,283380,15252,323,1087100,2001
MI,housing and community development,0,0,0,0,0,0,0,2001
MI,natural resources,4497,17455103,1237,1183662,102193,5074,18638765,2001
MI,water transport and terminals,0,0,0,0,0,0,0,2001
MI,electric power,0,0,0,0,0,0,0,2001
MI,gas supply,0,0,0,0,0,0,0,2001
MI,transit,0,0,0,0,0,0,0,2001
MI,education - elementary and secondary instructional,634,1706476,101,86030,6265,670,1792506,2001
MI,education - elementary and secondary total,150,416439,58,45962,5220,184,462401,2001
MI,education - higher education instructional,13776,87358070,15370,24355173,1419191,21794,111713243,2001
MI,education - higher education other,30180,107354560,41979,24191719,2523491,44436,131546279,2001
MI,education - other,380,1657079,62,86853,4479,405,1743932,2001
MI,libraries,0,0,0,0,0,0,0,2001
MI,liquor stores,0,0,0,0,0,0,0,2001
MI,other and unallocable,7116,29032102,1206,763305,47512,7384,29795407,2001
MN,total,59516,247058266,30571,33461235,2843668,75588,280519501,2001
MN,financial administration,2422,9428696,144,245677,21354,2543,9674373,2001
MN,other government administration,1350,4764591,142,283465,14282,1431,5048056,2001
MN,judicial and legal,2032,8969522,459,1235941,61939,2382,10205463,2001
MN,police protection - officers,545,2763260,0,0,0,545,2763260,2001
MN,police protection - other,381,1322427,26,39263,2810,397,1361690,2001
MN,corrections,3645,13179107,135,291701,18383,3749,13470808,2001
MN,streets and highways,5065,20363342,235,323698,25279,5208,20687040,2001
MN,air transportation,0,0,0,0,0,0,0,2001
MN,water transport and terminals,0,0,0,0,0,0,0,2001
MN,public welfare,1687,6263197,1094,1984716,176166,2683,8247913,2001
MN,health,2026,8538168,210,479159,25612,2171,9017327,2001
MN,hospitals,3436,13397284,1243,2626484,215318,4652,16023768,2001
MN,social insurance administration,1132,4372265,117,225132,13144,1207,4597397,2001
MN,solid waste management,0,0,0,0,0,0,0,2001
MN,sewerage,0,0,0,0,0,0,0,2001
MN,parks and recreation,506,1912849,110,145940,10264,564,2058789,2001
MN,housing and community development,0,0,0,0,0,0,0,2001
MN,natural resources,3024,11797599,653,962800,77234,3458,12760399,2001
MN,water transport and terminals,0,0,0,0,0,0,0,2001
MN,electric power,0,0,0,0,0,0,0,2001
MN,gas supply,0,0,0,0,0,0,0,2001
MN,transit,0,0,0,0,0,0,0,2001
MN,education - elementary and secondary instructional,0,0,0,0,0,0,0,2001
MN,education - elementary and secondary total,0,0,0,0,0,0,0,2001
MN,education - higher education instructional,10026,50867132,10479,13065286,859409,14889,63932418,2001
MN,education - higher education other,14835,60607909,14014,9371791,1192316,21569,69979700,2001
MN,education - other,4115,15532664,1308,1820556,107041,4719,17353220,2001
MN,libraries,0,0,0,0,0,0,0,2001
MN,liquor stores,0,0,0,0,0,0,0,2001
MN,other and unallocable,3289,12978254,202,359626,23117,3421,13337880,2001
MS,total,51180,142998107,14583,9294765,990908,56781,152292872,2001
MS,financial administration,1198,3412604,17,15718,1795,1208,3428322,2001
MS,other government administration,455,1452182,91,96199,7035,494,1548381,2001
MS,judicial and legal,636,3201623,91,57227,3562,656,3258850,2001
MS,police protection - officers,733,2085677,0,0,0,733,2085677,2001
MS,police protection - other,553,1303214,0,0,0,553,1303214,2001
MS,corrections,4291,8862410,25,30853,3012,4308,8893263,2001
MS,streets and highways,3298,7557908,5,6192,860,3303,7564100,2001
MS,air transportation,0,0,0,0,0,0,0,2001
MS,water transport and terminals,66,191194,4,4802,427,68,195996,2001
MS,public welfare,3053,6464652,0,0,0,3053,6464652,2001
MS,health,2961,7699324,85,182307,9894,3016,7881631,2001
MS,hospitals,11239,25071182,415,941420,53692,11542,26012602,2001
MS,social insurance administration,763,2073222,213,395089,34007,955,2468311,2001
MS,solid waste management,0,0,0,0,0,0,0,2001
MS,sewerage,0,0,0,0,0,0,0,2001
MS,parks and recreation,324,576748,139,86350,10858,386,663098,2001
MS,housing and community development,0,0,0,0,0,0,0,2001
MS,natural resources,3105,7810141,863,593251,64104,3468,8403392,2001
MS,water transport and terminals,0,0,0,0,0,0,0,2001
MS,electric power,0,0,0,0,0,0,0,2001
MS,gas supply,0,0,0,0,0,0,0,2001
MS,transit,0,0,0,0,0,0,0,2001
MS,education - elementary and secondary instructional,0,0,0,0,0,0,0,2001
MS,education - elementary and secondary total,0,0,0,0,0,0,0,2001
MS,education - higher education instructional,5204,27384863,1967,2006395,156511,6088,29391258,2001
MS,education - higher education other,8714,26154694,10548,4744191,635547,12305,30898885,2001
MS,education - other,1508,3966917,42,29471,4030,1532,3996388,2001
MS,libraries,0,0,0,0,0,0,0,2001
MS,liquor stores,124,271434,0,0,0,124,271434,2001
MS,other and unallocable,2955,7458118,78,105300,5574,2989,7563418,2001
MO,total,83020,231879620,25545,17870655,1675548,92563,249750275,2001
MO,financial administration,2574,6868037,520,307533,36102,2777,7175570,2001
MO,other government administration,1012,2713633,137,165468,12934,1089,2879101,2001
MO,judicial and legal,3654,11815214,374,465432,45030,3907,12280646,2001
MO,police protection - officers,1219,4316180,0,0,0,1219,4316180,2001
MO,police protection - other,1155,2772642,25,23270,2842,1171,2795912,2001
MO,corrections,11464,24184352,432,354220,24155,11601,24538572,2001
MO,streets and highways,6392,19288124,266,512930,37512,6604,19801054,2001
MO,air transportation,0,0,0,0,0,0,0,2001
MO,water transport and terminals,0,0,0,0,0,0,0,2001
MO,public welfare,8123,18374789,428,331141,33548,8312,18705930,2001
MO,health,3293,8778928,354,544878,33834,3516,9323806,2001
MO,hospitals,12289,29892477,2055,1802781,152067,13148,31695258,2001
MO,social insurance administration,636,1746550,15,18000,1200,643,1764550,2001
MO,solid waste management,0,0,0,0,0,0,0,2001
MO,sewerage,0,0,0,0,0,0,0,2001
MO,parks and recreation,520,1308535,248,213628,20082,661,1522163,2001
MO,housing and community development,0,0,0,0,0,0,0,2001
MO,natural resources,2444,7019895,536,498837,52730,2749,7518732,2001
MO,water transport and terminals,0,0,0,0,0,0,0,2001
MO,electric power,0,0,0,0,0,0,0,2001
MO,gas supply,0,0,0,0,0,0,0,2001
MO,transit,0,0,0,0,0,0,0,2001
MO,education - elementary and secondary instructional,0,0,0,0,0,0,0,2001
MO,education - elementary and secondary total,0,0,0,0,0,0,0,2001
MO,education - higher education instructional,8062,36676234,7432,6620631,485443,10805,43296865,2001
MO,education - higher education other,13230,37041508,11917,5265017,697699,17180,42306525,2001
MO,education - other,2080,5183911,442,502241,19917,2192,5686152,2001
MO,libraries,0,0,0,0,0,0,0,2001
MO,liquor stores,0,0,0,0,0,0,0,2001
MO,other and unallocable,4873,13898611,364,244648,20453,4989,14143259,2001
MT,total,16384,47943233,8020,6416284,531818,19389,54359517,2001
MT,financial administration,865,2199870,88,96504,8733,915,2296374,2001
MT,other government administration,349,1032815,307,425867,29237,514,1458682,2001
MT,judicial and legal,169,725056,74,150157,5739,201,875213,2001
MT,police protection - officers,188,570129,4,6155,396,190,576284,2001
MT,police protection - other,198,599385,42,27053,2801,214,626438,2001
MT,corrections,1083,2764330,47,51391,4060,1106,2815721,2001
MT,streets and highways,1976,5942084,188,208446,18254,2079,6150530,2001
MT,air transportation,0,0,0,0,0,0,0,2001
MT,water transport and terminals,0,0,0,0,0,0,0,2001
MT,public welfare,1414,3734619,221,290544,24164,1551,4025163,2001
MT,health,783,2014091,126,154776,13323,858,2168867,2001
MT,hospitals,537,1293078,102,119921,12106,605,1412999,2001
MT,social insurance administration,653,1841764,43,55137,4710,679,1896901,2001
MT,solid waste management,0,0,0,0,0,0,0,2001
MT,sewerage,0,0,0,0,0,0,0,2001
MT,parks and recreation,57,161485,20,12657,1167,64,174142,2001
MT,housing and community development,0,0,0,0,0,0,0,2001
MT,natural resources,1264,3716470,261,247378,21882,1389,3963848,2001
MT,water transport and terminals,0,0,0,0,0,0,0,2001
MT,electric power,0,0,0,0,0,0,0,2001
MT,gas supply,0,0,0,0,0,0,0,2001
MT,transit,0,0,0,0,0,0,0,2001
MT,education - elementary and secondary instructional,0,0,0,0,0,0,0,2001
MT,education - elementary and secondary total,0,0,0,0,0,0,0,2001
MT,education - higher education instructional,1547,7867834,1339,1785587,86538,2035,9653421,2001
MT,education - higher education other,3640,8738933,4765,2385409,266260,5145,11124342,2001
MT,education - other,563,1557107,284,251823,20774,681,1808930,2001
MT,libraries,0,0,0,0,0,0,0,2001
MT,liquor stores,77,192937,4,4189,392,79,197126,2001
MT,other and unallocable,1021,2991246,105,143290,11282,1084,3134536,2001
NE,total,27550,81007684,10974,7980010,913187,32707,88987694,2001
NE,financial administration,573,1616989,17,19117,1843,583,1636106,2001
NE,other government administration,286,859248,114,101740,8295,333,960988,2001
NE,judicial and legal,646,2393928,71,55766,5207,675,2449694,2001
NE,police protection - officers,474,1573719,0,0,0,474,1573719,2001
NE,police protection - other,209,534699,7,7812,696,213,542511,2001
NE,corrections,1976,4981142,64,64216,6227,2011,5045358,2001
NE,streets and highways,2216,6431863,11,16749,1169,2223,6448612,2001
NE,air transportation,27,84324,0,0,0,27,84324,2001
NE,water transport and terminals,0,0,0,0,0,0,0,2001
NE,public welfare,2730,6213188,127,41938,9296,2783,6255126,2001
NE,health,742,2128227,89,132016,11276,806,2260243,2001
NE,hospitals,4170,10745859,1044,1681692,148878,5011,12427551,2001
NE,social insurance administration,248,726524,12,17960,1395,256,744484,2001
NE,solid waste management,0,0,0,0,0,0,0,2001
NE,sewerage,0,0,0,0,0,0,0,2001
NE,parks and recreation,231,592286,178,114229,18102,333,706515,2001
NE,housing and community development,0,0,0,0,0,0,0,2001
NE,natural resources,1560,4197388,759,572576,76948,1994,4769964,2001
NE,water transport and terminals,0,0,0,0,0,0,0,2001
NE,electric power,0,0,0,0,0,0,0,2001
NE,gas supply,0,0,0,0,0,0,0,2001
NE,transit,0,0,0,0,0,0,0,2001
NE,education - elementary and secondary instructional,0,0,0,0,0,0,0,2001
NE,education - elementary and secondary total,0,0,0,0,0,0,0,2001
NE,education - higher education instructional,2791,13399327,1182,1364171,85032,3272,14763498,2001
NE,education - higher education other,5921,16229361,6864,3509543,517944,8847,19738904,2001
NE,education - other,538,1711234,28,23052,2015,549,1734286,2001
NE,libraries,0,0,0,0,0,0,0,2001
NE,liquor stores,0,0,0,0,0,0,0,2001
NE,other and unallocable,2212,6588378,407,257433,18864,2317,6845811,2001
NV,total,20142,71564297,6352,6839745,534370,23156,78404042,2001
NV,financial administration,1113,3356305,46,50902,2198,1126,3407207,2001
NV,other government administration,1192,4290800,33,35108,2726,1207,4325908,2001
NV,judicial and legal,625,2872864,21,30122,718,628,2902986,2001
NV,police protection - officers,379,1836763,0,0,0,379,1836763,2001
NV,police protection - other,366,1428118,0,0,0,366,1428118,2001
NV,corrections,3142,11016658,68,142846,4422,3167,11159504,2001
NV,streets and highways,1638,5598150,6,3354,414,1640,5601504,2001
NV,air transportation,0,0,0,0,0,0,0,2001
NV,water transport and terminals,0,0,0,0,0,0,0,2001
NV,public welfare,1057,3262276,16,19951,802,1062,3282227,2001
NV,health,1004,3511881,57,97869,3443,1023,3609750,2001
NV,hospitals,983,3481296,141,255518,10922,1045,3736814,2001
NV,social insurance administration,439,1348244,3,5535,306,441,1353779,2001
NV,solid waste management,0,0,0,0,0,0,0,2001
NV,sewerage,0,0,0,0,0,0,0,2001
NV,parks and recreation,181,607413,10,14276,686,185,621689,2001
NV,housing and community development,0,0,0,0,0,0,0,2001
NV,natural resources,1077,3570407,385,339591,18365,1180,3909998,2001
NV,water transport and terminals,13,58684,0,0,0,13,58684,2001
NV,electric power,14,58684,1,1096,55,14,59780,2001
NV,gas supply,0,0,0,0,0,0,0,2001
NV,transit,0,0,0,0,0,0,0,2001
NV,education - elementary and secondary instructional,0,0,0,0,0,0,0,2001
NV,education - elementary and secondary total,0,0,0,0,0,0,0,2001
NV,education - higher education instructional,1718,9475870,2095,2867477,152727,2581,12343347,2001
NV,education - higher education other,2944,7815325,3389,2889463,332489,4823,10704788,2001
NV,education - other,120,464353,15,27896,1078,126,492249,2001
NV,libraries,0,0,0,0,0,0,0,2001
NV,liquor stores,0,0,0,0,0,0,0,2001
NV,other and unallocable,2137,7510206,66,58741,3019,2150,7568947,2001
NH,total,15906,51294677,8875,6841161,500817,18920,58135838,2001
NH,financial administration,470,1310875,37,29746,3956,494,1340621,2001
NH,other government administration,286,874789,74,88821,6180,323,963610,2001
NH,judicial and legal,913,3101918,1,478,120,914,3102396,2001
NH,police protection - officers,307,1215798,0,0,0,307,1215798,2001
NH,police protection - other,120,343726,10,7740,903,125,351466,2001
NH,corrections,1274,3894732,70,96145,6844,1316,3990877,2001
NH,streets and highways,1794,5668672,271,247140,22200,1928,5915812,2001
NH,air transportation,0,0,0,0,0,0,0,2001
NH,water transport and terminals,5,16007,3,2743,246,6,18750,2001
NH,public welfare,1421,3925136,82,95063,6510,1460,4020199,2001
NH,health,891,2851956,84,86432,7008,932,2938388,2001
NH,hospitals,738,2037263,72,118637,1353,746,2155900,2001
NH,social insurance administration,333,903099,39,46571,3000,351,949670,2001
NH,solid waste management,0,0,0,0,0,0,0,2001
NH,sewerage,0,0,0,0,0,0,0,2001
NH,parks and recreation,73,185434,223,130586,18016,181,316020,2001
NH,housing and community development,0,0,0,0,0,0,0,2001
NH,natural resources,498,1451196,206,141871,13097,577,1593067,2001
NH,water transport and terminals,0,0,0,0,0,0,0,2001
NH,electric power,0,0,0,0,0,0,0,2001
NH,gas supply,0,0,0,0,0,0,0,2001
NH,transit,0,0,0,0,0,0,0,2001
NH,education - elementary and secondary instructional,0,0,0,0,0,0,0,2001
NH,education - elementary and secondary total,0,0,0,0,0,0,0,2001
NH,education - higher education instructional,1423,6189037,1640,2086901,77509,1890,8275938,2001
NH,education - higher education other,3042,10487206,5377,3213614,279931,4728,13700820,2001
NH,education - other,306,871233,17,21135,1580,315,892368,2001
NH,libraries,0,0,0,0,0,0,0,2001
NH,liquor stores,293,802761,383,229700,31390,482,1032461,2001
NH,other and unallocable,1719,5163839,286,197838,20974,1845,5361677,2001
NJ,total,128165,542888448,25543,22219461,1399102,136892,565107909,2001
NJ,financial administration,4929,19040122,465,787170,60690,5321,19827292,2001
NJ,other government administration,1343,6271862,61,70684,5449,1379,6342546,2001
NJ,judicial and legal,13960,56736672,179,202997,15514,14060,56939669,2001
NJ,police protection - officers,1350,4147234,34,60307,4649,1380,4207541,2001
NJ,police protection - other,2530,15765281,0,0,0,2530,15765281,2001
NJ,corrections,9818,40693657,31,33128,2555,9834,40726785,2001
NJ,streets and highways,7188,29701731,693,575744,73307,7602,30277475,2001
NJ,air transportation,0,0,0,0,0,0,0,2001
NJ,water transport and terminals,121,470612,11,16755,1493,129,487367,2001
NJ,public welfare,6145,23123441,169,270447,20854,6279,23393888,2001
NJ,health,2742,11973530,65,138001,10640,2811,12111531,2001
NJ,hospitals,14791,49419692,1135,1258316,92660,15380,50678008,2001
NJ,social insurance administration,1401,5300077,264,521988,37284,1642,5822065,2001
NJ,solid waste management,649,3175987,2,2903,224,650,3178890,2001
NJ,sewerage,0,0,0,0,0,0,0,2001
NJ,parks and recreation,1710,6687631,1070,1021296,19089,1824,7708927,2001
NJ,housing and community development,0,0,0,0,0,0,0,2001
NJ,natural resources,2666,11303618,571,781794,26594,2828,12085412,2001
NJ,water transport and terminals,117,386928,2,1014,71,117,387942,2001
NJ,electric power,0,0,0,0,0,0,0,2001
NJ,gas supply,0,0,0,0,0,0,0,2001
NJ,transit,9631,38807731,749,751628,55761,9946,39559359,2001
NJ,education - elementary and secondary instructional,9205,47437728,479,452942,16776,9331,47890670,2001
NJ,education - elementary and secondary total,3609,9873583,941,738590,67116,4061,10612173,2001
NJ,education - higher education instructional,7095,50762030,5361,6318603,231920,8537,57080633,2001
NJ,education - higher education other,16990,67123275,12277,7135063,572387,20535,74258338,2001
NJ,education - other,3538,15429222,629,647743,52402,3876,16076965,2001
NJ,libraries,0,0,0,0,0,0,0,2001
NJ,liquor stores,0,0,0,0,0,0,0,2001
NJ,other and unallocable,6637,29256804,355,432348,31667,6840,29689152,2001
NM,total,41559,116384366,15409,15337052,1111456,47839,131721418,2001
NM,financial administration,1887,5163678,12,22900,1442,1895,5186578,2001
NM,other government administration,201,682351,442,1697080,68210,587,2379431,2001
NM,judicial and legal,2681,8359615,124,148868,11277,2746,8508483,2001
NM,police protection - officers,462,1641671,0,0,0,462,1641671,2001
NM,police protection - other,171,610993,0,0,0,171,610993,2001
NM,corrections,3821,10147526,41,72298,5086,3850,10219824,2001
NM,streets and highways,2436,6335016,0,0,0,2436,6335016,2001
NM,air transportation,7,24124,0,0,0,7,24124,2001
NM,water transport and terminals,0,0,0,0,0,0,0,2001
NM,public welfare,1421,3401714,6,11387,505,1424,3413101,2001
NM,health,2501,7011576,202,222729,11856,2568,7234305,2001
NM,hospitals,6257,16316202,2076,4474868,306366,7988,20791070,2001
NM,social insurance administration,547,1320279,16,19208,1499,555,1339487,2001
NM,solid waste management,0,0,0,0,0,0,0,2001
NM,sewerage,0,0,0,0,0,0,0,2001
NM,parks and recreation,698,1695549,55,116835,6956,737,1812384,2001
NM,housing and community development,0,0,0,0,0,0,0,2001
NM,natural resources,1683,4907481,138,123276,12668,1756,5030757,2001
NM,water transport and terminals,0,0,0,0,0,0,0,2001
NM,electric power,0,0,0,0,0,0,0,2001
NM,gas supply,0,0,0,0,0,0,0,2001
NM,transit,0,0,0,0,0,0,0,2001
NM,education - elementary and secondary instructional,0,0,0,0,0,0,0,2001
NM,education - elementary and secondary total,0,0,0,0,0,0,0,2001
NM,education - higher education instructional,4029,13870970,3315,3523587,194834,5129,17394557,2001
NM,education - higher education other,10367,27974152,8728,4719298,474934,13048,32693450,2001
NM,education - other,848,2425955,78,86632,7863,893,2512587,2001
NM,libraries,0,0,0,0,0,0,0,2001
NM,liquor stores,0,0,0,0,0,0,0,2001
NM,other and unallocable,1542,4495514,176,98086,7960,1587,4593600,2001
NY,total,234923,960361750,46134,49186068,2924168,252099,1009547818,2001
NY,financial administration,13432,47457799,418,928176,41907,13678,48385975,2001
NY,other government administration,4763,16821134,925,788907,71541,5169,17610041,2001
NY,judicial and legal,18643,92788564,524,1243059,61239,18989,94031623,2001
NY,police protection - officers,4201,23177518,0,0,0,4201,23177518,2001
NY,police protection - other,1649,5273730,174,222018,22357,1775,5495748,2001
NY,corrections,36257,140898368,466,994358,45982,36519,141892726,2001
NY,streets and highways,12944,48817713,1006,970200,85521,13427,49787913,2001
NY,air transportation,127,482552,17,25377,2329,140,507929,2001
NY,water transport and terminals,814,3531452,24,43964,2026,825,3575416,2001
NY,public welfare,6555,23335321,464,727021,45718,6815,24062342,2001
NY,health,9451,40300939,384,951875,43880,9700,41252814,2001
NY,hospitals,44573,161002154,5275,10277342,484351,47334,171279496,2001
NY,social insurance administration,8373,30178958,111,235888,14754,8458,30414846,2001
NY,solid waste management,0,0,0,0,0,0,0,2001
NY,sewerage,0,0,0,0,0,0,0,2001
NY,parks and recreation,1910,6402271,1104,1553409,169977,2870,7955680,2001
NY,housing and community development,0,0,0,0,0,0,0,2001
NY,natural resources,3439,13143638,62,111917,6576,3477,13255555,2001
NY,water transport and terminals,0,0,0,0,0,0,0,2001
NY,electric power,1529,10257174,78,175282,12088,1597,10432456,2001
NY,gas supply,0,0,0,0,0,0,0,2001
NY,transit,14730,78194873,461,582913,56133,15047,78777786,2001
NY,education - elementary and secondary instructional,0,0,0,0,0,0,0,2001
NY,education - elementary and secondary total,0,0,0,0,0,0,0,2001
NY,education - higher education instructional,12427,70700279,14767,16373862,785354,17132,87074141,2001
NY,education - higher education other,22793,82231206,19028,11330067,897083,28194,93561273,2001
NY,education - other,4628,17753737,251,434834,22669,4757,18188571,2001
NY,libraries,0,0,0,0,0,0,0,2001
NY,liquor stores,0,0,0,0,0,0,0,2001
NY,other and unallocable,11685,47612370,595,1215599,52683,11995,48827969,2001
NC,total,117667,362053740,30599,27413978,2128070,129691,389467718,2001
NC,financial administration,3720,9295199,3,4734,463,3723,9299933,2001
NC,other government administration,999,3055428,254,410508,27328,1153,3465936,2001
NC,judicial and legal,5754,20990464,240,187299,8797,5804,21177763,2001
NC,police protection - officers,2310,8931620,0,0,0,2310,8931620,2001
NC,police protection - other,1033,3082174,4,6323,473,1036,3088497,2001
NC,corrections,19819,51567026,674,1456480,104150,20408,53023506,2001
NC,streets and highways,11873,28185598,3,4731,321,11875,28190329,2001
NC,air transportation,0,0,0,0,0,0,0,2001
NC,water transport and terminals,290,994866,5,5210,426,292,1000076,2001
NC,public welfare,1943,6373220,9,2546,146,1944,6375766,2001
NC,health,2526,9653200,219,271174,25780,2671,9924374,2001
NC,hospitals,17062,49501655,985,1775343,96886,17609,51276998,2001
NC,social insurance administration,2454,7554438,140,168104,12469,2524,7722542,2001
NC,solid waste management,249,844653,7,11480,667,253,856133,2001
NC,sewerage,0,0,0,0,0,0,0,2001
NC,parks and recreation,882,2212218,100,71658,8279,928,2283876,2001
NC,housing and community development,0,0,0,0,0,0,0,2001
NC,natural resources,3338,9973547,1247,1385066,101274,3910,11358613,2001
NC,water transport and terminals,0,0,0,0,0,0,0,2001
NC,electric power,0,0,0,0,0,0,0,2001
NC,gas supply,0,0,0,0,0,0,0,2001
NC,transit,0,0,0,0,0,0,0,2001
NC,education - elementary and secondary instructional,0,0,0,0,0,0,0,2001
NC,education - elementary and secondary total,0,0,0,0,0,0,0,2001
NC,education - higher education instructional,12068,57327487,10108,12351364,780923,16482,69678851,2001
NC,education - higher education other,23306,66304423,16281,8934742,936287,28594,75239165,2001
NC,education - other,3341,10595239,165,208594,11545,3407,10803833,2001
NC,libraries,0,0,0,0,0,0,0,2001
NC,liquor stores,0,0,0,0,0,0,0,2001
NC,other and unallocable,4700,15611285,155,158622,11856,4768,15769907,2001
ND,total,13224,38014329,7633,5469498,473802,15898,43483827,2001
ND,financial administration,605,1533910,72,48012,6605,642,1581922,2001
ND,other government administration,177,469413,241,645018,24122,313,1114431,2001
ND,judicial and legal,392,1394385,32,7879,974,398,1402264,2001
ND,police protection - officers,130,404118,0,0,0,130,404118,2001
ND,police protection - other,94,225559,2,1403,179,95,226962,2001
ND,corrections,563,1352679,37,18095,2186,575,1370774,2001
ND,streets and highways,906,2473469,35,42076,3801,927,2515545,2001
ND,air transportation,0,0,0,0,0,0,0,2001
ND,water transport and terminals,0,0,0,0,0,0,0,2001
ND,public welfare,425,999460,52,36457,1650,433,1035917,2001
ND,health,1151,2968774,221,212862,5605,1183,3181636,2001
ND,hospitals,1019,2103941,180,46497,4982,1047,2150438,2001
ND,social insurance administration,394,1029164,44,39996,3489,414,1069160,2001
ND,solid waste management,0,0,0,0,0,0,0,2001
ND,sewerage,0,0,0,0,0,0,0,2001
ND,parks and recreation,95,224940,27,22038,2437,109,246978,2001
ND,housing and community development,0,0,0,0,0,0,0,2001
ND,natural resources,972,3054146,612,485319,80547,1426,3539465,2001
ND,water transport and terminals,0,0,0,0,0,0,0,2001
ND,electric power,0,0,0,0,0,0,0,2001
ND,gas supply,0,0,0,0,0,0,0,2001
ND,transit,0,0,0,0,0,0,0,2001
ND,education - elementary and secondary instructional,0,0,0,0,0,0,0,2001
ND,education - elementary and secondary total,0,0,0,0,0,0,0,2001
ND,education - higher education instructional,1816,8142406,1862,2560995,158993,2715,10703401,2001
ND,education - higher education other,3036,7514839,4026,1172053,166988,3980,8686892,2001
ND,education - other,336,877275,43,25740,1784,346,903015,2001
ND,libraries,0,0,0,0,0,0,0,2001
ND,liquor stores,0,0,0,0,0,0,0,2001
ND,other and unallocable,1113,3245851,147,105058,9460,1165,3350909,2001
OH,total,114282,397357854,63541,60037481,4434023,139368,457395335,2001
OH,financial administration,8051,31729663,577,783103,55968,8368,32512766,2001
OH,other government administration,790,2872251,156,106088,10149,848,2978339,2001
OH,judicial and legal,2508,10510493,476,1045956,56457,2827,11556449,2001
OH,police protection - officers,1453,6058320,0,0,0,1453,6058320,2001
OH,police protection - other,1240,3467757,12,22329,1386,1248,3490086,2001
OH,corrections,18554,62232179,93,202774,12038,18622,62434953,2001
OH,streets and highways,6746,24874173,445,539177,41492,6980,25413350,2001
OH,air transportation,0,0,0,0,0,0,0,2001
OH,water transport and terminals,0,0,0,0,0,0,0,2001
OH,public welfare,1965,8043422,260,317441,29668,2133,8360863,2001
OH,health,3508,14750347,306,306646,26943,3660,15056993,2001
OH,hospitals,9906,26763643,3141,6404058,352860,11899,33167701,2001
OH,social insurance administration,2823,10377888,216,373307,27314,2978,10751195,2001
OH,solid waste management,0,0,0,0,0,0,0,2001
OH,sewerage,0,0,0,0,0,0,0,2001
OH,parks and recreation,621,2083416,273,329939,28215,780,2413355,2001
OH,housing and community development,0,0,0,0,0,0,0,2001
OH,natural resources,3368,10660861,874,1244357,90537,3879,11905218,2001
OH,water transport and terminals,0,0,0,0,0,0,0,2001
OH,electric power,0,0,0,0,0,0,0,2001
OH,gas supply,0,0,0,0,0,0,0,2001
OH,transit,0,0,0,0,0,0,0,2001
OH,education - elementary and secondary instructional,0,0,0,0,0,0,0,2001
OH,education - elementary and secondary total,0,0,0,0,0,0,0,2001
OH,education - higher education instructional,15494,79178085,20327,26349509,1293004,22820,105527594,2001
OH,education - higher education other,30194,75274646,35861,21313155,2366661,43578,96587801,2001
OH,education - other,2321,9271616,169,265319,12261,2390,9536935,2001
OH,libraries,0,0,0,0,0,0,0,2001
OH,liquor stores,0,0,0,0,0,0,0,2001
OH,other and unallocable,4740,19209094,355,434323,29070,4905,19643417,2001
OK,total,56523,165335459,24542,17559552,1437531,64704,182895011,2001
OK,financial administration,1753,5376748,94,103995,6788,1790,5480743,2001
OK,other government administration,849,2788716,192,267280,21500,970,3055996,2001
OK,judicial and legal,2488,9221147,221,267330,18187,2590,9488477,2001
OK,police protection - officers,1006,3626222,0,0,0,1006,3626222,2001
OK,police protection - other,788,2062786,59,48382,4339,813,2111168,2001
OK,corrections,5823,14924337,297,326106,21665,5946,15250443,2001
OK,streets and highways,2852,7753098,78,78510,5051,2881,7831608,2001
OK,air transportation,0,0,0,0,0,0,0,2001
OK,water transport and terminals,0,0,0,0,0,0,0,2001
OK,public welfare,6006,13994294,781,705510,66796,6383,14699804,2001
OK,health,3813,11204629,332,456182,35047,4011,11660811,2001
OK,hospitals,2402,7007790,249,259338,25204,2544,7267128,2001
OK,social insurance administration,1198,3498933,165,173990,14338,1279,3672923,2001
OK,solid waste management,72,202295,7,5976,629,76,208271,2001
OK,sewerage,0,0,0,0,0,0,0,2001
OK,parks and recreation,857,1984381,432,308296,41779,1093,2292677,2001
OK,housing and community development,0,0,0,0,0,0,0,2001
OK,natural resources,1805,4735746,943,715908,62928,2161,5451654,2001
OK,water transport and terminals,0,0,0,0,0,0,0,2001
OK,electric power,485,1935452,0,0,0,485,1935452,2001
OK,gas supply,0,0,0,0,0,0,0,2001
OK,transit,0,0,0,0,0,0,0,2001
OK,education - elementary and secondary instructional,0,0,0,0,0,0,0,2001
OK,education - elementary and secondary total,0,0,0,0,0,0,0,2001
OK,education - higher education instructional,6041,28026863,5225,6429974,337726,7964,34456837,2001
OK,education - higher education other,13801,33587431,15159,7045805,750010,18083,40633236,2001
OK,education - other,2047,5916910,143,132787,9919,2103,6049697,2001
OK,libraries,0,0,0,0,0,0,0,2001
OK,liquor stores,0,0,0,0,0,0,0,2001
OK,other and unallocable,2437,7487681,165,234183,15625,2526,7721864,2001
OR,total,46031,154942043,20409,18900058,1441252,54173,173842101,2001
OR,financial administration,3731,12822975,411,572614,45235,3987,13395589,2001
OR,other government administration,1344,4025594,230,372386,23990,1480,4397980,2001
OR,judicial and legal,2736,9525367,541,1321434,84189,3212,10846801,2001
OR,police protection - officers,843,3355253,56,169441,9617,897,3524694,2001
OR,police protection - other,489,1521121,136,154349,8074,535,1675470,2001
OR,corrections,4657,15670783,236,395824,35321,4856,16066607,2001
OR,streets and highways,3297,11025803,287,553006,38856,3517,11578809,2001
OR,air transportation,17,61145,0,0,0,17,61145,2001
OR,water transport and terminals,0,0,0,0,0,0,0,2001
OR,public welfare,5931,17696588,249,686348,30444,6102,18382936,2001
OR,health,2327,7740554,248,505287,26054,2474,8245841,2001
OR,hospitals,3194,8914820,1965,4113432,327377,5044,13028252,2001
OR,social insurance administration,2041,7828859,237,391785,28650,2202,8220644,2001
OR,solid waste management,0,0,0,0,0,0,0,2001
OR,sewerage,0,0,0,0,0,0,0,2001
OR,parks and recreation,389,1142614,32,72372,5632,421,1214986,2001
OR,housing and community development,0,0,0,0,0,0,0,2001
OR,natural resources,2605,9170850,541,492125,44904,2859,9662975,2001
OR,water transport and terminals,0,0,0,0,0,0,0,2001
OR,electric power,0,0,0,0,0,0,0,2001
OR,gas supply,0,0,0,0,0,0,0,2001
OR,transit,0,0,0,0,0,0,0,2001
OR,education - elementary and secondary instructional,0,0,0,0,0,0,0,2001
OR,education - elementary and secondary total,0,0,0,0,0,0,0,2001
OR,education - higher education instructional,4998,21140738,7018,4955894,343803,6940,26096632,2001
OR,education - higher education other,4810,14283841,7933,3761952,364853,6871,18045793,2001
OR,education - other,961,3218176,139,226353,14591,1044,3444529,2001
OR,libraries,0,0,0,0,0,0,0,2001
OR,liquor stores,162,559153,1,1260,100,163,560413,2001
OR,other and unallocable,1499,5237809,149,154196,9562,1552,5392005,2001
PA,total,135966,487601705,50080,50353314,3031707,153818,537955019,2001
PA,financial administration,6965,24448677,685,1017085,100008,7567,25465762,2001
PA,other government administration,3023,9405369,1241,2080265,111859,3686,11485634,2001
PA,judicial and legal,2840,14552331,10,28454,1007,2846,14580785,2001
PA,police protection - officers,4483,18977821,0,0,0,4483,18977821,2001
PA,police protection - other,1171,4960790,58,116580,9150,1226,5077370,2001
PA,corrections,15572,50812626,315,628690,40653,15817,51441316,2001
PA,streets and highways,12856,41351754,844,1627388,115940,13550,42979142,2001
PA,air transportation,36,136606,0,0,0,36,136606,2001
PA,water transport and terminals,82,372481,0,0,0,82,372481,2001
PA,public welfare,11977,40655733,372,872043,54668,12307,41527776,2001
PA,health,1447,5437306,13,17283,1191,1455,5454589,2001
PA,hospitals,13229,36666026,983,1275566,66842,13624,37941592,2001
PA,social insurance administration,3634,12871412,297,637147,42476,3890,13508559,2001
PA,solid waste management,0,0,0,0,0,0,0,2001
PA,sewerage,0,0,0,0,0,0,0,2001
PA,parks and recreation,898,3018118,679,1339641,96662,1480,4357759,2001
PA,housing and community development,0,0,0,0,0,0,0,2001
PA,natural resources,6401,23402875,1392,2327994,117204,7096,25730869,2001
PA,water transport and terminals,0,0,0,0,0,0,0,2001
PA,electric power,0,0,0,0,0,0,0,2001
PA,gas supply,0,0,0,0,0,0,0,2001
PA,transit,0,0,0,0,0,0,0,2001
PA,education - elementary and secondary instructional,0,0,0,0,0,0,0,2001
PA,education - elementary and secondary total,0,0,0,0,0,0,0,2001
PA,education - higher education instructional,12991,82102009,10162,20181063,763012,17386,102283072,2001
PA,education - higher education other,27487,79952916,31571,16862422,1389778,35681,96815338,2001
PA,education - other,3300,13272233,211,370171,26988,3462,13642404,2001
PA,libraries,0,0,0,0,0,0,0,2001
PA,liquor stores,2727,7496766,894,401544,45588,3002,7898310,2001
PA,other and unallocable,4847,17707856,353,569978,48681,5142,18277834,2001
RI,total,18144,69342784,6295,4952101,331548,20145,74294885,2001
RI,financial administration,861,3012896,8,10753,542,864,3023649,2001
RI,other government administration,680,2094746,202,21652,1144,687,2116398,2001
RI,judicial and legal,1127,4319810,40,59899,2726,1145,4379709,2001
RI,police protection - officers,218,1118327,0,0,0,218,1118327,2001
RI,police protection - other,81,333418,13,18881,973,87,352299,2001
RI,corrections,1847,7570713,21,36550,830,1852,7607263,2001
RI,streets and highways,872,2879544,10,11776,699,876,2891320,2001
RI,air transportation,144,567515,1,1607,100,145,569122,2001
RI,water transport and terminals,0,0,0,0,0,0,0,2001
RI,public welfare,1571,7104564,46,140891,5913,1609,7245455,2001
RI,health,1400,5630959,54,35683,1051,1406,5666642,2001
RI,hospitals,1188,4687377,15,46633,2234,1201,4734010,2001
RI,social insurance administration,505,1723048,36,67208,5245,539,1790256,2001
RI,solid waste management,111,491260,0,0,0,111,491260,2001
RI,sewerage,231,781588,3,8128,332,233,789716,2001
RI,parks and recreation,77,206586,0,0,0,77,206586,2001
RI,housing and community development,0,0,0,0,0,0,0,2001
RI,natural resources,551,2085652,28,32088,2531,565,2117740,2001
RI,water transport and terminals,0,0,0,0,0,0,0,2001
RI,electric power,0,0,0,0,0,0,0,2001
RI,gas supply,0,0,0,0,0,0,0,2001
RI,transit,676,2101472,30,83407,4456,701,2184879,2001
RI,education - elementary and secondary instructional,407,1684079,41,26010,2621,425,1710089,2001
RI,education - elementary and secondary total,75,211267,62,52226,4627,108,263493,2001
RI,education - higher education instructional,1729,7613069,2438,2609886,128555,2513,10222955,2001
RI,education - higher education other,2169,6679469,3064,1389557,149365,3044,8069026,2001
RI,education - other,536,2369620,112,231095,13727,625,2600715,2001
RI,libraries,0,0,0,0,0,0,0,2001
RI,liquor stores,0,0,0,0,0,0,0,2001
RI,other and unallocable,1088,4075805,71,68171,3877,1114,4143976,2001
SC,total,73670,211577378,21340,15708198,1265884,81219,227285576,2001
SC,financial administration,2192,7156944,27,47812,1388,2200,7204756,2001
SC,other government administration,512,1610150,529,412403,35869,728,2022553,2001
SC,judicial and legal,698,2846202,7,4538,416,700,2850740,2001
SC,police protection - officers,1519,4800632,0,0,0,1519,4800632,2001
SC,police protection - other,1829,4269556,11,13690,568,1832,4283246,2001
SC,corrections,9104,21748444,7,9526,378,9106,21757970,2001
SC,streets and highways,4888,12279172,10,11058,510,4891,12290230,2001
SC,air transportation,0,0,0,0,0,0,0,2001
SC,water transport and terminals,588,2464279,11,11716,930,593,2475995,2001
SC,public welfare,5103,12482104,15,20290,770,5108,12502394,2001
SC,health,7651,20679257,189,401209,10608,7715,21080466,2001
SC,hospitals,8524,17704793,226,462294,27603,8681,18167087,2001
SC,social insurance administration,1294,3546982,5,7634,74,1294,3554616,2001
SC,solid waste management,0,0,0,0,0,0,0,2001
SC,sewerage,0,0,0,0,0,0,0,2001
SC,parks and recreation,653,1568472,7,3229,425,655,1571701,2001
SC,housing and community development,0,0,0,0,0,0,0,2001
SC,natural resources,2184,6307738,169,146301,14898,2274,6454039,2001
SC,water transport and terminals,0,0,0,0,0,0,0,2001
SC,electric power,1652,7052236,20,55536,2387,1665,7107772,2001
SC,gas supply,0,0,0,0,0,0,0,2001
SC,transit,0,0,0,0,0,0,0,2001
SC,education - elementary and secondary instructional,0,0,0,0,0,0,0,2001
SC,education - elementary and secondary total,0,0,0,0,0,0,0,2001
SC,education - higher education instructional,8396,40626882,8705,8014069,488696,11330,48640951,2001
SC,education - higher education other,12601,31530237,11359,6023793,678612,16637,37554030,2001
SC,education - other,2816,8161482,26,37098,848,2820,8198580,2001
SC,libraries,0,0,0,0,0,0,0,2001
SC,liquor stores,0,0,0,0,0,0,0,2001
SC,other and unallocable,1466,4741816,17,26002,904,1471,4767818,2001
SD,total,11273,32806483,5744,3050183,354017,13269,35856666,2001
SD,financial administration,319,923557,16,19722,1596,328,943279,2001
SD,other government administration,293,860502,20,26690,2358,306,887192,2001
SD,judicial and legal,482,1566536,89,77576,6618,519,1644112,2001
SD,police protection - officers,178,651460,0,0,0,178,651460,2001
SD,police protection - other,101,246172,7,7129,493,103,253301,2001
SD,corrections,831,2045803,63,77072,6762,869,2122875,2001
SD,streets and highways,953,2648929,121,106668,10468,1012,2755597,2001
SD,air transportation,0,0,0,0,0,0,0,2001
SD,water transport and terminals,0,0,0,0,0,0,0,2001
SD,public welfare,939,2211662,90,104859,10782,999,2316521,2001
SD,health,498,1400709,81,84927,6792,536,1485636,2001
SD,hospitals,910,1973279,288,199238,23820,1045,2172517,2001
SD,social insurance administration,275,641407,12,14657,1264,282,656064,2001
SD,solid waste management,0,0,0,0,0,0,0,2001
SD,sewerage,0,0,0,0,0,0,0,2001
SD,parks and recreation,118,297353,25,21234,2451,132,318587,2001
SD,housing and community development,0,0,0,0,0,0,0,2001
SD,natural resources,720,2000815,323,129516,16645,814,2130331,2001
SD,water transport and terminals,0,0,0,0,0,0,0,2001
SD,electric power,0,0,0,0,0,0,0,2001
SD,gas supply,0,0,0,0,0,0,0,2001
SD,transit,0,0,0,0,0,0,0,2001
SD,education - elementary and secondary instructional,0,0,0,0,0,0,0,2001
SD,education - elementary and secondary total,0,0,0,0,0,0,0,2001
SD,education - higher education instructional,1261,6859969,946,906036,75356,1686,7766005,2001
SD,education - higher education other,2160,5099577,3356,1130597,171825,3131,6230174,2001
SD,education - other,367,929033,204,65862,8871,417,994895,2001
SD,libraries,0,0,0,0,0,0,0,2001
SD,liquor stores,0,0,0,0,0,0,0,2001
SD,other and unallocable,868,2449720,103,78400,7916,912,2528120,2001
TN,total,70878,207148872,25612,25444100,2020782,82681,232592972,2001
TN,financial administration,2635,8285848,51,58390,4996,2664,8344238,2001
TN,other government administration,693,2163224,78,92122,6224,730,2255346,2001
TN,judicial and legal,1985,7917808,37,35058,988,1991,7952866,2001
TN,police protection - officers,1150,3519836,0,0,0,1150,3519836,2001
TN,police protection - other,768,1825554,6,3296,472,771,1828850,2001
TN,corrections,6562,15709390,69,114212,6402,6601,15823602,2001
TN,streets and highways,4535,10683972,0,0,0,4535,10683972,2001
TN,air transportation,0,0,0,0,0,0,0,2001
TN,water transport and terminals,0,0,0,0,0,0,0,2001
TN,public welfare,5142,13199494,7,10208,456,5145,13209702,2001
TN,health,2936,8209079,136,168096,10712,2997,8377175,2001
TN,hospitals,9056,26907798,375,950767,58893,9391,27858565,2001
TN,social insurance administration,1357,3660278,134,182250,15388,1450,3842528,2001
TN,solid waste management,0,0,0,0,0,0,0,2001
TN,sewerage,0,0,0,0,0,0,0,2001
TN,parks and recreation,1059,1934332,120,80458,12926,1137,2014790,2001
TN,housing and community development,0,0,0,0,0,0,0,2001
TN,natural resources,2959,8009939,661,699810,75788,3397,8709749,2001
TN,water transport and terminals,0,0,0,0,0,0,0,2001
TN,electric power,0,0,0,0,0,0,0,2001
TN,gas supply,0,0,0,0,0,0,0,2001
TN,transit,0,0,0,0,0,0,0,2001
TN,education - elementary and secondary instructional,0,0,0,0,0,0,0,2001
TN,education - elementary and secondary total,0,0,0,0,0,0,0,2001
TN,education - higher education instructional,8806,42679674,7474,10038245,527873,11913,52717919,2001
TN,education - higher education other,16350,39049828,16206,12842016,1285612,23841,51891844,2001
TN,education - other,2109,5799922,177,107010,9366,2165,5906932,2001
TN,libraries,0,0,0,0,0,0,0,2001
TN,liquor stores,0,0,0,0,0,0,0,2001
TN,other and unallocable,2776,7592896,81,62162,4686,2803,7655058,2001
TX,total,240673,755020652,65725,72676924,4950406,268637,827697576,2001
TX,financial administration,8971,28235429,228,313115,21291,9091,28548544,2001
TX,other government administration,2447,7335614,631,523968,42415,2686,7859582,2001
TX,judicial and legal,5119,19635100,100,178105,10438,5178,19813205,2001
TX,police protection - officers,2139,8205270,0,0,0,2139,8205270,2001
TX,police protection - other,1501,4045422,34,29622,2720,1516,4075044,2001
TX,corrections,46504,107772468,556,577352,49537,46784,108349820,2001
TX,streets and highways,15314,40215603,555,761456,34078,15506,40977059,2001
TX,air transportation,0,0,0,0,0,0,0,2001
TX,water transport and terminals,0,0,0,0,0,0,0,2001
TX,public welfare,21297,52877187,144,217753,14141,21377,53094940,2001
TX,health,11618,35442307,653,1204926,59897,11956,36647233,2001
TX,hospitals,29686,88577235,1549,2574010,169119,30641,91151245,2001
TX,social insurance administration,4612,12879625,57,82213,5716,4644,12961838,2001
TX,solid waste management,0,0,0,0,0,0,0,2001
TX,sewerage,0,0,0,0,0,0,0,2001
TX,parks and recreation,961,2274541,191,147318,19524,1071,2421859,2001
TX,housing and community development,0,0,0,0,0,0,0,2001
TX,natural resources,10247,33449517,3113,2386287,268670,11763,35835804,2001
TX,water transport and terminals,0,0,0,0,0,0,0,2001
TX,electric power,0,0,0,0,0,0,0,2001
TX,gas supply,0,0,0,0,0,0,0,2001
TX,transit,0,0,0,0,0,0,0,2001
TX,education - elementary and secondary instructional,13,40600,0,0,0,13,40600,2001
TX,education - elementary and secondary total,0,0,0,0,0,0,0,2001
TX,education - higher education instructional,19412,125255200,25129,38301006,2049590,30994,163556206,2001
TX,education - higher education other,49914,154913727,31603,23813966,2086413,61696,178727693,2001
TX,education - other,4358,13375212,559,936153,61535,4707,14311365,2001
TX,libraries,0,0,0,0,0,0,0,2001
TX,liquor stores,0,0,0,0,0,0,0,2001
TX,other and unallocable,6560,20490595,623,629674,55322,6875,21120269,2001
UT,total,44630,134870378,19221,14663415,1315803,52070,149533793,2001
UT,financial administration,1560,4762054,282,256567,29854,1729,5018621,2001
UT,other government administration,176,769923,33,37547,1941,186,807470,2001
UT,judicial and legal,1501,5245916,243,345581,18401,1606,5591497,2001
UT,police protection - officers,405,1458211,0,0,0,405,1458211,2001
UT,police protection - other,332,1162660,57,52923,4662,358,1215583,2001
UT,corrections,2931,8835286,377,334503,31623,3110,9169789,2001
UT,streets and highways,1743,6058713,60,80474,6879,1782,6139187,2001
UT,air transportation,0,0,0,0,0,0,0,2001
UT,water transport and terminals,0,0,0,0,0,0,0,2001
UT,public welfare,2995,8797652,379,518895,35818,3198,9316547,2001
UT,health,1825,5808350,253,389216,20924,1943,6197566,2001
UT,hospitals,5591,14617096,439,363841,34071,5783,14980937,2001
UT,social insurance administration,714,2151446,68,94750,6097,748,2246196,2001
UT,solid waste management,0,0,0,0,0,0,0,2001
UT,sewerage,0,0,0,0,0,0,0,2001
UT,parks and recreation,251,760956,69,62347,7007,291,823303,2001
UT,housing and community development,0,0,0,0,0,0,0,2001
UT,natural resources,1016,3317571,247,225646,18582,1122,3543217,2001
UT,water transport and terminals,0,0,0,0,0,0,0,2001
UT,electric power,0,0,0,0,0,0,0,2001
UT,gas supply,0,0,0,0,0,0,0,2001
UT,transit,0,0,0,0,0,0,0,2001
UT,education - elementary and secondary instructional,0,0,0,0,0,0,0,2001
UT,education - elementary and secondary total,0,0,0,0,0,0,0,2001
UT,education - higher education instructional,4689,26264636,3285,3256154,189707,5761,29520790,2001
UT,education - higher education other,15874,34922901,11897,7404020,810800,20454,42326921,2001
UT,education - other,1202,3836632,922,777947,57783,1530,4614579,2001
UT,libraries,0,0,0,0,0,0,0,2001
UT,liquor stores,215,535496,245,131943,16587,309,667439,2001
UT,other and unallocable,1610,5564879,365,331061,25067,1755,5895940,2001
VT,total,12603,41634801,2607,2968260,182328,13666,44603061,2001
VT,financial administration,537,1639697,6,10461,985,543,1650158,2001
VT,other government administration,467,1377297,207,499668,29592,634,1876965,2001
VT,judicial and legal,562,2085539,65,128279,7879,606,2213818,2001
VT,police protection - officers,308,1445341,9,3631,356,310,1448972,2001
VT,police protection - other,170,558406,37,32816,1638,179,591222,2001
VT,corrections,984,3064849,17,31317,2462,998,3096166,2001
VT,streets and highways,990,3640540,12,29296,1831,1000,3669836,2001
VT,air transportation,0,0,0,0,0,0,0,2001
VT,water transport and terminals,0,0,0,0,0,0,0,2001
VT,public welfare,1089,3535756,72,157354,10544,1148,3693110,2001
VT,health,486,1731302,101,226660,12317,556,1957962,2001
VT,hospitals,169,504498,5,8776,598,172,513274,2001
VT,social insurance administration,304,990980,15,34414,2497,318,1025394,2001
VT,solid waste management,0,0,0,0,0,0,0,2001
VT,sewerage,0,0,0,0,0,0,0,2001
VT,parks and recreation,122,406889,6,15062,1069,128,421951,2001
VT,housing and community development,0,0,0,0,0,0,0,2001
VT,natural resources,536,2007090,71,263570,6820,575,2270660,2001
VT,water transport and terminals,0,0,0,0,0,0,0,2001
VT,electric power,0,0,0,0,0,0,0,2001
VT,gas supply,0,0,0,0,0,0,0,2001
VT,transit,0,0,0,0,0,0,0,2001
VT,education - elementary and secondary instructional,0,0,0,0,0,0,0,2001
VT,education - elementary and secondary total,0,0,0,0,0,0,0,2001
VT,education - higher education instructional,1228,6543031,440,575587,22836,1366,7118618,2001
VT,education - higher education other,3132,6994113,1385,712133,65517,3527,7706246,2001
VT,education - other,488,1629560,49,85574,5143,518,1715134,2001
VT,libraries,0,0,0,0,0,0,0,2001
VT,liquor stores,56,214842,1,839,84,56,215681,2001
VT,other and unallocable,975,3265071,109,152823,10160,1032,3417894,2001
VA,total,102837,346342492,45106,39553315,3660842,123521,385895807,2001
VA,financial administration,3937,13468640,686,779100,66960,4315,14247740,2001
VA,other government administration,503,2111178,293,591917,33520,699,2703095,2001
VA,judicial and legal,3348,13330526,456,473288,19100,3457,13803814,2001
VA,police protection - officers,1879,7698626,0,0,0,1879,7698626,2001
VA,police protection - other,726,2062234,158,149834,12830,799,2212068,2001
VA,corrections,15366,40407212,438,406796,34570,15562,40814008,2001
VA,streets and highways,10310,31003818,428,390698,31836,10490,31394516,2001
VA,air transportation,0,0,0,0,0,0,0,2001
VA,water transport and terminals,129,477604,2,1848,212,130,479452,2001
VA,public welfare,1967,6422002,197,325896,18626,2071,6747898,2001
VA,health,4783,15958024,629,619958,46972,5048,16577982,2001
VA,hospitals,12761,35882432,1269,2124267,117364,13423,38006699,2001
VA,social insurance administration,1157,3731434,389,410750,34546,1352,4142184,2001
VA,solid waste management,0,0,0,0,0,0,0,2001
VA,sewerage,0,0,0,0,0,0,0,2001
VA,parks and recreation,668,1928348,663,435808,47066,935,2364156,2001
VA,housing and community development,0,0,0,0,0,0,0,2001
VA,natural resources,2873,10361562,640,517916,46390,3136,10879478,2001
VA,water transport and terminals,0,0,0,0,0,0,0,2001
VA,electric power,0,0,0,0,0,0,0,2001
VA,gas supply,0,0,0,0,0,0,0,2001
VA,transit,0,0,0,0,0,0,0,2001
VA,education - elementary and secondary instructional,0,0,0,0,0,0,0,2001
VA,education - elementary and secondary total,0,0,0,0,0,0,0,2001
VA,education - higher education instructional,12955,72303298,12798,16434615,764078,17271,88737913,2001
VA,education - higher education other,22579,64549783,23893,13731704,2196435,34985,78281487,2001
VA,education - other,2726,9508284,667,645704,47999,2998,10153988,2001
VA,libraries,0,0,0,0,0,0,0,2001
VA,liquor stores,698,1645158,883,848000,92336,1220,2493158,2001
VA,other and unallocable,3472,13492329,617,665216,50002,3751,14157545,2001
WA,total,91881,338574129,53638,48310633,3405767,111132,386884762,2001
WA,financial administration,2446,9165534,237,443496,25078,2589,9609030,2001
WA,other government administration,1411,4774254,228,194244,12764,1483,4968498,2001
WA,judicial and legal,1674,7757146,216,354428,17970,1776,8111574,2001
WA,police protection - officers,1004,4524018,0,0,0,1004,4524018,2001
WA,police protection - other,1155,4339300,1,3830,140,1156,4343130,2001
WA,corrections,6490,22221770,1949,2965062,221350,7740,25186832,2001
WA,streets and highways,6486,26746908,453,908598,42300,6725,27655506,2001
WA,air transportation,0,0,0,0,0,0,0,2001
WA,water transport and terminals,0,0,0,0,0,0,0,2001
WA,public welfare,7830,26600994,365,367066,21616,7952,26968060,2001
WA,health,4986,17174576,554,694310,32474,5170,17868886,2001
WA,hospitals,7777,28291814,2623,5764379,201028,8912,34056193,2001
WA,social insurance administration,3488,12135866,599,705748,63992,3851,12841614,2001
WA,solid waste management,147,550930,10,35689,1100,153,586619,2001
WA,sewerage,0,0,0,0,0,0,0,2001
WA,parks and recreation,526,1571006,139,184918,15380,613,1755924,2001
WA,housing and community development,0,0,0,0,0,0,0,2001
WA,natural resources,4619,16570700,640,921145,76408,5051,17491845,2001
WA,water transport and terminals,0,0,0,0,0,0,0,2001
WA,electric power,0,0,0,0,0,0,0,2001
WA,gas supply,0,0,0,0,0,0,0,2001
WA,transit,0,0,0,0,0,0,0,2001
WA,education - elementary and secondary instructional,0,0,0,0,0,0,0,2001
WA,education - elementary and secondary total,0,0,0,0,0,0,0,2001
WA,education - higher education instructional,10441,48666933,11935,17171145,635211,14028,65838078,2001
WA,education - higher education other,22837,78159289,29658,13602133,1800667,33012,91761422,2001
WA,education - other,3015,10303662,3055,2520038,138045,3800,12823700,2001
WA,libraries,0,0,0,0,0,0,0,2001
WA,liquor stores,495,1478806,479,675554,53236,796,2154360,2001
WA,other and unallocable,5054,17540623,497,798850,47008,5321,18339473,2001
WV,total,32206,89000631,9116,6837603,523020,35348,95838234,2001
WV,financial administration,2104,4901206,65,63144,7491,2146,4964350,2001
WV,other government administration,267,778794,330,963307,32964,476,1742101,2001
WV,judicial and legal,1274,3773206,23,25960,2184,1287,3799166,2001
WV,police protection - officers,662,2305512,0,0,0,662,2305512,2001
WV,police protection - other,371,605762,9,6158,828,376,611920,2001
WV,corrections,1325,2725408,5,5776,426,1327,2731184,2001
WV,streets and highways,5314,14467552,38,71045,6162,5349,14538597,2001
WV,air transportation,0,0,0,0,0,0,0,2001
WV,water transport and terminals,0,0,0,0,0,0,0,2001
WV,public welfare,3104,6603532,0,0,0,3104,6603532,2001
WV,health,769,1898272,17,35844,2012,780,1934116,2001
WV,hospitals,1653,3133046,68,87824,6914,1693,3220870,2001
WV,social insurance administration,756,1809202,31,23176,2354,770,1832378,2001
WV,solid waste management,12,33706,0,0,0,12,33706,2001
WV,sewerage,0,0,0,0,0,0,0,2001
WV,parks and recreation,438,809576,344,180076,30854,612,989652,2001
WV,housing and community development,0,0,0,0,0,0,0,2001
WV,natural resources,1858,5362904,190,84306,13344,1937,5447210,2001
WV,water transport and terminals,0,0,0,0,0,0,0,2001
WV,electric power,0,0,0,0,0,0,0,2001
WV,gas supply,0,0,0,0,0,0,0,2001
WV,transit,0,0,0,0,0,0,0,2001
WV,education - elementary and secondary instructional,0,0,0,0,0,0,0,2001
WV,education - elementary and secondary total,0,0,0,0,0,0,0,2001
WV,education - higher education instructional,3202,15072886,4238,3420119,172810,4244,18493005,2001
WV,education - higher education other,5805,15404024,3505,1644932,227197,7172,17048956,2001
WV,education - other,1343,3860368,145,130074,8672,1396,3990442,2001
WV,libraries,0,0,0,0,0,0,0,2001
WV,liquor stores,58,134418,0,0,0,58,134418,2001
WV,other and unallocable,1891,5321257,108,95862,8808,1947,5417119,2001
WI,total,54607,216601296,37847,41003503,2623337,69428,257604799,2001
WI,financial administration,2536,8845720,1208,1323834,116483,3194,10169554,2001
WI,other government administration,755,2809634,370,659121,29905,926,3468755,2001
WI,judicial and legal,1871,10096692,345,785286,34950,2068,10881978,2001
WI,police protection - officers,647,2529103,0,0,0,647,2529103,2001
WI,police protection - other,285,961732,34,38649,3000,302,1000381,2001
WI,corrections,8462,27049821,1147,2486275,117980,9128,29536096,2001
WI,streets and highways,1957,7494948,309,345466,23893,2092,7840414,2001
WI,air transportation,0,0,0,0,0,0,0,2001
WI,water transport and terminals,0,0,0,0,0,0,0,2001
WI,public welfare,1181,3897189,343,517416,35645,1382,4414605,2001
WI,health,1725,6753123,586,950384,41452,1960,7703507,2001
WI,hospitals,3198,10259980,1466,2177604,117212,3861,12437584,2001
WI,social insurance administration,865,2862733,53,134168,7477,907,2996901,2001
WI,solid waste management,0,0,0,0,0,0,0,2001
WI,sewerage,0,0,0,0,0,0,0,2001
WI,parks and recreation,163,520790,106,107543,7249,204,628333,2001
WI,housing and community development,0,0,0,0,0,0,0,2001
WI,natural resources,1966,6823795,1468,1719408,151625,2822,8543203,2001
WI,water transport and terminals,0,0,0,0,0,0,0,2001
WI,electric power,0,0,0,0,0,0,0,2001
WI,gas supply,0,0,0,0,0,0,0,2001
WI,transit,0,0,0,0,0,0,0,2001
WI,education - elementary and secondary instructional,0,0,0,0,0,0,0,2001
WI,education - elementary and secondary total,0,0,0,0,0,0,0,2001
WI,education - higher education instructional,8247,47364735,8271,10536673,567289,11452,57901408,2001
WI,education - higher education other,14676,54733265,20475,16845076,1226750,21607,71578341,2001
WI,education - other,1069,4127952,289,400262,21769,1192,4528214,2001
WI,libraries,0,0,0,0,0,0,0,2001
WI,liquor stores,0,0,0,0,0,0,0,2001
WI,other and unallocable,5004,19470084,1377,1976338,120658,5684,21446422,2001
WY,total,10041,28490203,3524,2251391,199061,11158,30741594,2001
WY,financial administration,474,1402940,4,5279,347,476,1408219,2001
WY,other government administration,82,288398,91,18534,1803,92,306932,2001
WY,judicial and legal,402,1385080,24,32600,2081,412,1417680,2001
WY,police protection - officers,111,356446,0,0,0,111,356446,2001
WY,police protection - other,78,249472,0,0,0,78,249472,2001
WY,corrections,897,2148368,4,3875,347,899,2152243,2001
WY,streets and highways,1713,4888423,95,100582,10260,1771,4989005,2001
WY,air transportation,0,0,0,0,0,0,0,2001
WY,water transport and terminals,0,0,0,0,0,0,0,2001
WY,public welfare,741,1830303,81,111428,11953,808,1941731,2001
WY,health,478,1435473,90,183043,13431,553,1618516,2001
WY,hospitals,964,1873228,8,1328,138,965,1874556,2001
WY,social insurance administration,289,815697,24,26036,2082,301,841733,2001
WY,solid waste management,0,0,0,0,0,0,0,2001
WY,sewerage,0,0,0,0,0,0,0,2001
WY,parks and recreation,84,219486,7,6898,607,87,226384,2001
WY,housing and community development,0,0,0,0,0,0,0,2001
WY,natural resources,677,2127752,17,16469,1332,684,2144221,2001
WY,water transport and terminals,0,0,0,0,0,0,0,2001
WY,electric power,0,0,0,0,0,0,0,2001
WY,gas supply,0,0,0,0,0,0,0,2001
WY,transit,0,0,0,0,0,0,0,2001
WY,education - elementary and secondary instructional,0,0,0,0,0,0,0,2001
WY,education - elementary and secondary total,0,0,0,0,0,0,0,2001
WY,education - higher education instructional,766,3433402,788,736009,45321,1022,4169411,2001
WY,education - higher education other,1479,3723334,2241,959409,105026,2072,4682743,2001
WY,education - other,174,521570,10,9423,866,178,530993,2001
WY,libraries,0,0,0,0,0,0,0,2001
WY,liquor stores,30,80936,0,0,0,30,80936,2001
WY,other and unallocable,602,1709895,40,40478,3467,619,1750373,2001
