state,government_function,full_time_employees,full_time_pay,part_time_employees,part_time_pay,part_time_hours,equivalent_employees,march_pay,year
US,total,3682499,13463776932,1392195,1379399864,94794243,4227836,14843176796,2002
US,financial administration,160247,560525842,13235,19546722,1400531,168327,580072564,2002
US,other government administration,48801,179395048,12663,20536439,1103875,55185,199931487,2002
US,judicial and legal,154427,645536919,9740,18632843,972943,160043,664169762,2002
US,police protection - officers,63230,287042841,643,943821,24992,63373,287986662,2002
US,other employees,39940,137951194,2649,3012849,184424,40998,140964043,2002
US,corrections,456831,1479004755,10871,19605041,1129071,463291,1498609796,2002
US,highways,242172,841985860,10366,16779682,1057864,248272,858765542,2002
US,air transportation,3119,12820538,194,283355,15454,3208,13103893,2002
US,water transport and terminals,4430,17077087,95,128833,7970,4475,17205920,2002
US,public welfare,234317,723370710,10272,18689358,1195542,241217,742060068,2002
US,health,168273,579527532,13905,23825367,1407523,176345,603352899,2002
US,hospitals,376905,1204415210,54351,105619216,5659099,409336,1310034426,2002
US,social insurance administration,82658,287973230,9119,16356957,1059987,88786,304330187,2002
US,solid waste management,1775,7901122,105,289766,11957,1844,8190888,2002
US,sewerage,1963,9211792,60,192488,7983,2009,9404280,2002
US,parks and recreation,28168,82682908,13572,15287713,1405788,36245,97970621,2002
US,natural resources,135421,467990045,32705,37083537,2990163,152530,505073582,2002
US,water transport and terminals,747,3349979,21,57010,2427,761,3406989,2002
US,electric power,3827,20948813,80,173414,9753,3882,21122227,2002
US,transit,31278,145793302,2051,2883524,201148,32421,148676826,2002
US,instructional employees,37086,144245793,9821,6681073,376393,39450,150926866,2002
US,other employees,13908,35973882,7731,3530910,298765,15811,39504792,2002
US,instructional employees,356944,2028769829,363075,490683764,23996210,495039,2519453593,2002
US,other employees,742053,2447095880,775653,502024273,47065930,1012526,2949120153,2002
US,education - other,91516,318915425,16404,18703117,1135316,98098,337618542,2002
US,libraries,498,1306600,248,159516,18356,602,1466116,2002
US,liquor stores,5849,16001124,3342,2411859,245462,7268,18412983,2002
US,other and unallocable,196116,776963672,19224,35277417,1809317,206494,812241089,2002
AL,total,73967,244920436,26127,26421465,2041536,85719,271341901,2002
AL,financial administration,2539,8243313,46,35058,5274,2569,8278371,2002
AL,other government administration,564,1990297,90,100783,6124,599,2091080,2002
AL,judicial and legal,3391,11827812,156,186189,20213,3505,12014001,2002
AL,police protection - officers,730,2896720,0,0,0,730,2896720,2002
AL,other employees,645,1606906,23,12349,1513,654,1619255,2002
AL,corrections,4574,14868421,9,8883,1010,4580,14877304,2002
AL,highways,3962,10773962,60,45659,5314,3992,10819621,2002
AL,water transport and terminals,412,1234075,2,1650,30,412,1235725,2002
AL,public welfare,3787,10402216,28,39651,2714,3802,10441867,2002
AL,health,4862,13708275,452,400586,54494,5172,14108861,2002
AL,hospitals,11616,38053635,1389,2982971,152594,12483,41036606,2002
AL,social insurance administration,1513,3945348,36,20561,2967,1530,3965909,2002
AL,parks and recreation,429,991436,417,357384,52144,725,1348820,2002
AL,natural resources,2121,6502936,331,302049,47005,2387,6804985,2002
AL,instructional employees,9118,48856284,7833,10407075,476448,11879,59263359,2002
AL,other employees,18535,53283685,14737,11047075,1159160,25222,64330760,2002
AL,education - other,2556,8169791,84,65755,5941,2589,8235546,2002
AL,liquor stores,639,1398351,4,5867,531,642,1404218,2002
AL,other and unallocable,1974,6166973,430,401920,48060,2247,6568893,2002
AK,total,22922,91197719,5581,5001645,323031,24815,96199364,2002
AK,financial administration,977,3922466,24,39658,2143,990,3962124,2002
AK,other government administration,615,2270763,38,36632,2391,629,2307395,2002
AK,judicial and legal,1181,5050766,89,134599,6220,1218,5185365,2002
AK,police protection - officers,252,1456508,2,717,64,252,1457225,2002
AK,other employees,195,637327,67,19806,1630,205,657133,2002
AK,corrections,1751,7113379,31,47862,3494,1772,7161241,2002
AK,highways,2882,12151734,18,20422,1613,2892,12172156,2002
AK,public welfare,1632,5357381,156,192035,20052,1753,5549416,2002
AK,health,721,2940352,39,57586,2971,739,2997938,2002
AK,hospitals,236,944794,6,8698,462,239,953492,2002
AK,social insurance administration,468,1637253,5,5638,285,470,1642891,2002
AK,parks and recreation,83,307626,2,2471,147,84,310097,2002
AK,natural resources,2187,8374156,62,72481,4637,2215,8446637,2002
AK,instructional employees,1998,7790778,660,633272,45829,2275,8424050,2002
AK,other employees,804,2429031,697,678053,52660,1126,3107084,2002
AK,instructional employees,1167,6724781,1749,1776339,54266,1475,8501120,2002
AK,other employees,2809,9621595,1817,1135964,114798,3461,10757559,2002
AK,education - other,406,1526335,56,60552,4627,434,1586887,2002
AK,other and unallocable,2558,10940694,63,78860,4742,2586,11019554,2002
AZ,total,56962,185742329,23880,20810774,1668946,66442,206553103,2002
AZ,financial administration,3690,10540681,36,65829,3010,3707,10606510,2002
AZ,other government administration,608,1945533,145,208718,14107,689,2154251,2002
AZ,judicial and legal,1347,5861031,102,178962,8533,1395,6039993,2002
AZ,police protection - officers,1012,4179788,0,0,0,1012,4179788,2002
AZ,other employees,863,2773483,5,7176,461,866,2780659,2002
AZ,corrections,9478,26744371,99,202515,9467,9532,26946886,2002
AZ,highways,3079,9736532,0,0,0,3079,9736532,2002
AZ,public welfare,5819,13661406,191,195117,18810,5925,13856523,2002
AZ,health,2454,8013057,34,67194,3542,2474,8080251,2002
AZ,hospitals,726,2221348,62,112221,4973,754,2333569,2002
AZ,social insurance administration,2015,4761791,14,19167,886,2020,4780958,2002
AZ,parks and recreation,367,973896,134,81529,12655,439,1055425,2002
AZ,natural resources,2028,6811745,644,593301,48494,2303,7405046,2002
AZ,electric power,10,49332,0,0,0,10,49332,2002
AZ,instructional employees,5097,30009508,6397,8144141,501011,7944,38153649,2002
AZ,other employees,12271,40611467,15337,10258432,990402,17899,50869899,2002
AZ,education - other,2695,6893899,513,513667,41988,2933,7407566,2002
AZ,other and unallocable,3403,9953461,167,162805,10607,3461,10116266,2002
AR,total,49082,144297649,13912,8589356,732440,53253,152887005,2002
AR,financial administration,1848,5025556,73,65410,7156,1889,5090966,2002
AR,other government administration,564,1867335,4,6447,303,565,1873782,2002
AR,judicial and legal,1374,4581719,100,257328,6961,1413,4839047,2002
AR,police protection - officers,551,1766936,0,0,0,551,1766936,2002
AR,other employees,599,1596445,2,1734,186,601,1598179,2002
AR,corrections,4230,9527484,4,3002,418,4232,9530486,2002
AR,highways,3605,10534382,48,58908,1492,3613,10593290,2002
AR,public welfare,4065,9013468,0,0,0,4065,9013468,2002
AR,health,4469,11108807,237,346440,22215,4596,11455247,2002
AR,hospitals,4248,10884978,149,203309,8473,4296,11088287,2002
AR,social insurance administration,889,2766054,219,243150,25869,1036,3009204,2002
AR,parks and recreation,624,1350164,228,135116,22536,752,1485280,2002
AR,natural resources,1775,4609984,472,258610,27483,1932,4868594,2002
AR,instructional employees,5311,29832808,3587,3160440,193087,6410,32993248,2002
AR,other employees,10020,25432236,7794,3042734,359857,12069,28474970,2002
AR,education - other,2594,7415916,819,596072,40062,2822,8011988,2002
AR,other and unallocable,2316,6983377,176,210656,16342,2411,7194033,2002
CA,total,321012,1522103063,150418,199359900,10149791,378688,1721462963,2002
CA,financial administration,20333,77650456,3864,5660345,380783,22497,83310801,2002
CA,other government administration,3833,17796616,449,962681,31916,4020,18759297,2002
CA,judicial and legal,3912,22579054,478,774378,31597,4092,23353432,2002
CA,police protection - officers,7585,43554252,575,831585,19332,7695,44385837,2002
CA,other employees,5337,19122083,1135,1239560,63492,5697,20361643,2002
CA,corrections,43791,194073909,1951,5131315,231936,45110,199205224,2002
CA,highways,22140,115983293,885,2397930,101394,22717,118381223,2002
CA,water transport and terminals,74,313960,14,13258,750,78,327218,2002
CA,public welfare,3983,16192581,308,633797,28919,4148,16826378,2002
CA,health,11538,52743681,1542,3245789,139866,12332,55989470,2002
CA,hospitals,32535,135386419,7928,16727220,715823,36601,152113639,2002
CA,social insurance administration,16184,66203266,2398,5147799,283290,17795,71351065,2002
CA,solid waste management,390,1890876,64,199176,7391,432,2090052,2002
CA,parks and recreation,2310,9262484,1454,2033951,149955,3162,11296435,2002
CA,natural resources,12434,57061188,3597,5103557,459820,15045,62164745,2002
CA,instructional employees,20640,144840912,28566,46407075,1838501,31087,191247987,2002
CA,other employees,76243,337917652,88536,83188367,4906423,104120,421106019,2002
CA,education - other,4576,19118917,644,1137644,59310,4912,20256561,2002
CA,other and unallocable,33174,190411464,6030,18524473,699293,37148,208935937,2002
CO,total,50137,211009098,34540,44217629,2795529,66025,255226727,2002
CO,financial administration,2099,8998750,152,256259,13601,2176,9255009,2002
CO,other government administration,450,1513852,124,304272,19938,564,1818124,2002
CO,judicial and legal,3155,13075302,850,1827576,91893,3677,14902878,2002
CO,police protection - officers,725,4319561,1,3273,80,725,4322834,2002
CO,other employees,382,1493679,13,16793,1105,389,1510472,2002
CO,corrections,6690,24839053,78,191481,9535,6745,25030534,2002
CO,highways,3015,11749633,158,341052,18392,3120,12090685,2002
CO,public welfare,1864,7321047,263,463366,24575,2004,7784413,2002
CO,health,1063,5085682,150,354563,15302,1150,5440245,2002
CO,hospitals,3284,10890983,905,1563915,80196,3740,12454898,2002
CO,social insurance administration,882,3637058,84,118329,7367,924,3755387,2002
CO,parks and recreation,252,1050177,101,88198,5708,284,1138375,2002
CO,natural resources,1330,5961269,285,413394,18341,1435,6374663,2002
CO,instructional employees,9869,53009937,9447,13261550,688330,13782,66271487,2002
CO,other employees,12555,47726852,21250,23949539,1744646,22467,71676391,2002
CO,education - other,1087,4135954,565,830013,45004,1342,4965967,2002
CO,other and unallocable,1435,6200309,114,234056,11516,1501,6434365,2002
CT,total,58414,249705597,18220,23863946,1388020,66875,273569543,2002
CT,financial administration,2677,10523959,81,192851,9004,2735,10716810,2002
CT,other government administration,1041,4386796,237,834565,35233,1244,5221361,2002
CT,judicial and legal,4039,15605748,154,496866,19565,4165,16102614,2002
CT,police protection - officers,1301,6491731,0,0,0,1301,6491731,2002
CT,other employees,534,2060840,46,58002,4406,563,2118842,2002
CT,corrections,7944,29968524,83,226195,8782,8001,30194719,2002
CT,highways,3628,15072786,0,0,0,3628,15072786,2002
CT,air transportation,34,193809,0,0,0,34,193809,2002
CT,public welfare,4597,18959632,207,557566,25245,4760,19517198,2002
CT,health,2135,8914817,117,304172,12274,2207,9218989,2002
CT,hospitals,9102,40860277,2169,4958760,225222,10495,45819037,2002
CT,social insurance administration,887,3702550,25,84278,2936,906,3786828,2002
CT,solid waste management,50,240680,8,19930,932,56,260610,2002
CT,parks and recreation,141,521410,5,12111,753,145,533521,2002
CT,natural resources,539,2158406,31,56468,4001,563,2214874,2002
CT,instructional employees,2596,12888772,533,1354853,70356,3020,14243625,2002
CT,other employees,947,2234533,988,338713,28226,1117,2573246,2002
CT,instructional employees,3883,24302261,6187,8982636,441956,6546,33284897,2002
CT,other employees,7174,30680219,6876,4405313,446523,9885,35085532,2002
CT,education - other,2796,10067671,279,616906,32761,3007,10684577,2002
CT,other and unallocable,2369,9870176,194,363761,19845,2497,10233937,2002
DE,total,22015,77613430,7719,7298328,467127,24828,84911758,2002
DE,financial administration,688,2166892,75,75632,7367,732,2242524,2002
DE,other government administration,227,816950,122,222472,10200,286,1039422,2002
DE,judicial and legal,1468,4835103,24,35741,1858,1478,4870844,2002
DE,police protection - officers,598,2682246,0,0,0,598,2682246,2002
DE,other employees,315,882355,2,2836,133,316,885191,2002
DE,corrections,2958,10610783,83,94425,10991,3020,10705208,2002
DE,highways,1644,4653112,43,50459,1335,1652,4703571,2002
DE,public welfare,1643,4804426,126,188901,14068,1727,4993327,2002
DE,health,1960,6416117,227,321136,24726,2109,6737253,2002
DE,hospitals,1905,5420494,105,233993,9671,1963,5654487,2002
DE,social insurance administration,297,851624,14,27865,1963,308,879489,2002
DE,solid waste management,99,299574,12,11869,1295,107,311443,2002
DE,parks and recreation,179,517586,131,85117,8935,233,602703,2002
DE,natural resources,421,1415759,111,66976,5636,454,1482735,2002
DE,transit,595,2078078,8,9815,793,600,2087893,2002
DE,instructional employees,1550,9409574,2695,3378414,170790,2580,12787988,2002
DE,other employees,3613,12694339,3718,2292645,180218,4707,14986984,2002
DE,education - other,358,1585173,9,18664,851,363,1603837,2002
DE,other and unallocable,1497,5473245,214,181368,16297,1595,5654613,2002
FL,total,168550,540417617,39601,42396080,2874514,184885,582813697,2002
FL,financial administration,6475,21052846,212,148685,17592,6575,21201531,2002
FL,other government administration,2132,7560254,32,55984,3758,2153,7616238,2002
FL,judicial and legal,17782,62865046,415,813885,41480,18020,63678931,2002
FL,police protection - officers,2325,8463510,0,0,0,2325,8463510,2002
FL,other employees,1785,6318279,24,27834,2212,1798,6346113,2002
FL,corrections,26352,71240834,41,67376,4381,26378,71308210,2002
FL,highways,8944,29264185,36,43283,3190,8962,29307468,2002
FL,water transport and terminals,0,0,6,5049,240,1,5049,2002
FL,public welfare,13856,35118021,91,114260,8311,13903,35232281,2002
FL,health,18620,51156073,1095,1899019,151954,19482,53055092,2002
FL,hospitals,4960,13277166,32,50008,2878,4977,13327174,2002
FL,social insurance administration,3369,9043013,28,39668,2727,3384,9082681,2002
FL,parks and recreation,1387,2694773,60,39258,5790,1420,2734031,2002
FL,natural resources,9862,26774746,2052,1791763,132346,10615,28566509,2002
FL,transit,534,1753183,32,34898,3372,553,1788081,2002
FL,instructional employees,14476,90418430,16758,21592219,1087541,20655,112010649,2002
FL,other employees,23971,69786493,18358,15308996,1381797,31822,85095489,2002
FL,education - other,3338,8895534,60,59237,4844,3365,8954771,2002
FL,other and unallocable,8382,24735231,269,304658,20101,8497,25039889,2002
GA,total,109861,343662929,35849,29630276,2295043,122901,373293205,2002
GA,financial administration,4471,12960005,15,36642,1459,4479,12996647,2002
GA,other government administration,956,3590083,595,1014363,59210,1292,4604446,2002
GA,judicial and legal,2322,8576286,15,40597,1396,2330,8616883,2002
GA,police protection - officers,1238,4251134,0,0,0,1238,4251134,2002
GA,other employees,1104,3216299,17,22526,1640,1113,3238825,2002
GA,corrections,19331,47609684,626,927650,60044,19672,48537334,2002
GA,highways,6003,15779550,6,11198,600,6006,15790748,2002
GA,water transport and terminals,654,2347667,0,0,0,654,2347667,2002
GA,public welfare,8583,22491180,144,206620,14670,8666,22697800,2002
GA,health,4137,12596225,191,205393,20262,4252,12801618,2002
GA,hospitals,7661,18836966,130,221990,10658,7721,19058956,2002
GA,social insurance administration,2144,6142093,17,19226,1680,2154,6161319,2002
GA,parks and recreation,1233,2956676,2499,2777989,302436,2950,5734665,2002
GA,natural resources,4324,12666894,916,736590,69077,4717,13403484,2002
GA,instructional employees,12527,67812212,12527,12036420,603468,15958,79848632,2002
GA,other employees,26943,80925340,17703,10494303,1099450,33190,91419643,2002
GA,education - other,2855,10229880,336,781277,38760,3076,11011157,2002
GA,other and unallocable,3375,10674755,112,97492,10233,3433,10772247,2002
HI,total,51694,161418362,19160,11664448,745488,55990,173082810,2002
HI,financial administration,646,2101984,9,4786,340,648,2106770,2002
HI,other government administration,596,2100408,13,15418,932,601,2115826,2002
HI,judicial and legal,2218,7808446,57,64962,2644,2233,7873408,2002
HI,corrections,2463,7982404,23,48242,1812,2473,8030646,2002
HI,highways,908,2960180,10,5382,780,912,2965562,2002
HI,air transportation,1095,3031054,20,16156,1538,1104,3047210,2002
HI,water transport and terminals,215,628864,3,1512,234,216,630376,2002
HI,public welfare,809,2514310,20,12436,1508,818,2526746,2002
HI,health,2460,7929436,88,129362,5952,2494,8058798,2002
HI,hospitals,3584,12095058,465,864448,42490,3823,12959506,2002
HI,social insurance administration,436,1215738,56,87420,4538,462,1303158,2002
HI,parks and recreation,163,451394,190,118354,11762,230,569748,2002
HI,natural resources,996,3578826,363,436724,33156,1185,4015550,2002
HI,instructional employees,20144,58364654,6709,2025051,113949,20830,60389705,2002
HI,other employees,4815,11360668,3963,841345,71283,5244,12202013,2002
HI,instructional employees,2080,10367592,1475,2254910,81066,2541,12622502,2002
HI,other employees,3763,13263014,5332,4471052,343928,5717,17734066,2002
HI,education - other,141,456392,2,3550,160,142,459942,2002
HI,libraries,498,1306600,248,159516,18356,602,1466116,2002
HI,other and unallocable,3664,11901340,114,103822,9060,3715,12005162,2002
ID,total,18386,60127786,11439,10216487,966188,23876,70344273,2002
ID,financial administration,1409,4393687,199,107674,13288,1484,4501361,2002
ID,other government administration,167,595217,267,417827,23234,299,1013044,2002
ID,judicial and legal,449,1960392,8,6101,764,454,1966493,2002
ID,police protection - officers,278,1046336,0,0,0,278,1046336,2002
ID,other employees,202,661897,23,23424,2037,214,685321,2002
ID,corrections,1786,4786991,132,99559,12445,1857,4886550,2002
ID,highways,1625,4775540,146,221032,24221,1763,4996572,2002
ID,public welfare,1592,4868495,202,394081,22880,1722,5262576,2002
ID,health,974,3375830,225,304213,18469,1079,3680043,2002
ID,hospitals,811,2376970,281,190287,15527,899,2567257,2002
ID,social insurance administration,505,2023590,252,229700,28711,668,2253290,2002
ID,parks and recreation,170,429901,66,51568,6445,207,481469,2002
ID,natural resources,1560,5381000,704,896255,83333,2034,6277255,2002
ID,instructional employees,1957,8881983,1844,2254390,138659,2744,11136373,2002
ID,other employees,3161,9320389,6393,4796161,548753,6279,14116550,2002
ID,education - other,614,1802386,284,114520,14312,695,1916906,2002
ID,liquor stores,151,375687,46,25680,3210,169,401367,2002
ID,other and unallocable,975,3071495,367,84015,9900,1031,3155510,2002
IL,total,126486,487797540,46554,37777251,3438521,146715,525574791,2002
IL,financial administration,5896,19842330,288,410377,29410,6074,20252707,2002
IL,other government administration,2237,9050359,46,53375,1979,2247,9103734,2002
IL,judicial and legal,3230,19216822,132,201148,10216,3293,19417970,2002
IL,police protection - officers,2345,11585344,3,4076,362,2347,11589420,2002
IL,other employees,1866,7346326,50,43210,2578,1882,7389536,2002
IL,corrections,16784,60528592,20,55066,1826,16795,60583658,2002
IL,highways,7820,31106507,1213,2579799,144751,8692,33686306,2002
IL,water transport and terminals,96,440000,3,3128,290,98,443128,2002
IL,public welfare,14565,55303972,170,469680,21690,14696,55773652,2002
IL,health,3099,13418874,19,46170,1692,3110,13465044,2002
IL,hospitals,13260,40741805,616,1304395,66657,13662,42046200,2002
IL,social insurance administration,2406,10416340,384,1086383,48630,2699,11502723,2002
IL,parks and recreation,695,2336934,81,155076,10856,761,2492010,2002
IL,natural resources,3141,12150349,1185,1312253,180709,4173,13462602,2002
IL,instructional employees,12657,69500486,12866,14215271,650220,16523,83715757,2002
IL,other employees,26104,85159084,29168,15351127,2238659,39210,100510211,2002
IL,education - other,2621,10030652,94,244978,11634,2691,10275630,2002
IL,other and unallocable,7664,29622764,216,241739,16362,7762,29864503,2002
IN,total,75174,240738329,35115,30214223,2646537,90326,270952552,2002
IN,financial administration,2631,7681619,166,200872,20919,2756,7882491,2002
IN,other government administration,506,1315449,175,177118,8574,558,1492567,2002
IN,judicial and legal,1199,5752334,7,13824,567,1203,5766158,2002
IN,police protection - officers,1265,5068154,0,0,0,1265,5068154,2002
IN,other employees,765,2021123,1,1063,105,766,2022186,2002
IN,corrections,8453,25989184,10,24256,1022,8458,26013440,2002
IN,highways,4266,10657281,2,1904,130,4267,10659185,2002
IN,water transport and terminals,35,141614,1,593,69,35,142207,2002
IN,public welfare,5132,12226368,42,23320,2974,5150,12249688,2002
IN,health,1717,5657348,13,22894,1149,1724,5680242,2002
IN,hospitals,4766,12048667,45,62716,3946,4790,12111383,2002
IN,social insurance administration,1356,3503629,155,168842,18943,1470,3672471,2002
IN,parks and recreation,125,294493,6,2300,276,127,296793,2002
IN,natural resources,2459,7356775,869,691669,84252,2954,8048444,2002
IN,instructional employees,13358,70013276,12675,19216341,1387046,21249,89229617,2002
IN,other employees,24287,62474449,20848,9543120,1112670,30675,72017569,2002
IN,education - other,1153,3475316,49,30010,2198,1167,3505326,2002
IN,other and unallocable,1701,5061250,51,33381,1697,1712,5094631,2002
IA,total,40778,164700912,23976,29542082,2031834,52325,194242994,2002
IA,financial administration,1236,4501953,80,131557,9926,1292,4633510,2002
IA,other government administration,405,1793008,405,605468,46890,672,2398476,2002
IA,judicial and legal,2152,8673564,192,422362,24042,2289,9095926,2002
IA,police protection - officers,650,2737611,0,0,0,650,2737611,2002
IA,other employees,294,1084189,2,5044,259,296,1089233,2002
IA,corrections,3099,10415381,173,387448,20898,3219,10802829,2002
IA,highways,2562,8772224,1,3945,133,2563,8776169,2002
IA,public welfare,2680,8915359,48,107060,5582,2712,9022419,2002
IA,health,379,1554967,27,39589,2205,392,1594556,2002
IA,hospitals,5683,21578124,2669,4241967,240395,7050,25820091,2002
IA,social insurance administration,314,1071284,3,4078,240,315,1075362,2002
IA,parks and recreation,105,382212,5,5365,602,108,387577,2002
IA,natural resources,1793,6841853,467,500597,51232,2083,7342450,2002
IA,instructional employees,4323,29199966,6631,15973155,760725,8645,45173121,2002
IA,other employees,10942,42041773,12926,6568690,833919,15680,48610463,2002
IA,education - other,1126,4191419,87,98345,6733,1164,4289764,2002
IA,other and unallocable,3035,10946025,260,447412,28053,3195,11393437,2002
KS,total,38372,130092635,17965,13548254,1062086,44408,143640889,2002
KS,financial administration,2176,6202741,49,65583,4742,2202,6268324,2002
KS,other government administration,526,1383032,207,507861,27563,681,1890893,2002
KS,judicial and legal,1999,6653484,143,126842,8105,2046,6780326,2002
KS,police protection - officers,613,2257818,0,0,0,613,2257818,2002
KS,other employees,508,1378892,12,14705,932,513,1393597,2002
KS,corrections,3584,9532246,34,38323,2383,3599,9570569,2002
KS,highways,3583,10346409,157,147160,13470,3660,10493569,2002
KS,public welfare,2701,7444139,168,204487,15682,2790,7648626,2002
KS,health,1036,3386931,19,39088,1397,1044,3426019,2002
KS,hospitals,2275,5756501,380,166585,8106,2321,5923086,2002
KS,social insurance administration,124,323014,8,9438,748,128,332452,2002
KS,parks and recreation,558,1282754,16,7481,569,561,1290235,2002
KS,natural resources,821,2598658,120,89583,8982,873,2688241,2002
KS,instructional employees,4147,25761222,3535,4615457,228981,5449,30376679,2002
KS,other employees,9768,34039162,12735,7125320,712476,13815,41164482,2002
KS,education - other,583,1875831,76,76762,3503,604,1952593,2002
KS,other and unallocable,3370,9869801,306,313579,24447,3509,10183380,2002
KY,total,69961,225254629,24229,18141673,1381526,78139,243396302,2002
KY,financial administration,2956,8994866,232,260512,28354,3127,9255378,2002
KY,other government administration,1111,4815236,579,1257176,53280,1433,6072412,2002
KY,judicial and legal,4184,13833356,832,1331438,112224,4860,15164794,2002
KY,police protection - officers,1024,3774188,2,4812,276,1026,3779000,2002
KY,other employees,1204,3693592,21,30682,2320,1218,3724274,2002
KY,corrections,3733,9458866,131,105216,1800,3744,9564082,2002
KY,highways,5427,16766426,178,114364,7932,5475,16880790,2002
KY,public welfare,7057,19680804,112,143308,12304,7132,19824112,2002
KY,health,2135,6582572,54,100269,5832,2170,6682841,2002
KY,hospitals,5160,15742515,375,1081550,58399,5494,16824065,2002
KY,social insurance administration,1073,3215746,116,157626,12466,1148,3373372,2002
KY,parks and recreation,1544,3270768,129,112536,16858,1645,3383304,2002
KY,natural resources,3359,10047365,941,926131,76669,3816,10973496,2002
KY,instructional employees,7011,37719737,5711,6880328,395846,9325,44600065,2002
KY,other employees,14811,39996569,13526,4523931,529660,17948,44520500,2002
KY,education - other,4144,14419180,1052,956982,56968,4488,15376162,2002
KY,other and unallocable,4028,13242843,238,154812,10338,4090,13397655,2002
LA,total,83849,253854712,26480,16596589,1398990,91795,270451301,2002
LA,financial administration,2377,6927783,370,283434,37123,2588,7211217,2002
LA,other government administration,1353,4184464,394,449357,28807,1516,4633821,2002
LA,judicial and legal,1703,6917113,57,31559,3212,1721,6948672,2002
LA,police protection - officers,1011,3715668,0,0,0,1011,3715668,2002
LA,other employees,640,1121688,3,1853,157,641,1123541,2002
LA,corrections,7723,21745262,406,140450,10804,7784,21885712,2002
LA,highways,5303,14352523,18,14576,2213,5316,14367099,2002
LA,water transport and terminals,385,1299629,7,11018,427,387,1310647,2002
LA,public welfare,5147,13972976,15,16846,551,5150,13989822,2002
LA,health,4050,13207145,149,155135,8844,4100,13362280,2002
LA,hospitals,18825,51788034,1316,1942188,81803,19291,53730222,2002
LA,social insurance administration,947,2628880,110,83052,7273,988,2711932,2002
LA,parks and recreation,1013,2386781,394,238541,31609,1192,2625322,2002
LA,natural resources,4362,13035932,1072,748035,79629,4813,13783967,2002
LA,instructional employees,7926,39166975,5360,5195946,333191,9820,44362921,2002
LA,other employees,15225,39496064,15545,6240615,687244,19129,45736679,2002
LA,education - other,3152,9846713,762,579860,41300,3385,10426573,2002
LA,other and unallocable,2707,8061082,502,464124,44803,2963,8525206,2002
ME,total,19156,64448964,7494,6578681,486657,21923,71027645,2002
ME,financial administration,1151,3496649,60,98619,6880,1190,3595268,2002
ME,other government administration,365,1429894,227,565090,33686,557,1994984,2002
ME,judicial and legal,655,2679806,68,100516,5772,687,2780322,2002
ME,police protection - officers,372,1711752,6,16676,733,376,1728428,2002
ME,other employees,209,570585,3,5559,412,211,576144,2002
ME,corrections,1299,4914950,74,132793,7642,1343,5047743,2002
ME,highways,2592,8247940,89,90126,6958,2632,8338066,2002
ME,water transport and terminals,64,192430,10,10869,974,70,203299,2002
ME,public welfare,2036,5664182,63,90903,6299,2072,5755085,2002
ME,health,1263,4366140,83,197768,10138,1320,4563908,2002
ME,hospitals,630,2225736,63,138326,6575,668,2364062,2002
ME,social insurance administration,479,1523528,35,60427,3682,500,1583955,2002
ME,parks and recreation,145,457211,17,17065,1374,153,474276,2002
ME,natural resources,1175,4026220,267,307397,20665,1293,4333617,2002
ME,instructional employees,26,92866,12,13776,1138,32,106642,2002
ME,other employees,6,12664,32,35397,2929,23,48061,2002
ME,instructional employees,1406,6372169,419,629604,30688,1581,7001773,2002
ME,other employees,3663,11075877,5779,3839788,325385,5512,14915665,2002
ME,education - other,386,1277178,121,120687,7523,429,1397865,2002
ME,liquor stores,60,163161,13,14123,1273,67,177284,2002
ME,other and unallocable,1174,3948026,53,93172,5931,1207,4041198,2002
MD,total,83435,323581514,15170,25916365,1560251,92296,349497879,2002
MD,financial administration,3547,13395153,142,317172,18216,3649,13712325,2002
MD,other government administration,1328,5080339,358,586568,18293,1432,5666907,2002
MD,judicial and legal,3711,12702424,475,833465,67217,4093,13535889,2002
MD,police protection - officers,1600,8179402,0,0,0,1600,8179402,2002
MD,other employees,789,3210690,29,67208,3759,810,3277898,2002
MD,corrections,11548,40904168,370,717879,57590,11875,41622047,2002
MD,highways,4840,18651414,0,0,0,4840,18651414,2002
MD,air transportation,495,2030725,0,0,0,495,2030725,2002
MD,water transport and terminals,299,1182745,0,0,0,299,1182745,2002
MD,public welfare,7363,24341605,170,325604,25727,7509,24667209,2002
MD,health,6164,22730717,897,1686094,124321,6871,24416811,2002
MD,hospitals,5255,17573412,586,802253,57154,5579,18375665,2002
MD,social insurance administration,1058,3864407,149,331699,23265,1190,4196106,2002
MD,parks and recreation,478,1970250,152,193349,22282,605,2163599,2002
MD,natural resources,2111,8625329,101,180433,12865,2184,8805762,2002
MD,transit,2161,8587632,201,263003,23274,2293,8850635,2002
MD,instructional employees,9084,53298071,3613,9200566,345583,11047,62498637,2002
MD,other employees,12027,39280729,6784,8427835,641807,15674,47708564,2002
MD,education - other,1963,7947434,325,668298,43499,2210,8615732,2002
MD,other and unallocable,7614,30024868,818,1314939,75399,8041,31339807,2002
MA,total,85294,344105530,27076,31822495,1707975,95442,375928025,2002
MA,financial administration,4316,18138438,341,883455,35769,4532,19021893,2002
MA,other government administration,2030,6051081,295,1131419,29615,2200,7182500,2002
MA,judicial and legal,8844,34482458,521,1320733,32520,9039,35803191,2002
MA,police protection - officers,5308,26400654,24,38965,1162,5314,26439619,2002
MA,other employees,577,2338302,5,10764,254,578,2349066,2002
MA,corrections,7112,29116673,76,177162,8757,7164,29293835,2002
MA,highways,3948,17071149,194,508248,23923,4085,17579397,2002
MA,air transportation,1112,6130555,158,236817,11954,1180,6367372,2002
MA,water transport and terminals,159,773290,7,9985,735,163,783275,2002
MA,public welfare,6821,27343871,654,1634106,88925,7356,28977977,2002
MA,health,7646,28806789,1277,2509969,121216,8376,31316758,2002
MA,hospitals,7167,21893970,924,1832700,80897,7624,23726670,2002
MA,social insurance administration,1492,5701836,191,394197,23324,1633,6096033,2002
MA,solid waste management,3,16559,0,0,0,3,16559,2002
MA,sewerage,1022,4942693,37,130593,5222,1052,5073286,2002
MA,parks and recreation,956,3168395,34,72451,3150,975,3240846,2002
MA,natural resources,1237,5447538,84,127742,8080,1286,5575280,2002
MA,water transport and terminals,616,2829773,18,55819,2343,630,2885592,2002
MA,instructional employees,49,193470,0,0,0,49,193470,2002
MA,other employees,38,135586,10,4547,170,39,140133,2002
MA,instructional employees,6389,34446243,9061,13152620,602798,9986,47598863,2002
MA,other employees,13534,47131580,12837,6633893,596801,17077,53765473,2002
MA,education - other,1115,4686224,100,261591,10267,1177,4947815,2002
MA,other and unallocable,3803,16858403,228,694719,20093,3924,17553122,2002
MI,total,112125,464587793,66452,70451498,5440126,143038,535039291,2002
MI,financial administration,2510,10315361,999,2260309,144055,3328,12575670,2002
MI,other government administration,1731,6148906,16,55990,1968,1742,6204896,2002
MI,judicial and legal,1970,9599165,48,103500,4824,1997,9702665,2002
MI,police protection - officers,2296,10417634,0,0,0,2296,10417634,2002
MI,other employees,1091,4172890,182,338399,21150,1211,4511289,2002
MI,corrections,18822,69664916,382,1175543,56198,19141,70840459,2002
MI,highways,2757,11318402,383,1096993,62410,3112,12415395,2002
MI,public welfare,11724,43242108,886,2790694,140452,12522,46032802,2002
MI,health,1721,7228386,253,478126,23897,1856,7706512,2002
MI,hospitals,9611,34972158,3465,6742150,460873,12230,41714308,2002
MI,social insurance administration,1077,4123349,138,312212,19899,1190,4435561,2002
MI,parks and recreation,230,863542,169,294549,15617,319,1158091,2002
MI,natural resources,4355,17585333,1203,1584127,122155,5048,19169460,2002
MI,instructional employees,676,1984175,127,173786,12634,748,2157961,2002
MI,other employees,182,463421,90,73150,7240,227,536571,2002
MI,instructional employees,13903,90977516,14386,23180069,1302762,21306,114157585,2002
MI,other employees,30245,111930752,42665,27634187,2927627,46880,139564939,2002
MI,education - other,1400,5905889,327,918210,45323,1658,6824099,2002
MI,other and unallocable,5824,23673890,733,1239504,71042,6227,24913394,2002
MN,total,62702,270725695,30927,32330617,2303419,75793,303056312,2002
MN,financial administration,2451,9848548,127,237405,19426,2562,10085953,2002
MN,other government administration,1239,4722595,172,364253,20670,1357,5086848,2002
MN,judicial and legal,2189,10299422,543,1455277,63600,2551,11754699,2002
MN,police protection - officers,544,2687767,0,0,0,544,2687767,2002
MN,other employees,399,1447887,24,43076,3038,416,1490963,2002
MN,corrections,3684,13415808,131,276230,17278,3782,13692038,2002
MN,highways,5067,21832582,262,359671,26172,5216,22192253,2002
MN,public welfare,1637,6365832,1102,2063251,177736,2646,8429083,2002
MN,health,2022,8855309,228,506765,27227,2177,9362074,2002
MN,hospitals,3383,13699935,1315,2862408,231190,4697,16562343,2002
MN,social insurance administration,1176,4633371,111,224924,12649,1248,4858295,2002
MN,sewerage,706,3405573,18,51456,2285,719,3457029,2002
MN,parks and recreation,534,2094918,154,175438,12137,602,2270356,2002
MN,natural resources,2952,11918295,633,889954,69917,3350,12808249,2002
MN,transit,2265,8865024,523,837479,43374,2511,9702503,2002
MN,instructional employees,10072,50173232,9582,10280374,525142,13053,60453606,2002
MN,other employees,15098,66838388,14338,10160819,969879,20611,76999207,2002
MN,education - other,3770,14925412,1462,1121072,56966,4095,16046484,2002
MN,other and unallocable,3514,14695797,202,420765,24733,3656,15116562,2002
MS,total,50916,143771292,14809,10497151,1068799,56988,154268443,2002
MS,financial administration,1192,3418824,26,11285,1321,1199,3430109,2002
MS,other government administration,459,1553136,76,100707,5481,490,1653843,2002
MS,judicial and legal,616,3080128,83,73650,5000,645,3153778,2002
MS,police protection - officers,671,1964985,0,0,0,671,1964985,2002
MS,other employees,528,1260917,0,0,0,528,1260917,2002
MS,corrections,4182,8623618,40,47538,4493,4208,8671156,2002
MS,highways,3178,7320920,8,11230,1088,3184,7332150,2002
MS,water transport and terminals,62,208069,2,1700,212,63,209769,2002
MS,public welfare,2924,6111756,0,0,0,2924,6111756,2002
MS,health,2963,7797375,87,186999,9940,3020,7984374,2002
MS,hospitals,11450,25536103,567,1292032,73014,11865,26828135,2002
MS,social insurance administration,762,2054089,324,615282,52018,1058,2669371,2002
MS,parks and recreation,306,565431,165,100054,14144,387,665485,2002
MS,natural resources,3042,7688838,807,570070,61446,3389,8258908,2002
MS,instructional employees,5438,28117337,1862,2033519,150158,6291,30150856,2002
MS,other employees,8618,26603300,10657,5317900,681634,12491,31921200,2002
MS,education - other,1495,3911431,43,37468,4233,1519,3948899,2002
MS,liquor stores,123,269657,0,0,0,123,269657,2002
MS,other and unallocable,2907,7685378,62,97717,4617,2933,7783095,2002
MO,total,82509,233078519,24772,18165931,1627645,91760,251244450,2002
MO,financial administration,2526,6859402,300,121833,18085,2629,6981235,2002
MO,other government administration,862,2403638,268,583540,35396,1063,2987178,2002
MO,judicial and legal,3700,12047094,272,440435,21344,3820,12487529,2002
MO,police protection - officers,1130,4078696,0,0,0,1130,4078696,2002
MO,other employees,1033,2465558,77,85360,10184,1091,2550918,2002
MO,corrections,11485,24516208,461,386593,26987,11638,24902801,2002
MO,highways,6176,18432456,341,337014,21876,6300,18769470,2002
MO,public welfare,8159,18338624,605,502324,50640,8447,18840948,2002
MO,health,3439,9159718,197,231384,16381,3532,9391102,2002
MO,hospitals,12302,30546734,1737,2485775,169474,13265,33032509,2002
MO,social insurance administration,661,1783984,17,8000,526,664,1791984,2002
MO,parks and recreation,586,1465630,190,81946,7590,629,1547576,2002
MO,natural resources,2396,7043239,509,444282,49323,2676,7487521,2002
MO,instructional employees,8086,37273324,7346,6695202,483129,10832,43968526,2002
MO,other employees,13100,37445586,11808,5185379,682278,16982,42630965,2002
MO,education - other,2082,5297880,400,4e+05,15516,2170,5697880,2002
MO,other and unallocable,4786,13920748,244,176864,18916,4892,14097612,2002
MT,total,14767,48068811,7828,7497221,532554,17793,55566032,2002
MT,financial administration,939,2551841,91,112405,10037,996,2664246,2002
MT,other government administration,332,1106574,46,41341,3286,350,1147915,2002
MT,judicial and legal,178,808628,79,164989,6350,214,973617,2002
MT,police protection - officers,193,591455,4,10443,441,196,601898,2002
MT,other employees,209,642014,41,28695,3046,226,670709,2002
MT,corrections,881,2439768,30,49040,3418,900,2488808,2002
MT,highways,1948,6481782,200,273296,18332,2052,6755078,2002
MT,public welfare,1388,3845654,227,325116,26804,1540,4170770,2002
MT,health,779,2104377,110,153096,12601,851,2257473,2002
MT,hospitals,500,1287952,109,129067,12635,572,1417019,2002
MT,social insurance administration,681,1978975,38,60823,4264,705,2039798,2002
MT,parks and recreation,59,173440,38,19713,2013,70,193153,2002
MT,natural resources,1241,3860937,269,236288,21681,1365,4097225,2002
MT,instructional employees,1399,8555233,1591,2743990,100332,1968,11299223,2002
MT,other employees,2636,7563221,4757,2880962,286167,4262,10444183,2002
MT,education - other,383,1074307,96,123300,10211,441,1197607,2002
MT,liquor stores,35,103741,6,5730,465,38,109471,2002
MT,other and unallocable,986,2898912,96,138927,10471,1047,3037839,2002
NE,total,28071,83737389,10859,7932755,899346,33184,91670144,2002
NE,financial administration,598,1818487,20,16781,1358,605,1835268,2002
NE,other government administration,285,929597,105,105123,7730,329,1034720,2002
NE,judicial and legal,677,2677178,68,51756,4499,703,2728934,2002
NE,police protection - officers,492,1690810,0,0,0,492,1690810,2002
NE,other employees,221,578528,7,9011,780,226,587539,2002
NE,corrections,2333,6252954,56,65360,5438,2364,6318314,2002
NE,highways,2178,6516834,10,16229,1116,2184,6533063,2002
NE,air transportation,28,100167,1,1107,91,29,101274,2002
NE,public welfare,2730,6306386,127,42567,6758,2769,6348953,2002
NE,health,754,2200199,88,132037,11165,817,2332236,2002
NE,hospitals,4170,10907047,1044,1706917,148878,5016,12613964,2002
NE,social insurance administration,261,777486,8,10259,797,266,787745,2002
NE,parks and recreation,237,617749,143,107125,15917,328,724874,2002
NE,natural resources,1561,4271820,764,579437,76358,1994,4851257,2002
NE,instructional employees,2784,13617431,1161,1311611,82427,3253,14929042,2002
NE,other employees,5953,16629307,6857,3565101,518960,8901,20194408,2002
NE,education - other,560,1853105,50,38139,3997,583,1891244,2002
NE,other and unallocable,2249,5992304,350,174195,13077,2325,6166499,2002
NV,total,21255,78186316,10958,8377847,567012,24471,86564163,2002
NV,financial administration,1148,3749456,41,52550,2038,1159,3802006,2002
NV,other government administration,930,3503251,86,84862,4625,956,3588113,2002
NV,judicial and legal,638,3141451,22,41650,889,643,3183101,2002
NV,police protection - officers,422,2338086,0,0,0,422,2338086,2002
NV,other employees,398,1659874,3,5114,133,399,1664988,2002
NV,corrections,3237,12177086,62,157077,3917,3259,12334163,2002
NV,highways,1672,5859962,4,1514,208,1673,5861476,2002
NV,public welfare,1105,3596692,17,25454,1203,1111,3622146,2002
NV,health,999,3884245,49,99689,3130,1017,3983934,2002
NV,hospitals,978,3802445,128,276183,10067,1035,4078628,2002
NV,social insurance administration,477,1576379,5,9688,387,479,1586067,2002
NV,parks and recreation,178,637944,11,18053,766,182,655997,2002
NV,natural resources,1077,3868998,400,360420,19125,1186,4229418,2002
NV,water transport and terminals,13,61162,0,0,0,13,61162,2002
NV,electric power,13,61162,0,0,0,13,61162,2002
NV,instructional employees,1890,10015930,2069,2930254,150174,2743,12946184,2002
NV,other employees,3974,9953794,7990,4237868,366981,6059,14191662,2002
NV,education - other,116,485480,7,15374,447,119,500854,2002
NV,other and unallocable,1990,7812919,64,62097,2922,2003,7875016,2002
NH,total,17107,57635382,8781,7404340,479116,19995,65039722,2002
NH,financial administration,508,1515296,44,38507,5289,539,1553803,2002
NH,other government administration,304,957817,88,93057,7159,346,1050874,2002
NH,judicial and legal,888,3229188,3,7760,348,890,3236948,2002
NH,police protection - officers,297,1386606,0,0,0,297,1386606,2002
NH,other employees,116,360621,17,16716,1574,125,377337,2002
NH,corrections,1449,4614106,58,87457,6011,1486,4701563,2002
NH,highways,1792,5786114,285,267801,23271,1932,6053915,2002
NH,water transport and terminals,3,9033,4,4457,328,5,13490,2002
NH,public welfare,1380,3950095,79,98439,5272,1412,4048534,2002
NH,health,935,3149352,83,79610,6245,973,3228962,2002
NH,hospitals,777,2211148,75,116257,1822,788,2327405,2002
NH,social insurance administration,369,1016970,50,68849,4096,394,1085819,2002
NH,parks and recreation,76,205698,225,127238,18166,186,332936,2002
NH,natural resources,520,1594160,188,162679,13010,599,1756839,2002
NH,instructional employees,1349,6267899,1754,2531749,57999,1698,8799648,2002
NH,other employees,3884,13725910,5086,3189041,269409,5508,16914951,2002
NH,education - other,325,994653,16,16824,1532,334,1011477,2002
NH,liquor stores,302,866066,378,235242,30965,489,1101308,2002
NH,other and unallocable,1833,5794650,348,262657,26620,1994,6057307,2002
NJ,total,136463,604987282,31996,28774149,1814424,147821,633761431,2002
NJ,financial administration,4987,20115501,445,597468,48655,5301,20712969,2002
NJ,other government administration,1368,6701378,53,62191,5065,1400,6763569,2002
NJ,judicial and legal,14172,61554294,138,211535,17226,14283,61765829,2002
NJ,police protection - officers,1342,4450514,18,28191,2296,1357,4478705,2002
NJ,other employees,2779,17766916,0,0,0,2779,17766916,2002
NJ,corrections,10146,44194743,21,27241,2218,10160,44221984,2002
NJ,highways,6997,30293431,831,787500,70664,7399,31080931,2002
NJ,water transport and terminals,106,409058,9,11529,1023,112,420587,2002
NJ,public welfare,6292,25354805,173,279601,19864,6420,25634406,2002
NJ,health,2777,12567997,57,92235,7510,2825,12660232,2002
NJ,hospitals,15423,52673600,1379,1613183,108063,16111,54286783,2002
NJ,social insurance administration,1386,5417450,267,543787,38267,1633,5961237,2002
NJ,solid waste management,647,3336547,1,664,53,647,3337211,2002
NJ,parks and recreation,1691,6814969,1089,1051633,83707,2174,7866602,2002
NJ,natural resources,2849,12391008,574,762378,29798,3030,13153386,2002
NJ,water transport and terminals,118,459044,3,1191,84,118,460235,2002
NJ,transit,10014,42905407,827,1181455,82034,10480,44086862,2002
NJ,instructional employees,11214,61312080,1692,2392842,126232,12077,63704922,2002
NJ,other employees,7014,19027634,1887,1497478,130616,7901,20525112,2002
NJ,instructional employees,7177,55046496,6394,7854340,263756,8814,62900836,2002
NJ,other employees,17517,74415482,15381,9040151,717685,21968,83455633,2002
NJ,education - other,3579,16318790,649,597408,48705,3893,16916198,2002
NJ,other and unallocable,6868,31460138,108,140148,10903,6939,31600286,2002
NM,total,39654,116986207,15140,14674551,1007278,45508,131660758,2002
NM,financial administration,1775,5564236,54,72066,7090,1815,5636302,2002
NM,other government administration,205,712990,24,43713,2261,219,756703,2002
NM,judicial and legal,2922,9416144,74,114819,7060,2961,9530963,2002
NM,police protection - officers,462,1666296,0,0,0,462,1666296,2002
NM,other employees,171,620158,0,0,0,171,620158,2002
NM,corrections,4010,11784890,82,118473,10293,4068,11903363,2002
NM,highways,2379,6335481,0,0,0,2379,6335481,2002
NM,air transportation,7,25682,0,0,0,7,25682,2002
NM,public welfare,1490,3879070,35,47056,4100,1513,3926126,2002
NM,health,2337,6219955,258,321259,21000,2460,6541214,2002
NM,hospitals,4941,14330924,2246,5253304,254366,6393,19584228,2002
NM,social insurance administration,515,1340637,9,15558,979,520,1356195,2002
NM,parks and recreation,660,1803854,86,142210,10308,718,1946064,2002
NM,natural resources,1664,5070584,161,172931,20094,1779,5243515,2002
NM,instructional employees,3861,13611686,3267,3454922,171094,4866,17066608,2002
NM,other employees,9772,26951927,8561,4710824,473885,12552,31662751,2002
NM,education - other,822,2584615,100,91267,8111,868,2675882,2002
NM,other and unallocable,1661,5067078,183,116149,16637,1757,5183227,2002
NY,total,235522,1020514837,45690,50033564,2865057,252559,1070548401,2002
NY,financial administration,13148,50488214,412,939825,44958,13412,51428039,2002
NY,other government administration,4627,17857109,1112,872792,67140,5009,18729901,2002
NY,judicial and legal,19065,103263248,563,1550194,75212,19493,104813442,2002
NY,police protection - officers,4451,26861773,0,0,0,4451,26861773,2002
NY,other employees,1630,5944466,162,142798,13729,1708,6087264,2002
NY,corrections,35079,148995375,357,884586,41059,35315,149879961,2002
NY,highways,12633,46176683,1053,1003701,87532,13130,47180384,2002
NY,air transportation,128,477573,14,27586,1771,138,505159,2002
NY,water transport and terminals,780,3682526,25,52621,2537,795,3735147,2002
NY,public welfare,6579,24974163,508,997379,56994,6905,25971542,2002
NY,health,9461,43649333,424,1076108,48211,9737,44725441,2002
NY,hospitals,42998,165178669,5232,11146914,522630,46002,176325583,2002
NY,social insurance administration,8496,32662768,113,271038,16749,8592,32933806,2002
NY,parks and recreation,1919,6933154,1381,2032930,169540,2882,8966084,2002
NY,natural resources,3403,14135381,57,123495,7062,3444,14258876,2002
NY,electric power,1609,11101575,55,103286,6550,1646,11204861,2002
NY,transit,15033,79070512,422,479557,42353,15274,79550069,2002
NY,instructional employees,13436,77868884,14795,15486691,720957,17847,93355575,2002
NY,other employees,24749,90983295,18196,11159173,863032,30036,102142468,2002
NY,education - other,4727,19429339,230,438561,23602,4861,19867900,2002
NY,other and unallocable,11571,50780797,579,1244329,53439,11882,52025126,2002
NC,total,119429,393461281,33720,37963653,2737388,134986,431424934,2002
NC,financial administration,4127,11259805,12,28999,1047,4134,11288804,2002
NC,other government administration,722,2797425,386,657563,40676,953,3454988,2002
NC,judicial and legal,5792,20959542,221,219138,10519,5852,21178680,2002
NC,police protection - officers,2372,9231873,0,0,0,2372,9231873,2002
NC,other employees,999,3031679,8,10081,732,1003,3041760,2002
NC,corrections,19898,52498665,627,1334302,72205,20308,53832967,2002
NC,highways,12159,32600151,0,0,0,12159,32600151,2002
NC,water transport and terminals,277,913514,1,280,28,277,913794,2002
NC,public welfare,1898,6291001,6,8610,293,1900,6299611,2002
NC,health,3955,14677093,207,234360,21644,4078,14911453,2002
NC,hospitals,16682,49786516,1510,4016670,200840,17823,53803186,2002
NC,social insurance administration,2415,7718441,236,345311,24974,2557,8063752,2002
NC,solid waste management,241,778430,0,0,0,241,778430,2002
NC,parks and recreation,922,2175804,164,86052,9890,978,2261856,2002
NC,natural resources,3737,10946862,773,1086783,69325,4130,12033645,2002
NC,instructional employees,10632,61818504,10588,17382552,794671,15147,79201056,2002
NC,other employees,25421,81929445,18719,12277686,1473557,33795,94207131,2002
NC,education - other,2819,9084035,103,126103,6008,2853,9210138,2002
NC,other and unallocable,4361,14962496,159,149163,10979,4426,15111659,2002
ND,total,13687,40938501,8115,5550873,520196,16643,46489374,2002
ND,financial administration,627,1699831,90,62281,8336,674,1762112,2002
ND,other government administration,188,492545,135,51880,2238,201,544425,2002
ND,judicial and legal,497,1658537,37,12599,1296,505,1671136,2002
ND,police protection - officers,130,420583,0,0,0,130,420583,2002
ND,other employees,92,227602,3,2171,148,93,229773,2002
ND,corrections,587,1483684,35,27969,2983,603,1511653,2002
ND,highways,926,2651700,32,38073,3149,944,2689773,2002
ND,public welfare,428,1052173,53,27838,2353,441,1080011,2002
ND,health,1225,3437102,234,81964,6184,1260,3519066,2002
ND,hospitals,990,2178393,193,57886,5948,1023,2236279,2002
ND,social insurance administration,384,1050344,57,69900,5800,417,1120244,2002
ND,parks and recreation,101,252258,32,21981,2295,114,274239,2002
ND,natural resources,1002,3249656,591,522569,84965,1485,3772225,2002
ND,instructional employees,1776,8433594,2243,3052845,186905,2838,11486439,2002
ND,other employees,3247,8120845,4202,1387085,196509,4365,9507930,2002
ND,education - other,282,802630,38,23756,1655,292,826386,2002
ND,other and unallocable,1205,3727024,140,110076,9432,1258,3837100,2002
OH,total,112801,410456129,65756,61624254,4469304,138230,472080383,2002
OH,financial administration,7965,33728968,595,872303,59972,8307,34601271,2002
OH,other government administration,782,3011177,140,111101,10268,840,3122278,2002
OH,judicial and legal,2498,10842083,438,1103978,58775,2831,11946061,2002
OH,police protection - officers,1437,6595349,0,0,0,1437,6595349,2002
OH,other employees,1224,3690295,14,26780,1981,1235,3717075,2002
OH,corrections,17143,60851429,67,128771,7381,17185,60980200,2002
OH,highways,6782,26082033,470,588121,45504,7041,26670154,2002
OH,public welfare,2552,10711310,221,250822,27598,2709,10962132,2002
OH,health,3562,15852002,309,369939,27876,3720,16221941,2002
OH,hospitals,9490,26301985,3075,6405829,361701,11545,32707814,2002
OH,social insurance administration,2140,8002965,548,550387,39099,2362,8553352,2002
OH,parks and recreation,584,2033386,236,317616,23991,720,2351002,2002
OH,natural resources,3380,10936715,866,1241233,89206,3887,12177948,2002
OH,instructional employees,15319,81481656,21379,26064622,1253947,22463,107546278,2002
OH,other employees,30795,80308524,36862,22832841,2419289,44554,103141365,2002
OH,education - other,2388,9880815,181,306349,14315,2471,10187164,2002
OH,other and unallocable,4760,20145437,355,453562,28401,4923,20598999,2002
OK,total,58232,180418430,24108,17972472,1423534,66380,198390902,2002
OK,financial administration,1763,5408278,103,142525,8772,1811,5550803,2002
OK,other government administration,866,2922768,157,197033,17723,967,3119801,2002
OK,judicial and legal,2597,9476234,213,244745,16856,2692,9720979,2002
OK,police protection - officers,1005,3630320,0,0,0,1005,3630320,2002
OK,other employees,807,2189655,93,86681,7311,848,2276336,2002
OK,corrections,5927,16536165,269,306653,20310,6042,16842818,2002
OK,highways,2816,8043940,87,89261,6243,2852,8133201,2002
OK,public welfare,5759,15272901,559,551758,51726,6053,15824659,2002
OK,health,5676,16337046,311,428458,27764,5832,16765504,2002
OK,hospitals,2471,6319392,275,311750,28761,2634,6631142,2002
OK,social insurance administration,1229,3620123,162,163679,12962,1303,3783802,2002
OK,solid waste management,72,215377,5,4683,593,75,220060,2002
OK,parks and recreation,842,1971498,411,251552,32509,1027,2223050,2002
OK,natural resources,1840,5214104,953,784357,67203,2221,5998461,2002
OK,electric power,479,2144794,6,9068,752,483,2153862,2002
OK,instructional employees,6141,30526995,5314,6689076,294323,7829,37216071,2002
OK,other employees,13442,37015946,14786,7307004,801502,18048,44322950,2002
OK,education - other,2084,6065271,151,138007,11238,2148,6203278,2002
OK,other and unallocable,2416,7507623,253,266182,16986,2510,7773805,2002
OR,total,47209,164481029,21202,19388022,1430842,55339,183869051,2002
OR,financial administration,3846,13611248,419,560327,43397,4092,14171575,2002
OR,other government administration,1062,3639324,231,389159,20734,1180,4028483,2002
OR,judicial and legal,2813,9901600,453,849538,50178,3099,10751138,2002
OR,police protection - officers,804,2813040,0,0,0,804,2813040,2002
OR,other employees,843,2801177,141,115340,5296,873,2916517,2002
OR,corrections,4751,16344894,194,402424,23304,4883,16747318,2002
OR,highways,3297,11191190,287,561302,38856,3518,11752492,2002
OR,air transportation,17,62062,0,0,0,17,62062,2002
OR,public welfare,5938,18758847,268,748393,28598,6100,19507240,2002
OR,health,2525,8376763,308,584824,28997,2689,8961587,2002
OR,hospitals,3211,9221203,1999,4283041,331945,5097,13504244,2002
OR,social insurance administration,2064,8001178,255,404701,30424,2237,8405879,2002
OR,parks and recreation,408,1203681,24,53476,4224,432,1257157,2002
OR,natural resources,2553,8477059,424,519842,40405,2783,8996901,2002
OR,instructional employees,4693,22357227,5081,4850603,314058,6477,27207830,2002
OR,other employees,5677,18207770,10725,4681548,447330,8219,22889318,2002
OR,education - other,1018,3517480,218,198289,11721,1084,3715769,2002
OR,liquor stores,171,532983,5,5301,350,173,538284,2002
OR,other and unallocable,1518,5462303,170,179914,11025,1582,5642217,2002
PA,total,137616,511551492,55675,56385735,3281571,157121,567937227,2002
PA,financial administration,7009,25120057,649,978278,90312,7554,26098335,2002
PA,other government administration,2987,9439538,1402,2584968,131972,3771,12024506,2002
PA,judicial and legal,2813,14733452,50,114521,7804,2860,14847973,2002
PA,police protection - officers,4470,19709896,0,0,0,4470,19709896,2002
PA,other employees,1167,5154221,3,8958,427,1170,5163179,2002
PA,corrections,16023,54816277,454,898324,70016,16445,55714601,2002
PA,highways,12849,42395826,642,1459570,92547,13398,43855396,2002
PA,air transportation,37,142551,0,0,0,37,142551,2002
PA,water transport and terminals,82,379376,0,0,0,82,379376,2002
PA,public welfare,12549,44196473,231,670144,31339,12738,44866617,2002
PA,health,1538,6006156,15,21946,1318,1547,6028102,2002
PA,hospitals,12861,36764169,849,1281186,58810,13215,38045355,2002
PA,social insurance administration,3674,13323070,558,1198529,79901,4155,14521599,2002
PA,parks and recreation,903,3123872,1344,2525760,182803,2004,5649632,2002
PA,natural resources,6365,24312836,1484,2591177,112698,7035,26904013,2002
PA,instructional employees,13194,87171527,10611,22223802,813104,17918,109395329,2002
PA,other employees,27807,85554374,35702,18388187,1486863,36701,103942561,2002
PA,education - other,3418,12277232,185,347699,23772,3561,12624931,2002
PA,liquor stores,2776,7773686,1087,412842,43381,3037,8186528,2002
PA,other and unallocable,5094,19156903,409,679844,54504,5423,19836747,2002
RI,total,18032,72875691,6480,5258903,342210,20091,78134594,2002
RI,financial administration,838,2995363,7,9110,443,841,3004473,2002
RI,other government administration,640,2113958,253,77083,1939,652,2191041,2002
RI,judicial and legal,1138,4762721,42,67514,2193,1152,4830235,2002
RI,police protection - officers,215,1452827,0,0,0,215,1452827,2002
RI,other employees,84,337423,5,8660,353,86,346083,2002
RI,corrections,1772,7944509,5,7966,217,1773,7952475,2002
RI,highways,884,3418714,8,13846,677,888,3432560,2002
RI,air transportation,164,615809,1,1689,100,165,617498,2002
RI,public welfare,1526,6526531,43,84263,4184,1553,6610794,2002
RI,health,1362,5632666,60,56743,1888,1373,5689409,2002
RI,hospitals,1247,5326479,17,34465,1284,1254,5360944,2002
RI,social insurance administration,516,2058338,21,62185,2245,530,2120523,2002
RI,solid waste management,110,521687,0,0,0,110,521687,2002
RI,sewerage,235,863526,5,10439,476,238,873965,2002
RI,parks and recreation,71,215203,3,3751,430,74,218954,2002
RI,natural resources,534,2220199,28,32569,2531,548,2252768,2002
RI,transit,668,2511460,38,77317,5948,702,2588777,2002
RI,instructional employees,370,1577789,88,87493,6255,406,1665282,2002
RI,other employees,102,310345,64,62227,5641,134,372572,2002
RI,instructional employees,1735,7785741,2543,2779234,135295,2564,10564975,2002
RI,other employees,2171,6871274,3069,1418141,150558,3057,8289415,2002
RI,education - other,506,2331089,124,304104,16840,616,2635193,2002
RI,other and unallocable,1144,4482040,56,60104,2713,1160,4542144,2002
SC,total,71068,210572526,20535,15722193,1222914,78367,226294719,2002
SC,financial administration,2028,6930500,40,71359,3112,2046,7001859,2002
SC,other government administration,577,1958382,492,396789,31965,770,2355171,2002
SC,judicial and legal,679,2798040,7,5916,416,682,2803956,2002
SC,police protection - officers,1386,4451364,0,0,0,1386,4451364,2002
SC,other employees,1725,4101950,12,18300,670,1729,4120250,2002
SC,corrections,8177,20067342,4,7704,238,8179,20075046,2002
SC,highways,4883,12646426,9,12910,490,4886,12659336,2002
SC,water transport and terminals,590,2392858,1,1184,93,591,2394042,2002
SC,public welfare,4989,12458548,21,28694,1094,4995,12487242,2002
SC,health,7101,19724178,177,381947,10224,7161,20106125,2002
SC,hospitals,8107,16981012,226,460002,27649,8266,17441014,2002
SC,social insurance administration,1341,3764680,4,5624,64,1341,3770304,2002
SC,parks and recreation,652,1621221,7,3396,425,654,1624617,2002
SC,natural resources,2118,6118621,161,139849,14923,2208,6258470,2002
SC,electric power,1716,7591950,19,61060,2451,1730,7653010,2002
SC,instructional employees,8317,41259864,8686,8532210,522806,11453,49792074,2002
SC,other employees,12603,33190900,10635,5547253,604604,16202,38738153,2002
SC,education - other,2778,8293232,22,30448,1084,2784,8323680,2002
SC,other and unallocable,1301,4221458,12,17548,606,1304,4239006,2002
SD,total,11504,34948505,4631,2895739,288964,13146,37844244,2002
SD,financial administration,324,980405,16,17759,1522,333,998164,2002
SD,other government administration,310,933831,58,39341,3254,328,973172,2002
SD,judicial and legal,492,1637273,84,84249,7034,532,1721522,2002
SD,police protection - officers,178,614201,0,0,0,178,614201,2002
SD,other employees,97,228124,3,2635,266,99,230759,2002
SD,corrections,773,1939349,52,63354,5333,804,2002703,2002
SD,highways,983,2968454,144,130916,12283,1053,3099370,2002
SD,public welfare,954,2312939,90,115416,10955,1016,2428355,2002
SD,health,559,1681388,95,175043,10246,617,1856431,2002
SD,hospitals,854,2096667,142,181278,15321,941,2277945,2002
SD,social insurance administration,276,627160,4,6609,523,279,633769,2002
SD,parks and recreation,123,306685,20,15757,1758,133,322442,2002
SD,natural resources,735,2125577,325,145669,16473,829,2271246,2002
SD,instructional employees,1307,7199585,1031,1033008,82461,1776,8232593,2002
SD,other employees,2199,5513593,2425,757128,110612,2827,6270721,2002
SD,education - other,369,965334,41,40222,3672,389,1005556,2002
SD,other and unallocable,971,2817940,101,87355,7251,1012,2905295,2002
TN,total,71725,214754531,25709,25494752,2075923,83892,240249283,2002
TN,financial administration,2634,8540383,53,68494,5691,2668,8608877,2002
TN,other government administration,789,2467638,63,75608,4194,814,2543246,2002
TN,judicial and legal,1990,8233437,11,22210,768,1994,8255647,2002
TN,police protection - officers,1192,4302642,0,0,0,1192,4302642,2002
TN,other employees,759,1835874,5,3636,360,761,1839510,2002
TN,corrections,6771,15728516,60,94794,5134,6802,15823310,2002
TN,highways,4485,11225842,5,350,14,4485,11226192,2002
TN,public welfare,5557,14327218,4,2652,266,5559,14329870,2002
TN,health,2936,8559095,126,195335,14182,3019,8754430,2002
TN,hospitals,9067,27572802,356,937518,56549,9389,28510320,2002
TN,social insurance administration,1385,3741590,157,210290,17496,1490,3951880,2002
TN,parks and recreation,913,1721814,87,51996,8218,963,1773810,2002
TN,natural resources,2932,8348581,659,750098,76019,3374,9098679,2002
TN,instructional employees,8797,43619552,7632,9786390,547042,12026,53405942,2002
TN,other employees,16800,41211554,16251,13142312,1328152,24569,54353866,2002
TN,education - other,2076,5894383,169,109007,8816,2128,6003390,2002
TN,other and unallocable,2642,7423610,71,44062,3022,2659,7467672,2002
TX,total,242140,795693116,69728,73635742,4872779,269833,869328858,2002
TX,financial administration,9196,30281174,275,359658,24105,9333,30640832,2002
TX,other government administration,1944,6812293,664,649089,46151,2206,7461382,2002
TX,judicial and legal,5162,20806757,84,172810,9736,5218,20979567,2002
TX,police protection - officers,2049,7841026,0,0,0,2049,7841026,2002
TX,other employees,1666,4486714,28,29022,2240,1679,4515736,2002
TX,corrections,45193,108822993,606,667919,56517,45514,109490912,2002
TX,highways,15333,46437031,533,973924,40605,15564,47410955,2002
TX,public welfare,20874,55096660,157,239782,15454,20962,55336442,2002
TX,health,11938,38163485,841,1513965,82679,12408,39677450,2002
TX,hospitals,29635,89236109,1979,3624184,209627,30827,92860293,2002
TX,social insurance administration,4963,14331278,77,105209,7356,5005,14436487,2002
TX,parks and recreation,964,2363844,181,154623,19587,1075,2518467,2002
TX,natural resources,10584,35562705,3222,4008285,192818,11680,39570990,2002
TX,instructional employees,13,41209,0,0,0,13,41209,2002
TX,instructional employees,20912,133391258,22255,32923682,1544515,29690,166314940,2002
TX,other employees,50386,165124538,37549,26557129,2500424,64591,191681667,2002
TX,education - other,4550,14792956,607,1010295,66525,4929,15803251,2002
TX,other and unallocable,6778,22101086,670,646166,54440,7090,22747252,2002
UT,total,41630,139361728,19362,15688966,1320729,49135,155050694,2002
UT,financial administration,1558,5165181,269,257415,27674,1715,5422596,2002
UT,other government administration,186,893649,91,109134,8827,237,1002783,2002
UT,judicial and legal,1476,5360249,228,357988,18451,1580,5718237,2002
UT,police protection - officers,408,1557987,8,5083,246,409,1563070,2002
UT,other employees,352,1292473,152,234377,10439,411,1526850,2002
UT,corrections,3063,9107879,299,246608,21638,3186,9354487,2002
UT,highways,1778,6403087,71,106489,7899,1823,6509576,2002
UT,public welfare,3090,9380565,370,538462,36604,3299,9919027,2002
UT,health,1797,5910844,267,427305,21737,1921,6338149,2002
UT,hospitals,5517,15230170,458,397285,37876,5732,15627455,2002
UT,social insurance administration,745,2311691,70,99462,6580,782,2411153,2002
UT,parks and recreation,253,791330,71,69508,7572,296,860838,2002
UT,natural resources,1044,3657086,211,218895,15828,1134,3875981,2002
UT,instructional employees,4168,26928764,3009,3316690,168673,5126,30245454,2002
UT,other employees,13150,35123544,12364,8047043,827046,17848,43170587,2002
UT,education - other,1169,3882350,864,798067,62470,1524,4680417,2002
UT,liquor stores,220,530590,258,128904,16756,315,659494,2002
UT,other and unallocable,1656,5834289,302,330251,24413,1797,6164540,2002
VT,total,12711,43779596,2517,2920620,172551,13724,46700216,2002
VT,financial administration,571,1966185,9,17456,1446,579,1983641,2002
VT,other government administration,476,1528432,204,474939,27928,635,2003371,2002
VT,judicial and legal,546,2094565,53,108024,6314,581,2202589,2002
VT,police protection - officers,281,1641816,0,0,0,281,1641816,2002
VT,other employees,88,271007,0,0,0,88,271007,2002
VT,corrections,956,3186677,18,37691,3142,974,3224368,2002
VT,highways,1005,3843004,11,27854,1630,1014,3870858,2002
VT,public welfare,1132,3833823,55,131539,7718,1176,3965362,2002
VT,health,528,1929627,110,246790,12445,599,2176417,2002
VT,hospitals,162,502084,5,12553,642,166,514637,2002
VT,social insurance administration,306,1007140,12,29781,1827,316,1036921,2002
VT,parks and recreation,124,457999,5,13924,660,128,471923,2002
VT,natural resources,525,2044425,65,217275,8393,575,2261700,2002
VT,instructional employees,1224,6713003,417,601877,23250,1364,7314880,2002
VT,other employees,3195,7217131,1369,738297,61287,3564,7955428,2002
VT,education - other,518,1843051,49,82963,5025,548,1926014,2002
VT,liquor stores,54,189111,1,784,73,54,189895,2002
VT,other and unallocable,1020,3510516,134,178873,10771,1082,3689389,2002
VA,total,103593,354087358,47194,42857987,3041197,120885,396945345,2002
VA,financial administration,4059,13890316,741,939808,79542,4511,14830124,2002
VA,other government administration,518,2163120,580,900621,53942,835,3063741,2002
VA,judicial and legal,3387,13453108,461,626768,22962,3518,14079876,2002
VA,police protection - officers,1822,7815254,0,0,0,1822,7815254,2002
VA,other employees,737,2099816,146,147620,7578,780,2247436,2002
VA,corrections,14990,39287458,396,450376,37584,15203,39737834,2002
VA,highways,10314,31450304,421,545882,42794,10557,31996186,2002
VA,water transport and terminals,134,516512,0,0,0,134,516512,2002
VA,public welfare,2070,6815342,173,321284,18950,2177,7136626,2002
VA,health,4786,15958220,577,716534,54010,5093,16674754,2002
VA,hospitals,12749,36109794,1223,2050495,111874,13384,38160289,2002
VA,social insurance administration,1201,3959642,462,688782,58038,1531,4648424,2002
VA,parks and recreation,620,1797812,649,477252,47970,893,2275064,2002
VA,natural resources,3351,10839928,695,594490,57398,3678,11434418,2002
VA,instructional employees,13112,74197265,13306,17395510,823839,17793,91592775,2002
VA,other employees,22806,68114707,25126,14623704,1424565,30902,82738411,2002
VA,education - other,2640,9481536,621,708682,51088,2930,10190218,2002
VA,liquor stores,722,2038494,993,832026,90372,1235,2870520,2002
VA,other and unallocable,3575,14098730,624,838153,58691,3909,14936883,2002
WA,total,95344,360380284,53740,50209621,3359537,114441,410589905,2002
WA,financial administration,2525,9796963,193,376388,20499,2640,10173351,2002
WA,other government administration,1460,5162244,172,152342,10756,1522,5314586,2002
WA,judicial and legal,1800,9065866,192,376088,17360,1899,9441954,2002
WA,police protection - officers,1003,4808624,0,0,0,1003,4808624,2002
WA,other employees,1249,4400494,0,0,0,1249,4400494,2002
WA,corrections,8469,26205658,694,933930,55986,8787,27139588,2002
WA,highways,6571,28781990,663,1036632,65018,6940,29818622,2002
WA,public welfare,8612,31295924,629,1128748,60612,8956,32424672,2002
WA,health,4830,16108145,797,1429970,82175,5297,17538115,2002
WA,hospitals,7847,29579877,2662,6098716,217858,9084,35678593,2002
WA,social insurance administration,3438,13180040,972,1690322,105152,4036,14870362,2002
WA,solid waste management,151,567180,15,53444,1693,161,620624,2002
WA,parks and recreation,586,1821322,128,189975,10160,643,2011297,2002
WA,natural resources,4610,17212894,740,1164241,85468,5097,18377135,2002
WA,instructional employees,10656,50665612,12308,18184398,644387,14318,68850010,2002
WA,other employees,23050,80842776,29792,13701952,1760842,33056,94544728,2002
WA,education - other,2796,10255602,2868,2351692,129770,3540,12607294,2002
WA,liquor stores,508,1531334,546,740786,57514,835,2272120,2002
WA,other and unallocable,5183,19097739,369,599997,34287,5378,19697736,2002
WV,total,33706,95612580,9385,6692320,502873,36732,102304900,2002
WV,financial administration,2264,5465082,42,42096,3816,2286,5507178,2002
WV,other government administration,267,804070,293,756043,22045,406,1560113,2002
WV,judicial and legal,1197,3707853,23,26909,2593,1212,3734762,2002
WV,police protection - officers,609,2272586,0,0,0,609,2272586,2002
WV,other employees,343,690424,11,6060,794,348,696484,2002
WV,corrections,2919,5802228,14,16050,1494,2928,5818278,2002
WV,highways,4974,13532784,17,17276,2391,4988,13550060,2002
WV,air transportation,2,10551,0,0,0,2,10551,2002
WV,water transport and terminals,3,11867,0,0,0,3,11867,2002
WV,public welfare,3209,6972166,0,0,0,3209,6972166,2002
WV,health,692,2340204,0,0,0,692,2340204,2002
WV,hospitals,1639,3257140,66,85888,6620,1677,3343028,2002
WV,social insurance administration,736,1890572,39,38734,4044,760,1929306,2002
WV,solid waste management,12,34212,0,0,0,12,34212,2002
WV,parks and recreation,429,832564,315,160548,26484,579,993112,2002
WV,natural resources,2191,6287324,240,188094,20192,2311,6475418,2002
WV,transit,8,22006,0,0,0,8,22006,2002
WV,instructional employees,3080,15208732,3555,3503547,176560,4144,18712279,2002
WV,other employees,5687,16002266,4477,1615149,217461,6999,17617415,2002
WV,education - other,1337,4025192,203,163484,10594,1402,4188676,2002
WV,liquor stores,59,149900,5,4574,572,62,154474,2002
WV,other and unallocable,2049,6292857,85,67868,7213,2095,6360725,2002
WI,total,55391,220355819,42160,40739643,2740730,70962,261095462,2002
WI,financial administration,2511,9219256,641,927260,65484,2882,10146516,2002
WI,other government administration,987,3825197,306,696910,31652,1168,4522107,2002
WI,judicial and legal,1846,10033325,342,787784,34430,2041,10821109,2002
WI,police protection - officers,616,2509509,0,0,0,616,2509509,2002
WI,other employees,290,953807,29,31231,2604,305,985038,2002
WI,corrections,8475,27227522,938,1871520,100673,9045,29099042,2002
WI,highways,1867,7257864,223,250372,15843,1957,7508236,2002
WI,public welfare,1170,3946497,358,529689,35969,1375,4476186,2002
WI,health,1728,6763204,592,976139,54077,2036,7739343,2002
WI,hospitals,3259,10309034,1413,2063672,119672,3939,12372706,2002
WI,social insurance administration,885,3059525,65,139116,7528,927,3198641,2002
WI,parks and recreation,154,512317,117,144804,9545,208,657121,2002
WI,natural resources,2178,7404959,1012,1361200,88588,2680,8766159,2002
WI,instructional employees,7743,44870780,9171,10374104,605244,11182,55244884,2002
WI,other employees,15172,57766411,25299,18295259,1434299,23322,76061670,2002
WI,education - other,1074,4153495,259,327143,19488,1185,4480638,2002
WI,other and unallocable,5436,20543117,1395,1963440,115634,6094,22506557,2002
WY,total,10083,30978033,3461,2650798,224195,11353,33628831,2002
WY,financial administration,482,1459554,8,14362,693,485,1473916,2002
WY,other government administration,84,295500,188,295673,20797,202,591173,2002
WY,judicial and legal,374,1358271,33,37428,1907,384,1395699,2002
WY,police protection - officers,170,700009,0,0,0,170,700009,2002
WY,other employees,30,103650,0,0,0,30,103650,2002
WY,corrections,953,2502879,5,6450,569,956,2509329,2002
WY,highways,1713,5294111,104,116508,11411,1778,5410619,2002
WY,public welfare,870,2559168,97,126239,10520,930,2685407,2002
WY,health,466,1554233,110,194368,13949,545,1748601,2002
WY,hospitals,895,1897817,11,2108,211,896,1899925,2002
WY,social insurance administration,261,781953,41,69373,3553,281,851326,2002
WY,parks and recreation,86,246648,6,7643,520,89,254291,2002
WY,natural resources,647,2174993,17,18842,1349,655,2193835,2002
WY,instructional employees,767,3670775,803,751996,46999,1034,4422771,2002
WY,other employees,1480,3980752,2006,980250,108917,2099,4961002,2002
WY,education - other,176,541046,4,3814,347,178,544860,2002
WY,liquor stores,29,78363,0,0,0,29,78363,2002
WY,other and unallocable,600,1778311,28,25744,2453,612,1804055,2002
