state,government_function,full_time_employees,full_time_pay,part_time_employees,part_time_pay,part_time_hours,full_time_equivalent_employees,total_march_pay,year
US,total,3646705,13680391896,1396095,1436014745,94613544,4190667,15116406641,2003
US,financial administration,160295,578222268,12589,19500772,1374248,168165,597723040,2003
US,other government administration,47849,180240941,12400,22190295,1184369,54718,202431236,2003
US,judicial and legal,154537,663247065,9514,18706390,922508,159849,681953455,2003
US,police protection - officers,62801,293587107,698,783742,23253,62934,294370849,2003
US,police protection - other,40351,141536703,2083,2166070,147208,41193,143702773,2003
US,corrections,452146,1497479360,11440,21574945,1181499,458899,1519054305,2003
US,highways,238749,849985487,10590,18712956,1097268,245085,868698443,2003
US,air transportation,3103,12812321,197,301426,15827,3193,13113747,2003
US,water transport and terminals,4469,17381024,95,136497,8431,4515,17517521,2003
US,public welfare,223972,701460366,10036,17711043,1128398,230449,719171409,2003
US,health,168796,593038242,14330,24170711,1408915,176868,617208953,2003
US,hospitals,371887,1223418064,56292,109453488,5456817,403005,1332871552,2003
US,social insurance administration,83303,291653409,9495,17492396,1114129,89722,309145805,2003
US,solid waste management,1761,8126967,117,311339,12287,1833,8438306,2003
US,sewerage,1799,8888201,51,164320,6753,1837,9052521,2003
US,parks and recreation,27648,82919964,12752,14579770,1342926,35344,97499734,2003
US,housing and community development,0,0,0,0,0,0,0,2003
US,natural resources,132519,469570914,31940,38142161,2853752,148854,507713075,2003
US,water transport and terminals,656,3087324,23,62914,2717,671,3150238,2003
US,electric power,3829,21498437,75,171725,9022,3880,21670162,2003
US,gas supply,0,0,0,0,0,0,0,2003
US,transit,31287,151859848,2050,3240353,215566,32512,155100201,2003
US,education - elementary and secondary instructional,34446,137400056,9553,8337718,479450,37341,145737774,2003
US,education - elementary and secondary other,13093,32713884,6971,4360913,365343,15337,37074797,2003
US,education - higher education instructional,354399,2065821906,368217,509201666,24257573,494058,2575023572,2003
US,education - higher education other,743935,2529678150,781925,538497696,47338867,1016034,3068175846,2003
US,education - other,88085,311822937,12599,16534547,970824,93665,328357484,2003
US,libraries,482,1387596,240,137426,16004,573,1525022,2003
US,liquor stores,5736,16569201,3223,2579785,257665,7226,19148986,2003
US,other and unallocable,194772,794984154,16600,26791681,1421925,202907,821775835,2003
AL,total,74360,252332276,27761,26592864,1937970,85518,278925140,2003
AL,financial administration,2599,8730321,77,77889,9738,2655,8808210,2003
AL,other government administration,564,2043894,94,110294,6774,603,2154188,2003
AL,judicial and legal,3389,12579899,75,131381,5751,3421,12711280,2003
AL,police protection - officers,614,2613107,0,0,0,614,2613107,2003
AL,police protection - other,585,1635593,0,0,0,585,1635593,2003
AL,corrections,4728,15339754,8,9828,1187,4735,15349582,2003
AL,highways,4053,11428002,76,57936,6731,4091,11485938,2003
AL,air transportation,0,0,0,0,0,0,0,2003
AL,water transport and terminals,403,1205795,1,1000,40,403,1206795,2003
AL,public welfare,3787,10559445,28,40246,2714,3802,10599691,2003
AL,health,5146,15612488,454,440418,58210,5477,16052906,2003
AL,hospitals,11270,33522988,1430,2348971,119663,11950,35871959,2003
AL,social insurance administration,1286,3845738,37,24398,3188,1304,3870136,2003
AL,solid waste management,0,0,0,0,0,0,0,2003
AL,sewerage,0,0,0,0,0,0,0,2003
AL,parks and recreation,551,1258146,280,202853,29809,720,1460999,2003
AL,housing and community development,0,0,0,0,0,0,0,2003
AL,natural resources,2089,6570856,197,185072,26879,2241,6755928,2003
AL,water transport and terminals,0,0,0,0,0,0,0,2003
AL,electric power,0,0,0,0,0,0,0,2003
AL,gas supply,0,0,0,0,0,0,0,2003
AL,transit,0,0,0,0,0,0,0,2003
AL,education - elementary and secondary instructional,0,0,0,0,0,0,0,2003
AL,education - elementary and secondary other,0,0,0,0,0,0,0,2003
AL,education - higher education instructional,8852,51210118,8690,11529212,530254,11927,62739330,2003
AL,education - higher education other,19160,57375060,15674,10891444,1074852,25352,68266504,2003
AL,education - other,2620,8595710,98,76712,7829,2665,8672422,2003
AL,libraries,0,0,0,0,0,0,0,2003
AL,liquor stores,644,1538889,6,9407,762,648,1548296,2003
AL,other and unallocable,2020,6666473,536,455803,53589,2325,7122276,2003
AK,total,22577,92458702,5675,5768768,388829,24837,98227470,2003
AK,financial administration,993,4120532,29,46963,2429,1007,4167495,2003
AK,other government administration,602,2288574,40,49876,2897,620,2338450,2003
AK,judicial and legal,1173,5200231,94,160461,7155,1216,5360692,2003
AK,police protection - officers,255,1507853,0,0,0,255,1507853,2003
AK,police protection - other,195,643921,70,21109,1685,205,665030,2003
AK,corrections,1747,7097696,36,49229,3984,1771,7146925,2003
AK,highways,2964,12831115,29,39583,2807,2981,12870698,2003
AK,air transportation,0,0,0,0,0,0,0,2003
AK,water transport and terminals,0,0,0,0,0,0,0,2003
AK,public welfare,1685,5855379,170,210259,19976,1806,6065638,2003
AK,health,725,3091224,46,79624,3960,749,3170848,2003
AK,hospitals,232,969319,18,32801,2532,247,1002120,2003
AK,social insurance administration,443,1621588,5,7221,374,445,1628809,2003
AK,solid waste management,0,0,0,0,0,0,0,2003
AK,sewerage,0,0,0,0,0,0,0,2003
AK,parks and recreation,83,300561,3,3999,228,84,304560,2003
AK,housing and community development,0,0,0,0,0,0,0,2003
AK,natural resources,2241,8736385,115,162034,9834,2298,8898419,2003
AK,water transport and terminals,0,0,0,0,0,0,0,2003
AK,electric power,0,0,0,0,0,0,0,2003
AK,gas supply,0,0,0,0,0,0,0,2003
AK,transit,0,0,0,0,0,0,0,2003
AK,education - elementary and secondary instructional,1884,7797092,651,580830,46254,2163,8377922,2003
AK,education - elementary and secondary other,834,2110860,604,598211,46122,1112,2709071,2003
AK,education - higher education instructional,938,5821184,1036,1107928,32577,1123,6929112,2003
AK,education - higher education other,2565,9530019,2646,2533237,200810,3706,12063256,2003
AK,education - other,418,1602202,38,23501,1712,428,1625703,2003
AK,libraries,0,0,0,0,0,0,0,2003
AK,liquor stores,0,0,0,0,0,0,0,2003
AK,other and unallocable,2600,11332967,45,61902,3493,2621,11394869,2003
AZ,total,55119,188301079,26315,22424242,1804636,65372,210725321,2003
AZ,financial administration,3643,10915596,32,65992,3049,3659,10981588,2003
AZ,other government administration,585,1994268,166,217331,14478,668,2211599,2003
AZ,judicial and legal,1258,5602067,78,158442,7578,1302,5760509,2003
AZ,police protection - officers,1122,4442309,0,0,0,1122,4442309,2003
AZ,police protection - other,889,3268415,1,1559,122,890,3269974,2003
AZ,corrections,9102,28820196,70,180268,6633,9140,29000464,2003
AZ,highways,2980,9585548,0,0,0,2980,9585548,2003
AZ,air transportation,0,0,0,0,0,0,0,2003
AZ,water transport and terminals,0,0,0,0,0,0,0,2003
AZ,public welfare,5592,14443276,161,176061,16408,5685,14619337,2003
AZ,health,2379,7997730,30,69238,3036,2396,8066968,2003
AZ,hospitals,718,2296155,68,134315,5378,749,2430470,2003
AZ,social insurance administration,1903,4736530,9,11878,903,1908,4748408,2003
AZ,solid waste management,0,0,0,0,0,0,0,2003
AZ,sewerage,0,0,0,0,0,0,0,2003
AZ,parks and recreation,345,962506,163,102818,14526,428,1065324,2003
AZ,housing and community development,0,0,0,0,0,0,0,2003
AZ,natural resources,1913,6943534,849,860653,65979,2288,7804187,2003
AZ,water transport and terminals,0,0,0,0,0,0,0,2003
AZ,electric power,10,51064,0,0,0,10,51064,2003
AZ,gas supply,0,0,0,0,0,0,0,2003
AZ,transit,0,0,0,0,0,0,0,2003
AZ,education - elementary and secondary instructional,0,0,0,0,0,0,0,2003
AZ,education - elementary and secondary other,0,0,0,0,0,0,0,2003
AZ,education - higher education instructional,4953,27973064,6906,8410271,540404,8024,36383335,2003
AZ,education - higher education other,11654,40713144,17140,11345548,1080494,17792,52058692,2003
AZ,education - other,2756,7365533,467,509806,34526,2952,7875339,2003
AZ,libraries,0,0,0,0,0,0,0,2003
AZ,liquor stores,0,0,0,0,0,0,0,2003
AZ,other and unallocable,3317,10190144,175,180062,11122,3379,10370206,2003
AR,total,49343,150067878,14191,9075233,834231,54087,159143111,2003
AR,financial administration,1842,5136641,38,35589,4163,1866,5172230,2003
AR,other government administration,611,2112469,59,126902,8354,659,2239371,2003
AR,judicial and legal,1348,4594121,107,274126,9416,1402,4868247,2003
AR,police protection - officers,517,1697770,0,0,0,517,1697770,2003
AR,police protection - other,537,1363426,4,7483,485,540,1370909,2003
AR,corrections,4231,9927118,7,15150,587,4234,9942268,2003
AR,highways,3751,9927175,46,65074,1683,3761,9992249,2003
AR,air transportation,0,0,0,0,0,0,0,2003
AR,water transport and terminals,0,0,0,0,0,0,0,2003
AR,public welfare,3788,9565916,28,56617,2507,3803,9622533,2003
AR,health,4589,12088145,213,281220,21012,4710,12369365,2003
AR,hospitals,4306,11562225,165,243602,10355,4365,11805827,2003
AR,social insurance administration,945,2898383,269,312760,31611,1124,3211143,2003
AR,solid waste management,0,0,0,0,0,0,0,2003
AR,sewerage,0,0,0,0,0,0,0,2003
AR,parks and recreation,636,1398675,200,126581,20603,753,1525256,2003
AR,housing and community development,0,0,0,0,0,0,0,2003
AR,natural resources,1758,4692827,429,252527,33165,1947,4945354,2003
AR,water transport and terminals,0,0,0,0,0,0,0,2003
AR,electric power,0,0,0,0,0,0,0,2003
AR,gas supply,0,0,0,0,0,0,0,2003
AR,transit,0,0,0,0,0,0,0,2003
AR,education - elementary and secondary instructional,0,0,0,0,0,0,0,2003
AR,education - elementary and secondary other,0,0,0,0,0,0,0,2003
AR,education - higher education instructional,5393,30410233,3730,3376245,227302,6685,33786478,2003
AR,education - higher education other,10323,28423015,7938,3080596,409667,12651,31503611,2003
AR,education - other,2488,7308259,773,592824,35668,2689,7901083,2003
AR,libraries,0,0,0,0,0,0,0,2003
AR,liquor stores,0,0,0,0,0,0,0,2003
AR,other and unallocable,2280,6961480,185,227937,17653,2381,7189417,2003
CA,total,332326,1625783254,149557,200454928,10033931,389345,1826238182,2003
CA,financial administration,20123,79774585,3559,5288727,383935,22304,85063312,2003
CA,other government administration,3865,18549304,392,922071,28361,4035,19471375,2003
CA,judicial and legal,3943,23245183,379,756841,29079,4108,24002024,2003
CA,police protection - officers,7924,50057579,543,533810,11102,7987,50591389,2003
CA,police protection - other,5231,19724329,751,757272,42243,5472,20481601,2003
CA,corrections,48114,222447809,3013,7468633,371195,50223,229916442,2003
CA,highways,21130,116966726,997,3277113,123117,21830,120243839,2003
CA,air transportation,0,0,0,0,0,0,0,2003
CA,water transport and terminals,74,313704,16,17757,942,79,331461,2003
CA,public welfare,3664,15258151,281,630645,29595,3832,15888796,2003
CA,health,11151,52808872,1513,3344396,134544,11916,56153268,2003
CA,hospitals,34285,147365532,8360,18392701,738782,38483,165758233,2003
CA,social insurance administration,17432,69515051,2399,5450158,299046,19131,74965209,2003
CA,solid waste management,389,1924552,63,198169,7372,431,2122721,2003
CA,sewerage,0,0,0,0,0,0,0,2003
CA,parks and recreation,2270,9415779,1563,2404369,178544,3284,11820148,2003
CA,housing and community development,0,0,0,0,0,0,0,2003
CA,natural resources,12068,57080517,3656,5201008,425424,14485,62281525,2003
CA,water transport and terminals,0,0,0,0,0,0,0,2003
CA,electric power,0,0,0,0,0,0,0,2003
CA,gas supply,0,0,0,0,0,0,0,2003
CA,transit,0,0,0,0,0,0,0,2003
CA,education - elementary and secondary instructional,0,0,0,0,0,0,0,2003
CA,education - elementary and secondary other,0,0,0,0,0,0,0,2003
CA,education - higher education instructional,19946,140757725,26376,44320042,1694253,29572,185077767,2003
CA,education - higher education other,80167,367781760,91177,90433271,5130643,109318,458215031,2003
CA,education - other,4339,18365374,588,1055539,52048,4634,19420913,2003
CA,libraries,0,0,0,0,0,0,0,2003
CA,liquor stores,0,0,0,0,0,0,0,2003
CA,other and unallocable,36211,214430722,3931,10002406,353706,38221,224433128,2003
CO,total,50041,220793553,34600,49125097,3056634,67406,269918650,2003
CO,financial administration,2050,8918699,149,220494,12133,2118,9139193,2003
CO,other government administration,422,1501540,137,299477,19570,533,1801017,2003
CO,judicial and legal,2992,13502945,786,1866998,92481,3518,15369943,2003
CO,police protection - officers,760,4421937,7,21769,855,764,4443706,2003
CO,police protection - other,423,1782168,1,2151,80,423,1784319,2003
CO,corrections,6587,25694194,78,215428,10530,6646,25909622,2003
CO,highways,3034,12397063,171,373054,19820,3147,12770117,2003
CO,air transportation,0,0,0,0,0,0,0,2003
CO,water transport and terminals,0,0,0,0,0,0,0,2003
CO,public welfare,1834,7635797,406,752246,39588,2059,8388043,2003
CO,health,1061,5306838,149,387238,16276,1154,5694076,2003
CO,hospitals,3201,11190945,793,1467596,73505,3619,12658541,2003
CO,social insurance administration,894,3832031,91,148424,9104,946,3980455,2003
CO,solid waste management,0,0,0,0,0,0,0,2003
CO,sewerage,0,0,0,0,0,0,0,2003
CO,parks and recreation,241,1055008,83,62412,3979,264,1117420,2003
CO,housing and community development,0,0,0,0,0,0,0,2003
CO,natural resources,1301,6095905,256,421497,18412,1405,6517402,2003
CO,water transport and terminals,0,0,0,0,0,0,0,2003
CO,electric power,0,0,0,0,0,0,0,2003
CO,gas supply,0,0,0,0,0,0,0,2003
CO,transit,0,0,0,0,0,0,0,2003
CO,education - elementary and secondary instructional,0,0,0,0,0,0,0,2003
CO,education - elementary and secondary other,0,0,0,0,0,0,0,2003
CO,education - higher education instructional,9887,57441080,9040,14276486,792793,14392,71717566,2003
CO,education - higher education other,12888,49178959,21785,27546541,1891897,23636,76725500,2003
CO,education - other,1043,4204529,563,888018,46796,1309,5092547,2003
CO,libraries,0,0,0,0,0,0,0,2003
CO,liquor stores,0,0,0,0,0,0,0,2003
CO,other and unallocable,1423,6633915,105,175268,8815,1473,6809183,2003
CT,total,53825,241598941,16954,22825872,1037106,59967,264424813,2003
CT,financial administration,2432,9813745,75,192253,8492,2481,10005998,2003
CT,other government administration,996,4226716,232,836618,34561,1191,5063334,2003
CT,judicial and legal,4503,16635422,168,415512,7815,4547,17050934,2003
CT,police protection - officers,1267,6565478,0,0,0,1267,6565478,2003
CT,police protection - other,477,1914641,29,54540,2967,494,1969181,2003
CT,corrections,7466,30214575,85,260080,9369,7520,30474655,2003
CT,highways,3628,15298877,0,0,0,3628,15298877,2003
CT,air transportation,34,196716,0,0,0,34,196716,2003
CT,water transport and terminals,0,0,0,0,0,0,0,2003
CT,public welfare,4265,17920928,214,607017,25689,4411,18527945,2003
CT,health,2097,9127910,93,265267,9725,2152,9393177,2003
CT,hospitals,9127,44237719,2056,5068027,212951,10337,49305746,2003
CT,social insurance administration,818,3390969,34,117419,4049,841,3508388,2003
CT,solid waste management,50,244291,8,20229,932,56,264520,2003
CT,sewerage,0,0,0,0,0,0,0,2003
CT,parks and recreation,141,529232,5,12292,753,145,541524,2003
CT,housing and community development,0,0,0,0,0,0,0,2003
CT,natural resources,529,2196777,52,69807,2041,541,2266584,2003
CT,water transport and terminals,0,0,0,0,0,0,0,2003
CT,electric power,0,0,0,0,0,0,0,2003
CT,gas supply,0,0,0,0,0,0,0,2003
CT,transit,0,0,0,0,0,0,0,2003
CT,education - elementary and secondary instructional,0,0,0,0,0,0,0,2003
CT,education - elementary and secondary other,0,0,0,0,0,0,0,2003
CT,education - higher education instructional,3888,26262066,6121,9072283,348398,5983,35334349,2003
CT,education - higher education other,7226,32305429,7339,4951493,323168,9193,37256922,2003
CT,education - other,2729,11369080,268,573839,29931,2899,11942919,2003
CT,libraries,0,0,0,0,0,0,0,2003
CT,liquor stores,0,0,0,0,0,0,0,2003
CT,other and unallocable,2152,9148370,175,309196,16265,2247,9457566,2003
DE,total,21509,77263238,7878,7763905,487794,24455,85027143,2003
DE,financial administration,672,2270357,68,31775,3057,691,2302132,2003
DE,other government administration,233,852458,116,216310,9610,288,1068768,2003
DE,judicial and legal,1468,4917499,21,34198,1748,1477,4951697,2003
DE,police protection - officers,616,3019633,0,0,0,616,3019633,2003
DE,police protection - other,296,882723,6,10882,709,301,893605,2003
DE,corrections,2759,8893824,86,58231,5237,2789,8952055,2003
DE,highways,1585,4706433,32,46937,3325,1605,4753370,2003
DE,air transportation,0,0,0,0,0,0,0,2003
DE,water transport and terminals,251,871800,0,0,0,251,871800,2003
DE,public welfare,1504,4625181,157,215969,15884,1600,4841150,2003
DE,health,1844,6563138,211,324974,21009,1971,6888112,2003
DE,hospitals,1709,5099769,223,379978,21717,1840,5479747,2003
DE,social insurance administration,298,848046,14,25200,1807,309,873246,2003
DE,solid waste management,99,298928,13,9500,981,105,308428,2003
DE,sewerage,0,0,0,0,0,0,0,2003
DE,parks and recreation,168,458708,115,97214,10030,229,555922,2003
DE,housing and community development,0,0,0,0,0,0,0,2003
DE,natural resources,410,1404503,125,92926,8730,463,1497429,2003
DE,water transport and terminals,0,0,0,0,0,0,0,2003
DE,electric power,0,0,0,0,0,0,0,2003
DE,gas supply,0,0,0,0,0,0,0,2003
DE,transit,578,2088114,38,75477,6007,612,2163591,2003
DE,education - elementary and secondary instructional,0,0,0,0,0,0,0,2003
DE,education - elementary and secondary other,0,0,0,0,0,0,0,2003
DE,education - higher education instructional,1572,9704786,2810,3565667,179409,2654,13270453,2003
DE,education - higher education other,3652,13038960,3669,2396113,182701,4761,15435073,2003
DE,education - other,358,1592136,13,32035,1687,369,1624171,2003
DE,libraries,0,0,0,0,0,0,0,2003
DE,liquor stores,0,0,0,0,0,0,0,2003
DE,other and unallocable,1437,5126242,161,150519,14146,1524,5276761,2003
FL,total,169974,560633924,41484,43665736,2971442,186861,604299660,2003
FL,financial administration,6588,22110116,213,175650,23036,6719,22285766,2003
FL,other government administration,2068,7653949,37,48963,2941,2084,7702912,2003
FL,judicial and legal,17974,65521158,421,818660,38758,18196,66339818,2003
FL,police protection - officers,2075,7260175,0,0,0,2075,7260175,2003
FL,police protection - other,2277,7578996,27,28651,2329,2290,7607647,2003
FL,corrections,26570,72989965,28,45281,2565,26585,73035246,2003
FL,highways,8362,28423572,34,42159,3066,8379,28465731,2003
FL,air transportation,0,0,0,0,0,0,0,2003
FL,water transport and terminals,0,0,6,5125,240,1,5125,2003
FL,public welfare,13205,34529843,98,128440,8101,13251,34658283,2003
FL,health,20401,58176931,1186,2122220,166923,21350,60299151,2003
FL,hospitals,4882,13432614,39,63737,3103,4900,13496351,2003
FL,social insurance administration,2810,7650989,28,41706,2573,2825,7692695,2003
FL,solid waste management,0,0,0,0,0,0,0,2003
FL,sewerage,0,0,0,0,0,0,0,2003
FL,parks and recreation,1420,2863809,46,29422,4345,1445,2893231,2003
FL,housing and community development,0,0,0,0,0,0,0,2003
FL,natural resources,9655,26738326,2100,1853660,134699,10421,28591986,2003
FL,water transport and terminals,0,0,0,0,0,0,0,2003
FL,electric power,0,0,0,0,0,0,0,2003
FL,gas supply,0,0,0,0,0,0,0,2003
FL,transit,560,2007071,33,33875,3520,580,2040946,2003
FL,education - elementary and secondary instructional,0,0,0,0,0,0,0,2003
FL,education - elementary and secondary other,0,0,0,0,0,0,0,2003
FL,education - higher education instructional,14541,95885785,17026,21141255,1065701,20596,117027040,2003
FL,education - higher education other,25157,74913276,19868,16783903,1485903,33600,91697179,2003
FL,education - other,3476,9525197,48,47322,3748,3498,9572519,2003
FL,libraries,0,0,0,0,0,0,0,2003
FL,liquor stores,0,0,0,0,0,0,0,2003
FL,other and unallocable,7953,23372152,246,255707,19891,8066,23627859,2003
GA,total,107390,350248105,37614,33375792,2439575,121255,383623897,2003
GA,financial administration,4643,15628984,37,52154,1896,4654,15681138,2003
GA,other government administration,758,2657132,605,1210645,69575,1153,3867777,2003
GA,judicial and legal,2513,11273847,30,53358,1508,2522,11327205,2003
GA,police protection - officers,1222,4229191,0,0,0,1222,4229191,2003
GA,police protection - other,1084,3326533,19,20306,1860,1095,3346839,2003
GA,corrections,19182,48055794,558,867162,54912,19494,48922956,2003
GA,highways,6052,16249102,28,15240,692,6056,16264342,2003
GA,air transportation,0,0,0,0,0,0,0,2003
GA,water transport and terminals,610,2277290,0,0,0,610,2277290,2003
GA,public welfare,8794,23261734,135,198706,13932,8873,23460440,2003
GA,health,4503,14420973,229,257925,24448,4641,14678898,2003
GA,hospitals,8067,20053706,146,282482,14215,8147,20336188,2003
GA,social insurance administration,2236,6499692,31,16904,1596,2245,6516596,2003
GA,solid waste management,0,0,0,0,0,0,0,2003
GA,sewerage,0,0,0,0,0,0,0,2003
GA,parks and recreation,1283,3022245,2587,2973502,313977,3067,5995747,2003
GA,housing and community development,0,0,0,0,0,0,0,2003
GA,natural resources,4212,12639794,918,790903,70826,4617,13430697,2003
GA,water transport and terminals,0,0,0,0,0,0,0,2003
GA,electric power,0,0,0,0,0,0,0,2003
GA,gas supply,0,0,0,0,0,0,0,2003
GA,transit,0,0,0,0,0,0,0,2003
GA,education - elementary and secondary instructional,0,0,0,0,0,0,0,2003
GA,education - elementary and secondary other,0,0,0,0,0,0,0,2003
GA,education - higher education instructional,12067,68346789,13387,13790378,672049,15890,82137167,2003
GA,education - higher education other,24001,77755778,18388,11924093,1148643,30526,89679871,2003
GA,education - other,2834,9811086,349,797688,38715,3054,10608774,2003
GA,libraries,0,0,0,0,0,0,0,2003
GA,liquor stores,0,0,0,0,0,0,0,2003
GA,other and unallocable,3329,10738435,167,124346,10731,3389,10862781,2003
HI,total,51642,170208366,19573,16471214,1023437,57458,186679580,2003
HI,financial administration,645,2248896,5,2378,388,647,2251274,2003
HI,other government administration,480,1788430,83,217088,8495,528,2005518,2003
HI,judicial and legal,2254,8398168,59,86540,2924,2270,8484708,2003
HI,police protection - officers,0,0,0,0,0,0,0,2003
HI,police protection - other,0,0,0,0,0,0,0,2003
HI,corrections,2400,8193576,22,54930,1780,2410,8248506,2003
HI,highways,867,3147056,18,14948,1342,875,3162004,2003
HI,air transportation,1051,3036788,20,20412,1562,1060,3057200,2003
HI,water transport and terminals,216,694542,1,642,76,216,695184,2003
HI,public welfare,808,2669630,23,35638,3448,828,2705268,2003
HI,health,2406,8322368,96,162604,7204,2447,8484972,2003
HI,hospitals,3776,12054860,430,880970,37028,3988,12935830,2003
HI,social insurance administration,421,1218782,32,61090,3216,439,1279872,2003
HI,solid waste management,0,0,0,0,0,0,0,2003
HI,sewerage,0,0,0,0,0,0,0,2003
HI,parks and recreation,134,398282,160,95458,15896,224,493740,2003
HI,housing and community development,0,0,0,0,0,0,0,2003
HI,natural resources,1027,3961014,297,230150,17247,1125,4191164,2003
HI,water transport and terminals,0,0,0,0,0,0,0,2003
HI,electric power,0,0,0,0,0,0,0,2003
HI,gas supply,0,0,0,0,0,0,0,2003
HI,transit,0,0,0,0,0,0,0,2003
HI,education - elementary and secondary instructional,20100,62061806,6982,5026212,278644,21683,67088018,2003
HI,education - elementary and secondary other,4854,12470240,4262,2031362,169564,5817,14501602,2003
HI,education - higher education instructional,2110,11142998,1510,2573932,91168,2628,13716930,2003
HI,education - higher education other,3837,14051094,5218,4753952,360285,5884,18805046,2003
HI,education - other,140,482882,2,3804,160,141,486686,2003
HI,libraries,482,1387596,240,137426,16004,573,1525022,2003
HI,liquor stores,0,0,0,0,0,0,0,2003
HI,other and unallocable,3634,12479358,113,81678,7006,3675,12561036,2003
ID,total,17732,58102630,11736,10869650,938964,23320,68972280,2003
ID,financial administration,1311,4229057,193,180039,19773,1422,4409096,2003
ID,other government administration,146,547293,253,431074,23124,276,978367,2003
ID,judicial and legal,436,2017266,13,20384,1187,442,2037650,2003
ID,police protection - officers,258,1067830,0,0,0,258,1067830,2003
ID,police protection - other,183,528608,48,46720,4003,206,575328,2003
ID,corrections,1673,4587402,47,70472,5340,1703,4657874,2003
ID,highways,1623,4959749,140,207582,21839,1747,5167331,2003
ID,air transportation,0,0,0,0,0,0,0,2003
ID,water transport and terminals,0,0,0,0,0,0,0,2003
ID,public welfare,1556,4709636,161,209463,20749,1674,4919099,2003
ID,health,975,3318702,154,204299,11558,1042,3523001,2003
ID,hospitals,823,2169875,268,158633,15345,910,2328508,2003
ID,social insurance administration,518,1790610,233,219264,33363,707,2009874,2003
ID,solid waste management,0,0,0,0,0,0,0,2003
ID,sewerage,0,0,0,0,0,0,0,2003
ID,parks and recreation,160,463308,55,48473,5300,190,511781,2003
ID,housing and community development,0,0,0,0,0,0,0,2003
ID,natural resources,1512,5148344,715,1046366,83122,2010,6194710,2003
ID,water transport and terminals,0,0,0,0,0,0,0,2003
ID,electric power,0,0,0,0,0,0,0,2003
ID,gas supply,0,0,0,0,0,0,0,2003
ID,transit,0,0,0,0,0,0,0,2003
ID,education - elementary and secondary instructional,0,0,0,0,0,0,0,2003
ID,education - elementary and secondary other,0,0,0,0,0,0,0,2003
ID,education - higher education instructional,1986,8814348,2195,2675621,165595,2989,11489969,2003
ID,education - higher education other,3231,9431303,6747,4910683,486009,6162,14341986,2003
ID,education - other,408,1344755,167,199636,21116,527,1544391,2003
ID,libraries,0,0,0,0,0,0,0,2003
ID,liquor stores,109,313580,112,88606,9680,164,402186,2003
ID,other and unallocable,824,2660964,235,152335,11861,891,2813299,2003
IL,total,113387,444621027,47983,41048639,3496919,133916,485669666,2003
IL,financial administration,5254,18225755,227,308245,23984,5392,18534000,2003
IL,other government administration,1941,8529745,27,42170,1765,1951,8571915,2003
IL,judicial and legal,3049,19021089,65,119940,3918,3072,19141029,2003
IL,police protection - officers,2325,11672984,1,1186,110,2326,11674170,2003
IL,police protection - other,1856,7458664,35,36406,1406,1864,7495070,2003
IL,corrections,13862,52289914,15,40030,1354,13870,52329944,2003
IL,highways,7306,31469565,1188,3004152,141788,8159,34473717,2003
IL,air transportation,0,0,0,0,0,0,0,2003
IL,water transport and terminals,79,371052,3,6010,316,81,377062,2003
IL,public welfare,10704,39972776,131,244496,10428,10766,40217272,2003
IL,health,2788,11929386,53,136490,5256,2819,12065876,2003
IL,hospitals,11857,39886428,640,1333091,65360,12251,41219519,2003
IL,social insurance administration,1932,8024480,508,1343863,67409,2338,9368343,2003
IL,solid waste management,0,0,0,0,0,0,0,2003
IL,sewerage,0,0,0,0,0,0,0,2003
IL,parks and recreation,614,2147812,81,165346,10142,675,2313158,2003
IL,housing and community development,0,0,0,0,0,0,0,2003
IL,natural resources,2882,11142900,1219,1436786,190027,3965,12579686,2003
IL,water transport and terminals,0,0,0,0,0,0,0,2003
IL,electric power,0,0,0,0,0,0,0,2003
IL,gas supply,0,0,0,0,0,0,0,2003
IL,transit,0,0,0,0,0,0,0,2003
IL,education - elementary and secondary instructional,0,0,0,0,0,0,0,2003
IL,education - elementary and secondary other,0,0,0,0,0,0,0,2003
IL,education - higher education instructional,12241,62297522,14763,15715904,651296,16115,78013426,2003
IL,education - higher education other,25461,83836509,28749,16641899,2297480,38887,100478408,2003
IL,education - other,2310,8688291,83,252265,11641,2381,8940556,2003
IL,libraries,0,0,0,0,0,0,0,2003
IL,liquor stores,0,0,0,0,0,0,0,2003
IL,other and unallocable,6926,27656155,195,220360,13239,7004,27876515,2003
IN,total,75606,246117725,34975,31364166,2650760,90788,277481891,2003
IN,financial administration,2581,7554477,165,194410,12831,2658,7748887,2003
IN,other government administration,508,1478489,170,202481,9625,565,1680970,2003
IN,judicial and legal,1223,6210169,42,65745,4340,1249,6275914,2003
IN,police protection - officers,1205,5090776,0,0,0,1205,5090776,2003
IN,police protection - other,794,2068287,0,0,0,794,2068287,2003
IN,corrections,8192,21531475,4,6850,326,8193,21538325,2003
IN,highways,4271,11143312,0,0,0,4271,11143312,2003
IN,air transportation,0,0,0,0,0,0,0,2003
IN,water transport and terminals,33,140410,1,784,77,33,141194,2003
IN,public welfare,5458,13562771,58,48732,4760,5487,13611503,2003
IN,health,1703,5577456,9,8515,474,1706,5585971,2003
IN,hospitals,4269,10675976,111,115191,9616,4328,10791167,2003
IN,social insurance administration,1338,3590313,211,209925,16291,1436,3800238,2003
IN,solid waste management,0,0,0,0,0,0,0,2003
IN,sewerage,0,0,0,0,0,0,0,2003
IN,parks and recreation,92,248635,3,432,53,92,249067,2003
IN,housing and community development,0,0,0,0,0,0,0,2003
IN,natural resources,2368,7502683,735,570299,58275,2709,8072982,2003
IN,water transport and terminals,0,0,0,0,0,0,0,2003
IN,electric power,0,0,0,0,0,0,0,2003
IN,gas supply,0,0,0,0,0,0,0,2003
IN,transit,0,0,0,0,0,0,0,2003
IN,education - elementary and secondary instructional,0,0,0,0,0,0,0,2003
IN,education - elementary and secondary other,0,0,0,0,0,0,0,2003
IN,education - higher education instructional,13633,72686205,12455,19864256,1375113,21457,92550461,2003
IN,education - higher education other,25116,68465750,20805,9946390,1146324,31708,78412140,2003
IN,education - other,1138,3542990,139,71906,7099,1181,3614896,2003
IN,libraries,0,0,0,0,0,0,0,2003
IN,liquor stores,0,0,0,0,0,0,0,2003
IN,other and unallocable,1684,5047551,67,58250,5556,1716,5105801,2003
IA,total,40978,173016711,24454,31184971,2078399,52795,204201682,2003
IA,financial administration,1200,4694124,78,131028,10492,1260,4825152,2003
IA,other government administration,397,1868024,413,602023,46314,661,2470047,2003
IA,judicial and legal,2117,8836253,189,468343,24352,2255,9304596,2003
IA,police protection - officers,611,2893043,0,0,0,611,2893043,2003
IA,police protection - other,289,1114601,6,3042,197,291,1117643,2003
IA,corrections,3086,11058571,167,364791,18856,3195,11423362,2003
IA,highways,2531,9243474,1,4227,133,2532,9247701,2003
IA,air transportation,0,0,0,0,0,0,0,2003
IA,water transport and terminals,0,0,0,0,0,0,0,2003
IA,public welfare,2596,8988001,58,118683,6364,2633,9106684,2003
IA,health,396,1705810,38,45553,2681,411,1751363,2003
IA,hospitals,5676,23076281,2768,5247902,248811,7089,28324183,2003
IA,social insurance administration,758,2360490,4,4786,278,760,2365276,2003
IA,solid waste management,0,0,0,0,0,0,0,2003
IA,sewerage,0,0,0,0,0,0,0,2003
IA,parks and recreation,104,393065,7,7043,797,109,400108,2003
IA,housing and community development,0,0,0,0,0,0,0,2003
IA,natural resources,1689,6621213,482,371259,36438,1896,6992472,2003
IA,water transport and terminals,0,0,0,0,0,0,0,2003
IA,electric power,0,0,0,0,0,0,0,2003
IA,gas supply,0,0,0,0,0,0,0,2003
IA,transit,0,0,0,0,0,0,0,2003
IA,education - elementary and secondary instructional,0,0,0,0,0,0,0,2003
IA,education - elementary and secondary other,0,0,0,0,0,0,0,2003
IA,education - higher education instructional,3786,29052987,6894,15026172,791194,8282,44079159,2003
IA,education - higher education other,11632,45521482,12940,8128011,852038,16473,53649493,2003
IA,education - other,1100,4270126,81,118813,7133,1142,4388939,2003
IA,libraries,0,0,0,0,0,0,0,2003
IA,liquor stores,0,0,0,0,0,0,0,2003
IA,other and unallocable,3010,11319166,328,543295,32321,3195,11862461,2003
KS,total,37870,129229275,18000,13820435,1061922,43908,143049710,2003
KS,financial administration,2047,5839803,71,117288,9211,2101,5957091,2003
KS,other government administration,517,1371899,188,491641,25948,665,1863540,2003
KS,judicial and legal,2022,6645775,184,154183,10566,2083,6799958,2003
KS,police protection - officers,583,2167812,0,0,0,583,2167812,2003
KS,police protection - other,497,1353380,12,12987,857,501,1366367,2003
KS,corrections,3507,9227120,26,30753,1916,3520,9257873,2003
KS,highways,3555,10241656,159,150414,13463,3632,10392070,2003
KS,air transportation,0,0,0,0,0,0,0,2003
KS,water transport and terminals,0,0,0,0,0,0,0,2003
KS,public welfare,2569,7244649,143,189080,14246,2650,7433729,2003
KS,health,1019,3376413,35,43113,2037,1031,3419526,2003
KS,hospitals,2212,5524472,371,166609,8193,2258,5691081,2003
KS,social insurance administration,118,310288,7,9139,714,122,319427,2003
KS,solid waste management,0,0,0,0,0,0,0,2003
KS,sewerage,0,0,0,0,0,0,0,2003
KS,parks and recreation,547,1278483,11,6215,713,551,1284698,2003
KS,housing and community development,0,0,0,0,0,0,0,2003
KS,natural resources,814,2599754,121,89053,8934,866,2688807,2003
KS,water transport and terminals,0,0,0,0,0,0,0,2003
KS,electric power,0,0,0,0,0,0,0,2003
KS,gas supply,0,0,0,0,0,0,0,2003
KS,transit,0,0,0,0,0,0,0,2003
KS,education - elementary and secondary instructional,0,0,0,0,0,0,0,2003
KS,education - elementary and secondary other,0,0,0,0,0,0,0,2003
KS,education - higher education instructional,4160,26120489,3591,4732493,231812,5478,30852982,2003
KS,education - higher education other,9684,34030995,12725,7333731,713337,13737,41364726,2003
KS,education - other,571,1884357,70,79476,3535,590,1963833,2003
KS,libraries,0,0,0,0,0,0,0,2003
KS,liquor stores,0,0,0,0,0,0,0,2003
KS,other and unallocable,3448,10011930,286,214260,16440,3540,10226190,2003
KY,total,70162,231430301,24304,19535771,1464385,78828,250966072,2003
KY,financial administration,2886,9080624,238,251492,26798,3047,9332116,2003
KY,other government administration,1057,4722366,501,1063888,46020,1336,5786254,2003
KY,judicial and legal,4258,14390926,842,1357848,110160,4922,15748774,2003
KY,police protection - officers,967,3600110,2,4710,266,969,3604820,2003
KY,police protection - other,1222,3754718,18,31506,2096,1234,3786224,2003
KY,corrections,3766,9714978,135,115926,1974,3778,9830904,2003
KY,highways,5361,16283344,171,307574,16080,5458,16590918,2003
KY,air transportation,0,0,0,0,0,0,0,2003
KY,water transport and terminals,0,0,0,0,0,0,0,2003
KY,public welfare,6908,19660926,151,193428,15040,6999,19854354,2003
KY,health,2017,6546990,61,67348,3690,2040,6614338,2003
KY,hospitals,5289,16327110,464,1151837,63502,5656,17478947,2003
KY,social insurance administration,1094,3293262,117,179006,13442,1175,3472268,2003
KY,solid waste management,0,0,0,0,0,0,0,2003
KY,sewerage,0,0,0,0,0,0,0,2003
KY,parks and recreation,1509,3235290,137,110268,15622,1603,3345558,2003
KY,housing and community development,0,0,0,0,0,0,0,2003
KY,natural resources,3353,10063403,874,857065,86612,3859,10920468,2003
KY,water transport and terminals,0,0,0,0,0,0,0,2003
KY,electric power,0,0,0,0,0,0,0,2003
KY,gas supply,0,0,0,0,0,0,0,2003
KY,transit,0,0,0,0,0,0,0,2003
KY,education - elementary and secondary instructional,0,0,0,0,0,0,0,2003
KY,education - elementary and secondary other,0,0,0,0,0,0,0,2003
KY,education - higher education instructional,7222,40454593,5994,7237581,417330,9690,47692174,2003
KY,education - higher education other,15188,42561772,13312,5454443,577387,18588,48016215,2003
KY,education - other,4053,14100684,1076,1003606,59006,4408,15104290,2003
KY,libraries,0,0,0,0,0,0,0,2003
KY,liquor stores,0,0,0,0,0,0,0,2003
KY,other and unallocable,4012,13639205,211,148245,9360,4066,13787450,2003
LA,total,82111,260405652,26332,17819009,1421078,90189,278224661,2003
LA,financial administration,2356,7077519,374,288601,37407,2568,7366120,2003
LA,other government administration,1338,4326267,376,449739,30514,1512,4776006,2003
LA,judicial and legal,1715,7366444,53,33736,2931,1732,7400180,2003
LA,police protection - officers,1011,3771403,0,0,0,1011,3771403,2003
LA,police protection - other,640,1152759,3,1275,97,641,1154034,2003
LA,corrections,7855,22265917,488,432173,32754,8041,22698090,2003
LA,highways,5396,15548530,13,12285,1787,5407,15560815,2003
LA,air transportation,0,0,0,0,0,0,0,2003
LA,water transport and terminals,383,1341321,6,9734,598,386,1351055,2003
LA,public welfare,5227,14446971,33,65373,2108,5239,14512344,2003
LA,health,3680,12118716,143,98745,6594,3717,12217461,2003
LA,hospitals,17240,48940229,1294,2217588,84801,17722,51157817,2003
LA,social insurance administration,947,2668313,110,84298,7273,988,2752611,2003
LA,solid waste management,0,0,0,0,0,0,0,2003
LA,sewerage,0,0,0,0,0,0,0,2003
LA,parks and recreation,1034,2648430,338,262365,33602,1225,2910795,2003
LA,housing and community development,0,0,0,0,0,0,0,2003
LA,natural resources,4535,14013736,1076,745342,74743,4959,14759078,2003
LA,water transport and terminals,0,0,0,0,0,0,0,2003
LA,electric power,0,0,0,0,0,0,0,2003
LA,gas supply,0,0,0,0,0,0,0,2003
LA,transit,0,0,0,0,0,0,0,2003
LA,education - elementary and secondary instructional,0,0,0,0,0,0,0,2003
LA,education - elementary and secondary other,0,0,0,0,0,0,0,2003
LA,education - higher education instructional,7990,44362271,5379,5660582,341607,9929,50022853,2003
LA,education - higher education other,14891,40189170,15289,6347629,675300,18729,46536799,2003
LA,education - other,3191,10168676,827,638867,44915,3447,10807543,2003
LA,libraries,0,0,0,0,0,0,0,2003
LA,liquor stores,0,0,0,0,0,0,0,2003
LA,other and unallocable,2682,7998980,530,470677,44047,2936,8469657,2003
ME,total,19051,66173120,6953,7292660,488739,21830,73465780,2003
ME,financial administration,1132,3635424,77,145035,9109,1184,3780459,2003
ME,other government administration,357,1436519,237,536679,30905,533,1973198,2003
ME,judicial and legal,685,2848435,74,110669,6090,720,2959104,2003
ME,police protection - officers,376,1864569,5,14874,644,380,1879443,2003
ME,police protection - other,212,624842,2,3979,290,214,628821,2003
ME,corrections,1243,4139595,111,247103,14374,1326,4386698,2003
ME,highways,2457,8009135,89,91478,6958,2497,8100613,2003
ME,air transportation,0,0,0,0,0,0,0,2003
ME,water transport and terminals,61,186837,16,22180,1709,71,209017,2003
ME,public welfare,2034,5879991,56,96639,5579,2065,5976630,2003
ME,health,1288,4694524,93,213919,10944,1350,4908443,2003
ME,hospitals,633,2185016,83,171940,9000,683,2356956,2003
ME,social insurance administration,468,1545853,39,73013,4025,490,1618866,2003
ME,solid waste management,0,0,0,0,0,0,0,2003
ME,sewerage,0,0,0,0,0,0,0,2003
ME,parks and recreation,143,465281,33,41046,2710,158,506327,2003
ME,housing and community development,0,0,0,0,0,0,0,2003
ME,natural resources,1138,4073632,238,429061,23568,1272,4502693,2003
ME,water transport and terminals,0,0,0,0,0,0,0,2003
ME,electric power,0,0,0,0,0,0,0,2003
ME,gas supply,0,0,0,0,0,0,0,2003
ME,transit,0,0,0,0,0,0,0,2003
ME,education - elementary and secondary instructional,26,93659,13,15742,1227,33,109401,2003
ME,education - elementary and secondary other,6,12773,36,42002,3270,25,54775,2003
ME,education - higher education instructional,1411,6741171,567,708307,31140,1589,7449478,2003
ME,education - higher education other,3889,12416702,5102,4167369,318131,5697,16584071,2003
ME,education - other,265,930507,17,42157,2094,277,972664,2003
ME,libraries,0,0,0,0,0,0,0,2003
ME,liquor stores,56,148768,2,1450,124,57,150218,2003
ME,other and unallocable,1171,4239887,63,118018,6848,1209,4357905,2003
MD,total,83186,317728074,14913,25719010,1508912,91762,343447084,2003
MD,financial administration,3594,13552211,137,299838,18416,3698,13852049,2003
MD,other government administration,1209,5023931,314,544307,17450,1308,5568238,2003
MD,judicial and legal,3877,13342010,478,865680,66639,4256,14207690,2003
MD,police protection - officers,1600,8174770,0,0,0,1600,8174770,2003
MD,police protection - other,859,3026252,29,75575,3919,881,3101827,2003
MD,corrections,11780,40496118,286,600531,43120,12027,41096649,2003
MD,highways,4740,16121340,0,0,0,4740,16121340,2003
MD,air transportation,514,1866112,3,8710,263,515,1874822,2003
MD,water transport and terminals,293,1278060,0,0,0,293,1278060,2003
MD,public welfare,7123,23362548,130,253142,18638,7230,23615690,2003
MD,health,6316,22775776,871,1511667,111159,6948,24287443,2003
MD,hospitals,5094,17237427,580,767295,47277,5363,18004722,2003
MD,social insurance administration,1031,3818813,121,271193,18031,1133,4090006,2003
MD,solid waste management,0,0,0,0,0,0,0,2003
MD,sewerage,0,0,0,0,0,0,0,2003
MD,parks and recreation,477,1907698,231,255365,30299,649,2163063,2003
MD,housing and community development,0,0,0,0,0,0,0,2003
MD,natural resources,2091,8475031,124,203538,8065,2137,8678569,2003
MD,water transport and terminals,0,0,0,0,0,0,0,2003
MD,electric power,0,0,0,0,0,0,0,2003
MD,gas supply,0,0,0,0,0,0,0,2003
MD,transit,2133,9051197,239,313392,28394,2294,9364589,2003
MD,education - elementary and secondary instructional,0,0,0,0,0,0,0,2003
MD,education - elementary and secondary other,0,0,0,0,0,0,0,2003
MD,education - higher education instructional,9130,53947556,3721,9348122,346564,11099,63295678,2003
MD,education - higher education other,11871,38944952,6624,8549687,633217,15469,47494639,2003
MD,education - other,1935,7734217,244,583767,30093,2107,8317984,2003
MD,libraries,0,0,0,0,0,0,0,2003
MD,liquor stores,0,0,0,0,0,0,0,2003
MD,other and unallocable,7519,27592055,781,1267201,87368,8015,28859256,2003
MA,total,80802,338288573,27553,33418109,1725477,91064,371706682,2003
MA,financial administration,4134,17578801,330,916429,35604,4349,18495230,2003
MA,other government administration,1834,5705980,292,1092748,28111,1996,6798728,2003
MA,judicial and legal,8794,38158663,507,1230467,24622,8943,39389130,2003
MA,police protection - officers,4999,24623351,39,73054,2166,5012,24696405,2003
MA,police protection - other,570,2265542,8,16580,626,574,2282122,2003
MA,corrections,6840,29527840,78,184170,8571,6892,29712010,2003
MA,highways,3739,17282932,166,460331,19065,3848,17743263,2003
MA,air transportation,1115,6231017,158,240369,11954,1183,6471386,2003
MA,water transport and terminals,159,784889,7,10135,735,163,795024,2003
MA,public welfare,6254,25829363,646,1653158,76727,6715,27482521,2003
MA,health,7079,27221939,1212,2251443,114123,7767,29473382,2003
MA,hospitals,6882,22532039,911,2100608,87816,7383,24632647,2003
MA,social insurance administration,1447,5614168,205,443030,25036,1598,6057198,2003
MA,solid waste management,3,17205,0,0,0,3,17205,2003
MA,sewerage,888,4445440,36,125017,5000,916,4570457,2003
MA,parks and recreation,798,2653551,55,71696,3618,819,2725247,2003
MA,housing and community development,0,0,0,0,0,0,0,2003
MA,natural resources,1144,5176694,98,141629,6096,1181,5318323,2003
MA,water transport and terminals,522,2542324,22,59299,2573,536,2601623,2003
MA,electric power,0,0,0,0,0,0,0,2003
MA,gas supply,0,0,0,0,0,0,0,2003
MA,transit,0,0,0,0,0,0,0,2003
MA,education - elementary and secondary instructional,55,231222,0,0,0,55,231222,2003
MA,education - elementary and secondary other,33,115135,12,8983,500,36,124118,2003
MA,education - higher education instructional,6064,33055904,9806,14426763,622451,9779,47482667,2003
MA,education - higher education other,12908,45624194,12699,7162631,632980,16672,52786825,2003
MA,education - other,1051,4806084,94,262775,8423,1102,5068859,2003
MA,libraries,0,0,0,0,0,0,0,2003
MA,liquor stores,0,0,0,0,0,0,0,2003
MA,other and unallocable,3490,16264296,172,486794,8680,3542,16751090,2003
MI,total,108819,458327219,64241,66510896,4969584,137062,524838115,2003
MI,financial administration,3952,16944526,1067,2654026,152334,4818,19598552,2003
MI,other government administration,1712,6245555,18,68723,2566,1727,6314278,2003
MI,judicial and legal,1848,9118547,44,95007,4364,1873,9213554,2003
MI,police protection - officers,2296,10823921,0,0,0,2296,10823921,2003
MI,police protection - other,1056,4196542,93,149221,8092,1102,4345763,2003
MI,corrections,18448,68370185,278,884168,40616,18679,69254353,2003
MI,highways,2457,10104470,281,730368,38606,2676,10834838,2003
MI,air transportation,0,0,0,0,0,0,0,2003
MI,water transport and terminals,0,0,0,0,0,0,0,2003
MI,public welfare,9845,36882911,495,926947,79046,10294,37809858,2003
MI,health,1403,5947746,228,368237,17833,1504,6315983,2003
MI,hospitals,8952,32850270,3528,7129709,480261,11681,39979979,2003
MI,social insurance administration,1077,4185199,138,316894,19899,1190,4502093,2003
MI,solid waste management,0,0,0,0,0,0,0,2003
MI,sewerage,0,0,0,0,0,0,0,2003
MI,parks and recreation,228,886350,128,273486,14287,309,1159836,2003
MI,housing and community development,0,0,0,0,0,0,0,2003
MI,natural resources,4298,17166281,994,1118770,85375,4783,18285051,2003
MI,water transport and terminals,0,0,0,0,0,0,0,2003
MI,electric power,0,0,0,0,0,0,0,2003
MI,gas supply,0,0,0,0,0,0,0,2003
MI,transit,0,0,0,0,0,0,0,2003
MI,education - elementary and secondary instructional,622,2014484,130,172623,12868,696,2187107,2003
MI,education - elementary and secondary other,189,458436,72,63764,6315,226,522200,2003
MI,education - higher education instructional,13862,92882130,14347,23616542,1298919,21244,116498672,2003
MI,education - higher education other,30338,113906658,41474,25945607,2604788,45140,139852265,2003
MI,education - other,1143,4826504,276,778702,37444,1356,5605206,2003
MI,libraries,0,0,0,0,0,0,0,2003
MI,liquor stores,0,0,0,0,0,0,0,2003
MI,other and unallocable,5093,20516504,650,1218102,65971,5468,21734606,2003
MN,total,62245,277327947,29899,33251713,2284386,75220,310579660,2003
MN,financial administration,2434,10174028,151,282457,23225,2566,10456485,2003
MN,other government administration,1128,4475843,133,331778,16577,1222,4807621,2003
MN,judicial and legal,2221,11150295,542,1452829,66198,2596,12603124,2003
MN,police protection - officers,523,2950914,0,0,0,523,2950914,2003
MN,police protection - other,403,1529128,26,44681,3104,421,1573809,2003
MN,corrections,3694,13976949,145,333016,18388,3799,14309965,2003
MN,highways,4964,20916982,202,321508,22514,5092,21238490,2003
MN,air transportation,0,0,0,0,0,0,0,2003
MN,water transport and terminals,0,0,0,0,0,0,0,2003
MN,public welfare,1620,6456239,1133,2193646,182083,2654,8649885,2003
MN,health,2101,9553596,233,521904,27343,2256,10075500,2003
MN,hospitals,3306,13698680,1320,2935563,233595,4633,16634243,2003
MN,social insurance administration,1178,4722015,129,288956,14688,1261,5010971,2003
MN,solid waste management,0,0,0,0,0,0,0,2003
MN,sewerage,669,3518728,10,29243,1279,676,3547971,2003
MN,parks and recreation,527,2146817,159,193514,13335,603,2340331,2003
MN,housing and community development,0,0,0,0,0,0,0,2003
MN,natural resources,2873,12313328,707,1077664,81373,3336,13390992,2003
MN,water transport and terminals,0,0,0,0,0,0,0,2003
MN,electric power,0,0,0,0,0,0,0,2003
MN,gas supply,0,0,0,0,0,0,0,2003
MN,transit,2240,9172828,479,940884,40696,2471,10113712,2003
MN,education - elementary and secondary instructional,0,0,0,0,0,0,0,2003
MN,education - elementary and secondary other,0,0,0,0,0,0,0,2003
MN,education - higher education instructional,9861,51043494,9269,10111714,510295,12757,61155208,2003
MN,education - higher education other,15113,68903266,14576,11022039,966852,20609,79925305,2003
MN,education - other,3967,15591676,500,747372,40827,4198,16339048,2003
MN,libraries,0,0,0,0,0,0,0,2003
MN,liquor stores,0,0,0,0,0,0,0,2003
MN,other and unallocable,3423,15033141,185,422945,22014,3547,15456086,2003
MS,total,50424,147689863,14735,10356395,1028982,56269,158046258,2003
MS,financial administration,1203,3675042,40,41967,4412,1228,3717009,2003
MS,other government administration,474,1657664,79,103863,5716,507,1761527,2003
MS,judicial and legal,626,3198446,62,81094,4627,652,3279540,2003
MS,police protection - officers,663,2014407,0,0,0,663,2014407,2003
MS,police protection - other,526,1274408,0,0,0,526,1274408,2003
MS,corrections,4147,8757204,26,32000,3133,4165,8789204,2003
MS,highways,3254,8086090,12,15096,1224,3261,8101186,2003
MS,air transportation,0,0,0,0,0,0,0,2003
MS,water transport and terminals,58,207928,0,0,0,58,207928,2003
MS,public welfare,2825,6227650,0,0,0,2825,6227650,2003
MS,health,2962,8114081,79,178499,9117,3013,8292580,2003
MS,hospitals,11667,26537900,560,1306421,71054,12071,27844321,2003
MS,social insurance administration,781,2184080,333,588804,47806,1052,2772884,2003
MS,solid waste management,0,0,0,0,0,0,0,2003
MS,sewerage,0,0,0,0,0,0,0,2003
MS,parks and recreation,310,595869,97,46643,5731,343,642512,2003
MS,housing and community development,0,0,0,0,0,0,0,2003
MS,natural resources,2964,7715052,786,512309,49374,3242,8227361,2003
MS,water transport and terminals,0,0,0,0,0,0,0,2003
MS,electric power,0,0,0,0,0,0,0,2003
MS,gas supply,0,0,0,0,0,0,0,2003
MS,transit,0,0,0,0,0,0,0,2003
MS,education - elementary and secondary instructional,0,0,0,0,0,0,0,2003
MS,education - elementary and secondary other,0,0,0,0,0,0,0,2003
MS,education - higher education instructional,5191,28119473,1883,2094296,143554,6006,30213769,2003
MS,education - higher education other,8545,27442653,10666,5200852,671895,12362,32643505,2003
MS,education - other,1516,4210178,51,70630,5605,1549,4280808,2003
MS,libraries,0,0,0,0,0,0,0,2003
MS,liquor stores,123,298915,0,0,0,123,298915,2003
MS,other and unallocable,2589,7372823,61,83921,5734,2623,7456744,2003
MO,total,81836,233199158,24890,18132419,1596470,90912,251331577,2003
MO,financial administration,2491,6422787,309,137504,18955,2599,6560291,2003
MO,other government administration,820,2342154,263,588737,35443,1021,2930891,2003
MO,judicial and legal,4017,13428980,327,390814,16866,4112,13819794,2003
MO,police protection - officers,1307,4523988,0,0,0,1307,4523988,2003
MO,police protection - other,1063,2507850,98,71700,10200,1121,2579550,2003
MO,corrections,11462,24767347,500,422429,29697,11630,25189776,2003
MO,highways,6302,19146170,454,402212,29824,6471,19548382,2003
MO,air transportation,0,0,0,0,0,0,0,2003
MO,water transport and terminals,0,0,0,0,0,0,0,2003
MO,public welfare,7786,17290710,533,492380,43050,8030,17783090,2003
MO,health,3359,8500672,223,296290,18745,3465,8796962,2003
MO,hospitals,11769,29761613,1426,1764511,119510,12448,31526124,2003
MO,social insurance administration,622,1645666,23,18046,2004,633,1663712,2003
MO,solid waste management,0,0,0,0,0,0,0,2003
MO,sewerage,0,0,0,0,0,0,0,2003
MO,parks and recreation,574,1424828,350,226762,20693,692,1651590,2003
MO,housing and community development,0,0,0,0,0,0,0,2003
MO,natural resources,2437,6989139,562,525811,52813,2737,7514950,2003
MO,water transport and terminals,0,0,0,0,0,0,0,2003
MO,electric power,0,0,0,0,0,0,0,2003
MO,gas supply,0,0,0,0,0,0,0,2003
MO,transit,0,0,0,0,0,0,0,2003
MO,education - elementary and secondary instructional,0,0,0,0,0,0,0,2003
MO,education - elementary and secondary other,0,0,0,0,0,0,0,2003
MO,education - higher education instructional,7951,37396127,7407,6917061,486309,10716,44313188,2003
MO,education - higher education other,13134,38019479,11821,5309126,679337,16999,43328605,2003
MO,education - other,2080,5484682,400,4e+05,15286,2167,5884682,2003
MO,libraries,0,0,0,0,0,0,0,2003
MO,liquor stores,0,0,0,0,0,0,0,2003
MO,other and unallocable,4662,13546966,194,169036,17738,4764,13716002,2003
MT,total,15391,49834417,9169,8111187,581081,18700,57945604,2003
MT,financial administration,975,2720300,85,89095,8978,1026,2809395,2003
MT,other government administration,391,1242924,270,436320,41140,626,1679244,2003
MT,judicial and legal,414,1505174,109,203345,9487,468,1708519,2003
MT,police protection - officers,204,659168,0,0,0,204,659168,2003
MT,police protection - other,213,681998,31,45985,3758,234,727983,2003
MT,corrections,1066,3068746,47,70390,4335,1091,3139136,2003
MT,highways,2128,7338744,112,140923,9600,2183,7479667,2003
MT,air transportation,0,0,0,0,0,0,0,2003
MT,water transport and terminals,0,0,0,0,0,0,0,2003
MT,public welfare,1361,3955604,205,294622,23497,1494,4250226,2003
MT,health,796,2310480,124,142872,12834,870,2453352,2003
MT,hospitals,498,1342211,155,130214,13063,572,1472425,2003
MT,social insurance administration,707,2179833,26,35749,2679,723,2215582,2003
MT,solid waste management,0,0,0,0,0,0,0,2003
MT,sewerage,0,0,0,0,0,0,0,2003
MT,parks and recreation,63,189974,42,15764,1585,72,205738,2003
MT,housing and community development,0,0,0,0,0,0,0,2003
MT,natural resources,1234,4082797,262,253965,23109,1366,4336762,2003
MT,water transport and terminals,0,0,0,0,0,0,0,2003
MT,electric power,0,0,0,0,0,0,0,2003
MT,gas supply,0,0,0,0,0,0,0,2003
MT,transit,0,0,0,0,0,0,0,2003
MT,education - elementary and secondary instructional,0,0,0,0,0,0,0,2003
MT,education - elementary and secondary other,0,0,0,0,0,0,0,2003
MT,education - higher education instructional,1435,7058281,1824,2820134,102095,2018,9878415,2003
MT,education - higher education other,2510,7073902,5665,3153563,302733,4232,10227465,2003
MT,education - other,375,1115081,110,133941,11519,440,1249022,2003
MT,libraries,0,0,0,0,0,0,0,2003
MT,liquor stores,16,43751,3,2872,286,18,46623,2003
MT,other and unallocable,1005,3265449,99,141433,10383,1063,3406882,2003
NE,total,28056,84281750,10910,8662198,957576,33500,92943948,2003
NE,financial administration,553,1653264,9,14698,916,557,1667962,2003
NE,other government administration,231,744244,106,110602,8101,278,854846,2003
NE,judicial and legal,677,2717336,68,52533,4499,703,2769869,2003
NE,police protection - officers,509,1786356,0,0,0,509,1786356,2003
NE,police protection - other,230,634628,10,9263,837,234,643891,2003
NE,corrections,2440,6638632,52,59239,4906,2468,6697871,2003
NE,highways,2153,5552085,11,17891,1160,2160,5569976,2003
NE,air transportation,26,84621,1,2221,177,27,86842,2003
NE,water transport and terminals,0,0,0,0,0,0,0,2003
NE,public welfare,2730,6400982,127,43206,6758,2769,6444188,2003
NE,health,755,2247267,91,141268,11061,818,2388535,2003
NE,hospitals,4170,11195915,1044,1757443,161908,5090,12953358,2003
NE,social insurance administration,237,756117,7,9401,645,241,765518,2003
NE,solid waste management,0,0,0,0,0,0,0,2003
NE,sewerage,0,0,0,0,0,0,0,2003
NE,parks and recreation,234,625107,138,104452,15540,322,729559,2003
NE,housing and community development,0,0,0,0,0,0,0,2003
NE,natural resources,1557,4360583,758,1094560,103477,2145,5455143,2003
NE,water transport and terminals,0,0,0,0,0,0,0,2003
NE,electric power,0,0,0,0,0,0,0,2003
NE,gas supply,0,0,0,0,0,0,0,2003
NE,transit,0,0,0,0,0,0,0,2003
NE,education - elementary and secondary instructional,0,0,0,0,0,0,0,2003
NE,education - elementary and secondary other,0,0,0,0,0,0,0,2003
NE,education - higher education instructional,2780,14129346,1143,1372545,81172,3242,15501891,2003
NE,education - higher education other,5927,16650552,6907,3682509,540782,8999,20333061,2003
NE,education - other,542,1856063,65,34514,3771,564,1890577,2003
NE,libraries,0,0,0,0,0,0,0,2003
NE,liquor stores,0,0,0,0,0,0,0,2003
NE,other and unallocable,2305,6248652,373,155853,11866,2374,6404505,2003
NV,total,21525,81327933,10845,8378708,562256,24716,89706641,2003
NV,financial administration,1201,4080959,39,51115,2147,1214,4132074,2003
NV,other government administration,1209,5047271,26,38155,2331,1222,5085426,2003
NV,judicial and legal,626,3268761,26,54751,1355,633,3323512,2003
NV,police protection - officers,392,2220131,0,0,0,392,2220131,2003
NV,police protection - other,378,1495816,1,1023,83,378,1496839,2003
NV,corrections,3080,11843535,66,143081,4064,3103,11986616,2003
NV,highways,1712,6234157,4,1810,128,1713,6235967,2003
NV,air transportation,0,0,0,0,0,0,0,2003
NV,water transport and terminals,0,0,0,0,0,0,0,2003
NV,public welfare,1143,3702310,9,17012,651,1147,3719322,2003
NV,health,1063,4259375,45,86600,2663,1079,4345975,2003
NV,hospitals,986,3863496,99,237943,8546,1035,4101439,2003
NV,social insurance administration,482,1653324,5,8112,320,484,1661436,2003
NV,solid waste management,0,0,0,0,0,0,0,2003
NV,sewerage,0,0,0,0,0,0,0,2003
NV,parks and recreation,174,615202,10,17630,737,178,632832,2003
NV,housing and community development,0,0,0,0,0,0,0,2003
NV,natural resources,1106,4070155,393,354810,18575,1212,4424965,2003
NV,water transport and terminals,14,80439,1,3615,144,15,84054,2003
NV,electric power,14,80439,1,3615,144,15,84054,2003
NV,gas supply,0,0,0,0,0,0,0,2003
NV,transit,0,0,0,0,0,0,0,2003
NV,education - elementary and secondary instructional,0,0,0,0,0,0,0,2003
NV,education - elementary and secondary other,0,0,0,0,0,0,0,2003
NV,education - higher education instructional,1890,10166169,2069,2974207,150174,2743,13140376,2003
NV,education - higher education other,3974,10103101,7990,4301436,366981,6059,14404537,2003
NV,education - other,134,551245,7,15557,445,137,566802,2003
NV,libraries,0,0,0,0,0,0,0,2003
NV,liquor stores,0,0,0,0,0,0,0,2003
NV,other and unallocable,1947,7992048,54,68236,2768,1957,8060284,2003
NH,total,17451,59376424,8861,7781189,483519,20359,67157613,2003
NH,financial administration,537,1594342,44,32910,5158,567,1627252,2003
NH,other government administration,308,1005102,93,111259,7517,353,1116361,2003
NH,judicial and legal,932,3340934,1,1255,120,933,3342189,2003
NH,police protection - officers,278,1248437,0,0,0,278,1248437,2003
NH,police protection - other,119,377297,16,17050,1430,128,394347,2003
NH,corrections,1430,4687740,62,99616,5724,1464,4787356,2003
NH,highways,1830,5440478,278,260663,22773,1967,5701141,2003
NH,air transportation,0,0,0,0,0,0,0,2003
NH,water transport and terminals,3,9855,4,4047,328,5,13902,2003
NH,public welfare,1398,4162579,85,110109,4694,1425,4272688,2003
NH,health,1014,3511842,87,102411,6991,1057,3614253,2003
NH,hospitals,805,2371500,76,120648,1862,816,2492148,2003
NH,social insurance administration,384,1133340,49,55952,3770,407,1189292,2003
NH,solid waste management,0,0,0,0,0,0,0,2003
NH,sewerage,0,0,0,0,0,0,0,2003
NH,parks and recreation,80,227134,237,136602,19151,195,363736,2003
NH,housing and community development,0,0,0,0,0,0,0,2003
NH,natural resources,527,1652567,184,169985,12839,604,1822552,2003
NH,water transport and terminals,0,0,0,0,0,0,0,2003
NH,electric power,0,0,0,0,0,0,0,2003
NH,gas supply,0,0,0,0,0,0,0,2003
NH,transit,0,0,0,0,0,0,0,2003
NH,education - elementary and secondary instructional,0,0,0,0,0,0,0,2003
NH,education - elementary and secondary other,0,0,0,0,0,0,0,2003
NH,education - higher education instructional,1369,6462200,1864,2800890,65105,1761,9263090,2003
NH,education - higher education other,3899,13981377,5081,3242304,270048,5526,17223681,2003
NH,education - other,335,1075891,12,14174,1171,342,1090065,2003
NH,libraries,0,0,0,0,0,0,0,2003
NH,liquor stores,297,874105,360,241359,29495,475,1115464,2003
NH,other and unallocable,1906,6219704,328,259955,25343,2056,6479659,2003
NJ,total,135557,614176926,33077,33327058,1818703,146698,647503984,2003
NJ,financial administration,4904,20398412,491,802949,63464,5265,21201361,2003
NJ,other government administration,1394,6608534,53,77158,4814,1422,6685692,2003
NJ,judicial and legal,14039,62968241,140,203810,11566,14105,63172051,2003
NJ,police protection - officers,1320,4558453,44,67976,4005,1343,4626429,2003
NJ,police protection - other,2801,18197822,0,0,0,2801,18197822,2003
NJ,corrections,10078,46383424,20,33113,1439,10086,46416537,2003
NJ,highways,6620,29520279,945,914670,77926,7063,30434949,2003
NJ,air transportation,0,0,0,0,0,0,0,2003
NJ,water transport and terminals,112,484927,6,9819,961,117,494746,2003
NJ,public welfare,6152,25620638,179,296514,16293,6244,25917152,2003
NJ,health,3035,14438259,54,110408,4679,3062,14548667,2003
NJ,hospitals,15911,56036398,1589,1973878,128126,16646,58010276,2003
NJ,social insurance administration,1882,7105711,182,311585,21553,2004,7417296,2003
NJ,solid waste management,629,3350891,1,89,9,629,3350980,2003
NJ,sewerage,0,0,0,0,0,0,0,2003
NJ,parks and recreation,1725,7189461,1073,1082006,83317,2202,8271467,2003
NJ,housing and community development,0,0,0,0,0,0,0,2003
NJ,natural resources,2412,10646000,598,813472,28368,2580,11459472,2003
NJ,water transport and terminals,120,464561,0,0,0,120,464561,2003
NJ,electric power,0,0,0,0,0,0,0,2003
NJ,gas supply,0,0,0,0,0,0,0,2003
NJ,transit,10014,44557265,827,1226941,83933,10491,45784206,2003
NJ,education - elementary and secondary instructional,11319,63289842,1704,2454676,133855,12228,65744518,2003
NJ,education - elementary and secondary other,7090,17309872,1904,1535136,130855,7978,18845008,2003
NJ,education - higher education instructional,7102,55629235,6782,8728656,258082,8707,64357891,2003
NJ,education - higher education other,17437,75015421,15522,11618118,673780,21621,86633539,2003
NJ,education - other,2862,13174460,647,648721,61372,3211,13823181,2003
NJ,libraries,0,0,0,0,0,0,0,2003
NJ,liquor stores,0,0,0,0,0,0,0,2003
NJ,other and unallocable,6599,31228820,316,417363,30306,6773,31646183,2003
NM,total,40269,119376838,15074,15259938,1041722,46325,134636776,2003
NM,financial administration,1707,5488789,146,191897,22525,1835,5680686,2003
NM,other government administration,208,848426,9,13918,1180,216,862344,2003
NM,judicial and legal,2610,8765083,115,181957,12574,2682,8947040,2003
NM,police protection - officers,462,1691290,0,0,0,462,1691290,2003
NM,police protection - other,171,629460,0,0,0,171,629460,2003
NM,corrections,4070,11602182,72,126665,11019,4133,11728847,2003
NM,highways,2320,6377327,0,0,0,2320,6377327,2003
NM,air transportation,6,23732,0,0,0,6,23732,2003
NM,water transport and terminals,0,0,0,0,0,0,0,2003
NM,public welfare,1468,3974834,107,181110,17747,1569,4155944,2003
NM,health,2370,6391663,262,352071,20473,2490,6743734,2003
NM,hospitals,4988,14432768,2207,5260736,251147,6422,19693504,2003
NM,social insurance administration,510,1341449,3,8037,407,512,1349486,2003
NM,solid waste management,0,0,0,0,0,0,0,2003
NM,sewerage,0,0,0,0,0,0,0,2003
NM,parks and recreation,677,1809481,73,133617,9567,731,1943098,2003
NM,housing and community development,0,0,0,0,0,0,0,2003
NM,natural resources,1677,5305833,156,166105,19615,1789,5471938,2003
NM,water transport and terminals,0,0,0,0,0,0,0,2003
NM,electric power,0,0,0,0,0,0,0,2003
NM,gas supply,0,0,0,0,0,0,0,2003
NM,transit,0,0,0,0,0,0,0,2003
NM,education - elementary and secondary instructional,0,0,0,0,0,0,0,2003
NM,education - elementary and secondary other,0,0,0,0,0,0,0,2003
NM,education - higher education instructional,3950,13923087,3257,3624950,173580,4969,17548037,2003
NM,education - higher education other,9985,27741990,8513,4838578,486073,12835,32580568,2003
NM,education - other,1199,3676018,119,133074,11665,1266,3809092,2003
NM,libraries,0,0,0,0,0,0,0,2003
NM,liquor stores,0,0,0,0,0,0,0,2003
NM,other and unallocable,1891,5353426,35,47223,4150,1917,5400649,2003
NY,total,229745,1011908272,48853,55368463,3092113,248150,1067276735,2003
NY,financial administration,13093,50650925,413,997271,46369,13366,51648196,2003
NY,other government administration,4574,17440846,1058,887344,66981,4955,18328190,2003
NY,judicial and legal,18464,99157648,740,1889769,90362,18977,101047417,2003
NY,police protection - officers,4505,26544897,0,0,0,4505,26544897,2003
NY,police protection - other,1568,5361972,163,145706,13335,1644,5507678,2003
NY,corrections,33332,143003025,419,1001142,44617,33585,144004167,2003
NY,highways,11877,46560167,1024,962069,83771,12352,47522236,2003
NY,air transportation,128,484738,14,28000,1771,138,512738,2003
NY,water transport and terminals,654,3054951,23,48822,2365,668,3103773,2003
NY,public welfare,6292,24337728,585,1147070,69460,6688,25484798,2003
NY,health,9117,41920792,441,1135766,50421,9406,43056558,2003
NY,hospitals,42235,167282050,5805,12250854,561536,45453,179532904,2003
NY,social insurance administration,8327,32535635,114,279149,16669,8423,32814784,2003
NY,solid waste management,0,0,0,0,0,0,0,2003
NY,sewerage,0,0,0,0,0,0,0,2003
NY,parks and recreation,1815,6695923,1045,1672246,137392,2596,8368169,2003
NY,housing and community development,0,0,0,0,0,0,0,2003
NY,natural resources,3514,14203011,70,142793,8051,3560,14345804,2003
NY,water transport and terminals,0,0,0,0,0,0,0,2003
NY,electric power,1609,11268099,55,104836,6550,1646,11372935,2003
NY,gas supply,0,0,0,0,0,0,0,2003
NY,transit,15014,82311401,396,569451,46926,15281,82880852,2003
NY,education - elementary and secondary instructional,0,0,0,0,0,0,0,2003
NY,education - elementary and secondary other,0,0,0,0,0,0,0,2003
NY,education - higher education instructional,13314,79071159,15703,16032056,801392,18231,95103215,2003
NY,education - higher education other,24322,91048776,19881,14170603,955418,30171,105219379,2003
NY,education - other,4522,18570085,288,552171,30228,4694,19122256,2003
NY,libraries,0,0,0,0,0,0,0,2003
NY,liquor stores,0,0,0,0,0,0,0,2003
NY,other and unallocable,11469,50404444,616,1351345,58499,11811,51755789,2003
NC,total,117279,386927587,34947,38870039,2461160,131265,425797626,2003
NC,financial administration,3991,11228545,20,30920,1705,4001,11259465,2003
NC,other government administration,706,2822893,509,1063113,73669,1124,3886006,2003
NC,judicial and legal,5804,21760400,189,230765,10609,5865,21991165,2003
NC,police protection - officers,2280,8923648,0,0,0,2280,8923648,2003
NC,police protection - other,1012,3021787,9,11757,823,1017,3033544,2003
NC,corrections,18912,49748497,508,1004355,25489,19057,50752852,2003
NC,highways,11793,28468670,0,0,0,11793,28468670,2003
NC,air transportation,0,0,0,0,0,0,0,2003
NC,water transport and terminals,274,909076,0,0,0,274,909076,2003
NC,public welfare,1846,6136932,12,18455,805,1851,6155387,2003
NC,health,3872,14621281,225,211002,21208,3992,14832283,2003
NC,hospitals,15993,48790097,1352,1725329,89677,16504,50515426,2003
NC,social insurance administration,2399,7438639,321,543012,39021,2621,7981651,2003
NC,solid waste management,243,877688,11,24744,824,248,902432,2003
NC,sewerage,0,0,0,0,0,0,0,2003
NC,parks and recreation,872,2151901,174,129665,15936,963,2281566,2003
NC,housing and community development,0,0,0,0,0,0,0,2003
NC,natural resources,3607,10707609,737,946945,50268,3894,11654554,2003
NC,water transport and terminals,0,0,0,0,0,0,0,2003
NC,electric power,0,0,0,0,0,0,0,2003
NC,gas supply,0,0,0,0,0,0,0,2003
NC,transit,0,0,0,0,0,0,0,2003
NC,education - elementary and secondary instructional,0,0,0,0,0,0,0,2003
NC,education - elementary and secondary other,0,0,0,0,0,0,0,2003
NC,education - higher education instructional,10896,63757529,10337,18637398,824212,15578,82394927,2003
NC,education - higher education other,25875,82029716,20271,13977105,1287927,33192,96006821,2003
NC,education - other,2702,8684270,100,172421,7088,2743,8856691,2003
NC,libraries,0,0,0,0,0,0,0,2003
NC,liquor stores,0,0,0,0,0,0,0,2003
NC,other and unallocable,4202,14848409,172,143053,11899,4268,14991462,2003
ND,total,14154,43767133,8567,7557182,678312,18009,51324315,2003
ND,financial administration,634,1845716,77,74473,8466,683,1920189,2003
ND,other government administration,189,507466,232,742638,24626,328,1250104,2003
ND,judicial and legal,488,1704862,40,14213,1487,496,1719075,2003
ND,police protection - officers,125,423213,0,0,0,125,423213,2003
ND,police protection - other,90,245988,6,10094,658,94,256082,2003
ND,corrections,621,1560293,48,38968,3810,643,1599261,2003
ND,highways,923,2742977,39,52505,3775,944,2795482,2003
ND,air transportation,0,0,0,0,0,0,0,2003
ND,water transport and terminals,0,0,0,0,0,0,0,2003
ND,public welfare,429,1076894,56,36897,3221,447,1113791,2003
ND,health,1253,3548020,230,88163,6071,1287,3636183,2003
ND,hospitals,937,2144155,177,49554,6442,974,2193709,2003
ND,social insurance administration,396,1069831,26,37626,3197,414,1107457,2003
ND,solid waste management,0,0,0,0,0,0,0,2003
ND,sewerage,0,0,0,0,0,0,0,2003
ND,parks and recreation,101,267093,34,28272,2641,116,295365,2003
ND,housing and community development,0,0,0,0,0,0,0,2003
ND,natural resources,1032,3498091,595,574189,90739,1549,4072280,2003
ND,water transport and terminals,0,0,0,0,0,0,0,2003
ND,electric power,0,0,0,0,0,0,0,2003
ND,gas supply,0,0,0,0,0,0,0,2003
ND,transit,0,0,0,0,0,0,0,2003
ND,education - elementary and secondary instructional,0,0,0,0,0,0,0,2003
ND,education - elementary and secondary other,0,0,0,0,0,0,0,2003
ND,education - higher education instructional,1935,9152086,2266,3178529,202235,3084,12330615,2003
ND,education - higher education other,3475,9113130,4561,2480143,308326,5228,11593273,2003
ND,education - other,279,842163,40,29148,2168,291,871311,2003
ND,libraries,0,0,0,0,0,0,0,2003
ND,liquor stores,0,0,0,0,0,0,0,2003
ND,other and unallocable,1247,4025155,140,121770,10450,1306,4146925,2003
OH,total,112056,421827274,65774,61461807,4365812,136871,483289081,2003
OH,financial administration,8025,34969372,570,894173,58625,8359,35863545,2003
OH,other government administration,783,3036420,137,116372,6882,822,3152792,2003
OH,judicial and legal,2451,10980165,431,1026308,53239,2753,12006473,2003
OH,police protection - officers,1451,6997675,0,0,0,1451,6997675,2003
OH,police protection - other,1234,3915809,13,28344,1824,1244,3944153,2003
OH,corrections,16607,61774886,59,133923,6729,16645,61908809,2003
OH,highways,6857,27680890,378,505766,35880,7061,28186656,2003
OH,air transportation,0,0,0,0,0,0,0,2003
OH,water transport and terminals,0,0,0,0,0,0,0,2003
OH,public welfare,2690,11786900,212,243983,21567,2813,12030883,2003
OH,health,3527,16605314,325,400721,31515,3705,17006035,2003
OH,hospitals,9342,26552537,3058,6621772,364473,11413,33174309,2003
OH,social insurance administration,2080,7825814,522,560282,39234,2303,8386096,2003
OH,solid waste management,0,0,0,0,0,0,0,2003
OH,sewerage,0,0,0,0,0,0,0,2003
OH,parks and recreation,511,1844134,228,323459,24035,648,2167593,2003
OH,housing and community development,0,0,0,0,0,0,0,2003
OH,natural resources,3147,10726134,851,1256184,87402,3644,11982318,2003
OH,water transport and terminals,0,0,0,0,0,0,0,2003
OH,electric power,0,0,0,0,0,0,0,2003
OH,gas supply,0,0,0,0,0,0,0,2003
OH,transit,0,0,0,0,0,0,0,2003
OH,education - elementary and secondary instructional,0,0,0,0,0,0,0,2003
OH,education - elementary and secondary other,0,0,0,0,0,0,0,2003
OH,education - higher education instructional,15437,84449342,21345,25436761,1218805,22367,109886103,2003
OH,education - higher education other,30934,81999131,37078,23088333,2370659,44408,105087464,2003
OH,education - other,2431,10479927,212,357322,17365,2529,10837249,2003
OH,libraries,0,0,0,0,0,0,0,2003
OH,liquor stores,0,0,0,0,0,0,0,2003
OH,other and unallocable,4549,20202824,355,468104,27578,4706,20670928,2003
OK,total,57797,178198029,23806,17672557,1347368,65511,195870586,2003
OK,financial administration,1683,5317327,96,133163,7968,1728,5450490,2003
OK,other government administration,820,2752272,163,204103,17812,920,2956375,2003
OK,judicial and legal,2510,9080016,187,297736,17328,2608,9377752,2003
OK,police protection - officers,982,3863730,30,39660,2154,994,3903390,2003
OK,police protection - other,792,2342533,87,83149,7274,833,2425682,2003
OK,corrections,5615,15633131,232,252493,15921,5706,15885624,2003
OK,highways,2821,8111048,58,63700,4301,2846,8174748,2003
OK,air transportation,8,36210,0,0,0,8,36210,2003
OK,water transport and terminals,0,0,0,0,0,0,0,2003
OK,public welfare,6102,15784027,240,226974,22155,6228,16011001,2003
OK,health,5714,16519985,320,401446,24460,5852,16921431,2003
OK,hospitals,2548,6662541,71,90456,6684,2585,6752997,2003
OK,social insurance administration,1262,3668604,169,158114,13882,1341,3826718,2003
OK,solid waste management,72,219648,6,3782,458,75,223430,2003
OK,sewerage,0,0,0,0,0,0,0,2003
OK,parks and recreation,732,1731962,330,298700,30017,904,2030662,2003
OK,housing and community development,0,0,0,0,0,0,0,2003
OK,natural resources,1782,4857925,920,664341,55986,2099,5522266,2003
OK,water transport and terminals,0,0,0,0,0,0,0,2003
OK,electric power,488,2075270,2,3489,189,489,2078759,2003
OK,gas supply,0,0,0,0,0,0,0,2003
OK,transit,0,0,0,0,0,0,0,2003
OK,education - elementary and secondary instructional,0,0,0,0,0,0,0,2003
OK,education - elementary and secondary other,0,0,0,0,0,0,0,2003
OK,education - higher education instructional,6173,30278116,5828,6982118,285607,7810,37260234,2003
OK,education - higher education other,13372,36224561,14815,7511057,817450,18065,43735618,2003
OK,education - other,2007,5827110,113,104267,8223,2054,5931377,2003
OK,libraries,0,0,0,0,0,0,0,2003
OK,liquor stores,0,0,0,0,0,0,0,2003
OK,other and unallocable,2314,7212013,139,153809,9499,2366,7365822,2003
OR,total,49504,180125512,24641,25007032,1323234,57022,205132544,2003
OR,financial administration,3867,14000348,394,589598,42825,4110,14589946,2003
OR,other government administration,1031,3682159,219,296779,17362,1130,3978938,2003
OR,judicial and legal,2634,9463633,378,613617,31305,2811,10077250,2003
OR,police protection - officers,650,2843124,0,0,0,650,2843124,2003
OR,police protection - other,511,1670964,146,95968,4149,535,1766932,2003
OR,corrections,4495,15697282,145,338958,14797,4579,16036240,2003
OR,highways,3408,13247340,44,108417,7394,3450,13355757,2003
OR,air transportation,16,55762,0,0,0,16,55762,2003
OR,water transport and terminals,0,0,0,0,0,0,0,2003
OR,public welfare,5391,17283584,328,783757,26582,5543,18067341,2003
OR,health,2477,8337941,262,456766,22546,2605,8794707,2003
OR,hospitals,4011,12977708,2800,4691351,143562,4827,17669059,2003
OR,social insurance administration,2082,8349295,300,523627,37409,2295,8872922,2003
OR,solid waste management,0,0,0,0,0,0,0,2003
OR,sewerage,0,0,0,0,0,0,0,2003
OR,parks and recreation,383,1185859,29,44559,3468,403,1230418,2003
OR,housing and community development,0,0,0,0,0,0,0,2003
OR,natural resources,2471,9225257,418,705387,50780,2760,9930644,2003
OR,water transport and terminals,0,0,0,0,0,0,0,2003
OR,electric power,0,0,0,0,0,0,0,2003
OR,gas supply,0,0,0,0,0,0,0,2003
OR,transit,0,0,0,0,0,0,0,2003
OR,education - elementary and secondary instructional,0,0,0,0,0,0,0,2003
OR,education - elementary and secondary other,0,0,0,0,0,0,0,2003
OR,education - higher education instructional,7148,31631811,7507,9338599,421481,9542,40970410,2003
OR,education - higher education other,6348,20985209,11388,5988997,476687,9057,26974206,2003
OR,education - other,924,3319979,120,246666,12869,997,3566645,2003
OR,libraries,0,0,0,0,0,0,0,2003
OR,liquor stores,151,494468,6,7080,531,154,501548,2003
OR,other and unallocable,1506,5673789,157,176906,9487,1558,5850695,2003
PA,total,137238,530411323,53594,64252866,3779180,159463,594664189,2003
PA,financial administration,6957,25835149,525,775908,55675,7293,26611057,2003
PA,other government administration,3028,9831373,1120,2497070,120619,3743,12328443,2003
PA,judicial and legal,2927,16085045,30,57938,3861,2950,16142983,2003
PA,police protection - officers,4610,20807024,0,0,0,4610,20807024,2003
PA,police protection - other,1204,5501064,3,8393,401,1206,5509457,2003
PA,corrections,15862,56791408,449,804317,66420,16262,57595725,2003
PA,highways,12823,43146405,749,1745434,108004,13473,44891839,2003
PA,air transportation,39,160871,0,0,0,39,160871,2003
PA,water transport and terminals,83,407615,0,0,0,83,407615,2003
PA,public welfare,12686,46042554,305,849297,37977,12914,46891851,2003
PA,health,1608,6526357,11,17261,860,1613,6543618,2003
PA,hospitals,12413,36921589,916,1570146,71660,12839,38491735,2003
PA,social insurance administration,3684,13783780,660,1535453,100850,4292,15319233,2003
PA,solid waste management,0,0,0,0,0,0,0,2003
PA,sewerage,0,0,0,0,0,0,0,2003
PA,parks and recreation,923,3314188,903,1573600,116975,1628,4887788,2003
PA,housing and community development,0,0,0,0,0,0,0,2003
PA,natural resources,6302,25073906,1452,2817010,111718,6963,27890916,2003
PA,water transport and terminals,0,0,0,0,0,0,0,2003
PA,electric power,0,0,0,0,0,0,0,2003
PA,gas supply,0,0,0,0,0,0,0,2003
PA,transit,0,0,0,0,0,0,0,2003
PA,education - elementary and secondary instructional,0,0,0,0,0,0,0,2003
PA,education - elementary and secondary other,0,0,0,0,0,0,0,2003
PA,education - higher education instructional,13016,87296689,10558,25772395,925792,18352,113069084,2003
PA,education - higher education other,27961,92196862,34418,22983390,1956169,39474,115180252,2003
PA,education - other,3393,12686231,72,156180,6884,3436,12842411,2003
PA,libraries,0,0,0,0,0,0,0,2003
PA,liquor stores,2758,8308192,1042,424738,43381,3019,8732930,2003
PA,other and unallocable,4961,19695021,381,664336,51934,5274,20359357,2003
RI,total,18042,75453871,6353,5226223,337712,20080,80680094,2003
RI,financial administration,938,3593328,5,10082,498,942,3603410,2003
RI,other government administration,656,2280013,263,113612,3704,680,2393625,2003
RI,judicial and legal,1142,4960540,27,66362,2261,1157,5026902,2003
RI,police protection - officers,209,1467362,0,0,0,209,1467362,2003
RI,police protection - other,83,349788,1,490,14,83,350278,2003
RI,corrections,1749,8178899,5,8484,228,1750,8187383,2003
RI,highways,839,3418717,12,29457,1700,849,3448174,2003
RI,air transportation,164,625045,1,1714,100,165,626759,2003
RI,water transport and terminals,0,0,0,0,0,0,0,2003
RI,public welfare,1493,7046303,54,77450,4561,1519,7123753,2003
RI,health,1325,5816908,55,46747,1359,1333,5863655,2003
RI,hospitals,1195,4987699,11,37459,861,1200,5025158,2003
RI,social insurance administration,514,2074466,11,30881,1098,521,2105347,2003
RI,solid waste management,116,585106,0,0,0,116,585106,2003
RI,sewerage,242,924033,5,10060,474,245,934093,2003
RI,parks and recreation,66,206039,0,0,0,66,206039,2003
RI,housing and community development,0,0,0,0,0,0,0,2003
RI,natural resources,510,2204645,28,33058,2531,524,2237703,2003
RI,water transport and terminals,0,0,0,0,0,0,0,2003
RI,electric power,0,0,0,0,0,0,0,2003
RI,gas supply,0,0,0,0,0,0,0,2003
RI,transit,740,2649636,38,80333,6090,775,2729969,2003
RI,education - elementary and secondary instructional,427,1870124,73,87635,6602,470,1957759,2003
RI,education - elementary and secondary other,87,236568,81,81455,8717,143,318023,2003
RI,education - higher education instructional,1731,7917842,2514,2839993,136268,2566,10757835,2003
RI,education - higher education other,2171,7009958,3041,1419102,147475,3038,8429060,2003
RI,education - other,540,2521312,84,189630,10397,608,2710942,2003
RI,libraries,0,0,0,0,0,0,0,2003
RI,liquor stores,0,0,0,0,0,0,0,2003
RI,other and unallocable,1105,4529540,44,62219,2774,1121,4591759,2003
SC,total,69975,209379945,20780,16259068,1223126,77275,225639013,2003
SC,financial administration,2077,7014678,69,109065,4508,2103,7123743,2003
SC,other government administration,467,1588412,500,493765,36932,687,2082177,2003
SC,judicial and legal,676,2818668,7,5958,416,679,2824626,2003
SC,police protection - officers,1356,4401668,0,0,0,1356,4401668,2003
SC,police protection - other,1755,4114486,10,17736,590,1759,4132222,2003
SC,corrections,7899,19339172,1,2118,68,7899,19341290,2003
SC,highways,4797,12564082,8,11734,430,4800,12575816,2003
SC,air transportation,0,0,0,0,0,0,0,2003
SC,water transport and terminals,583,2236971,0,0,0,583,2236971,2003
SC,public welfare,4994,12536614,16,19956,752,4998,12556570,2003
SC,health,6913,19371478,177,389683,10272,6974,19761161,2003
SC,hospitals,7981,16647364,223,457549,27395,8139,17104913,2003
SC,social insurance administration,1347,3854334,2,5812,64,1347,3860146,2003
SC,solid waste management,0,0,0,0,0,0,0,2003
SC,sewerage,0,0,0,0,0,0,0,2003
SC,parks and recreation,633,1574648,7,2398,371,635,1577046,2003
SC,housing and community development,0,0,0,0,0,0,0,2003
SC,natural resources,1999,5801446,168,144852,16053,2095,5946298,2003
SC,water transport and terminals,0,0,0,0,0,0,0,2003
SC,electric power,1708,8023565,17,59785,2139,1720,8083350,2003
SC,gas supply,0,0,0,0,0,0,0,2003
SC,transit,0,0,0,0,0,0,0,2003
SC,education - elementary and secondary instructional,0,0,0,0,0,0,0,2003
SC,education - elementary and secondary other,0,0,0,0,0,0,0,2003
SC,education - higher education instructional,8315,42003102,8855,8872905,520458,11439,50876007,2003
SC,education - higher education other,12407,32689053,10689,5620374,600988,15984,38309427,2003
SC,education - other,2796,8651520,19,25018,1044,2803,8676538,2003
SC,libraries,0,0,0,0,0,0,0,2003
SC,liquor stores,0,0,0,0,0,0,0,2003
SC,other and unallocable,1272,4148684,12,20360,646,1275,4169044,2003
SD,total,11375,35751003,4696,3172581,296363,13062,38923584,2003
SD,financial administration,323,1009800,28,22718,1554,332,1032518,2003
SD,other government administration,283,870308,51,61275,5402,314,931583,2003
SD,judicial and legal,513,1782572,91,94606,6609,551,1877178,2003
SD,police protection - officers,172,662695,4,4678,257,173,667373,2003
SD,police protection - other,102,266131,2,802,88,103,266933,2003
SD,corrections,745,1986547,58,72378,5934,779,2058925,2003
SD,highways,960,2907547,115,106292,9179,1012,3013839,2003
SD,air transportation,0,0,0,0,0,0,0,2003
SD,water transport and terminals,0,0,0,0,0,0,0,2003
SD,public welfare,967,2412434,70,104374,8537,1016,2516808,2003
SD,health,537,1698616,119,257083,12885,610,1955699,2003
SD,hospitals,841,2126897,162,223578,17840,943,2350475,2003
SD,social insurance administration,268,634238,12,16862,1346,276,651100,2003
SD,solid waste management,0,0,0,0,0,0,0,2003
SD,sewerage,0,0,0,0,0,0,0,2003
SD,parks and recreation,128,330172,23,20785,2358,141,350957,2003
SD,housing and community development,0,0,0,0,0,0,0,2003
SD,natural resources,760,2299461,329,143542,16316,853,2443003,2003
SD,water transport and terminals,0,0,0,0,0,0,0,2003
SD,electric power,0,0,0,0,0,0,0,2003
SD,gas supply,0,0,0,0,0,0,0,2003
SD,transit,0,0,0,0,0,0,0,2003
SD,education - elementary and secondary instructional,0,0,0,0,0,0,0,2003
SD,education - elementary and secondary other,0,0,0,0,0,0,0,2003
SD,education - higher education instructional,1291,7224630,998,1040031,79616,1744,8264661,2003
SD,education - higher education other,2230,5832441,2503,880396,118230,2902,6712837,2003
SD,education - other,380,1017687,38,36491,3561,400,1054178,2003
SD,libraries,0,0,0,0,0,0,0,2003
SD,liquor stores,0,0,0,0,0,0,0,2003
SD,other and unallocable,875,2688827,93,86690,6651,913,2775517,2003
TN,total,71823,220846723,25045,25578754,1993039,83495,246425477,2003
TN,financial administration,2687,9031765,42,50211,3642,2708,9081976,2003
TN,other government administration,803,2605822,40,45335,2398,817,2651157,2003
TN,judicial and legal,2024,8645030,6,6198,416,2026,8651228,2003
TN,police protection - officers,1094,4044016,0,0,0,1094,4044016,2003
TN,police protection - other,904,2391708,6,3442,444,907,2395150,2003
TN,corrections,6831,16347818,57,80430,4524,6858,16428248,2003
TN,highways,4532,11957466,0,0,0,4532,11957466,2003
TN,air transportation,0,0,0,0,0,0,0,2003
TN,water transport and terminals,0,0,0,0,0,0,0,2003
TN,public welfare,5835,14758928,8,11074,588,5839,14770002,2003
TN,health,3100,9314174,124,154969,8664,3150,9469143,2003
TN,hospitals,8967,28334422,368,969644,57897,9297,29304066,2003
TN,social insurance administration,1403,3835250,192,243658,20208,1525,4078908,2003
TN,solid waste management,0,0,0,0,0,0,0,2003
TN,sewerage,0,0,0,0,0,0,0,2003
TN,parks and recreation,982,1897784,63,38896,5990,1018,1936680,2003
TN,housing and community development,0,0,0,0,0,0,0,2003
TN,natural resources,3105,9143254,645,696314,71296,3518,9839568,2003
TN,water transport and terminals,0,0,0,0,0,0,0,2003
TN,electric power,0,0,0,0,0,0,0,2003
TN,gas supply,0,0,0,0,0,0,0,2003
TN,transit,0,0,0,0,0,0,0,2003
TN,education - elementary and secondary instructional,0,0,0,0,0,0,0,2003
TN,education - elementary and secondary other,0,0,0,0,0,0,0,2003
TN,education - higher education instructional,8636,43965967,7658,10061055,546416,11863,54027022,2003
TN,education - higher education other,16340,41242253,15583,13046913,1258557,23692,54289166,2003
TN,education - other,1866,5498306,188,129438,9778,1924,5627744,2003
TN,libraries,0,0,0,0,0,0,0,2003
TN,liquor stores,0,0,0,0,0,0,0,2003
TN,other and unallocable,2714,7832760,65,41177,2221,2727,7873937,2003
TX,total,239121,808783857,64842,73132054,4678128,265748,881915911,2003
TX,financial administration,9268,31022169,236,279976,18684,9374,31302145,2003
TX,other government administration,2370,7815613,758,774952,52955,2712,8590565,2003
TX,judicial and legal,5239,21299778,89,202495,11419,5305,21502273,2003
TX,police protection - officers,2108,7714831,0,0,0,2108,7714831,2003
TX,police protection - other,1896,5138905,32,32445,2560,1911,5171350,2003
TX,corrections,45662,110424213,739,810415,67637,46046,111234628,2003
TX,highways,15751,48764281,507,1128131,44638,16004,49892412,2003
TX,air transportation,0,0,0,0,0,0,0,2003
TX,water transport and terminals,0,0,0,0,0,0,0,2003
TX,public welfare,19957,53857503,149,249032,15953,20047,54106535,2003
TX,health,12283,39724235,830,1513301,79464,12737,41237536,2003
TX,hospitals,29477,91483069,2071,4174584,240488,30845,95657653,2003
TX,social insurance administration,4571,13607380,55,82394,5480,4602,13689774,2003
TX,solid waste management,0,0,0,0,0,0,0,2003
TX,sewerage,0,0,0,0,0,0,0,2003
TX,parks and recreation,988,2543946,184,121048,20764,1106,2664994,2003
TX,housing and community development,0,0,0,0,0,0,0,2003
TX,natural resources,10315,36100249,3123,4380702,197479,11438,40480951,2003
TX,water transport and terminals,0,0,0,0,0,0,0,2003
TX,electric power,0,0,0,0,0,0,0,2003
TX,gas supply,0,0,0,0,0,0,0,2003
TX,transit,0,0,0,0,0,0,0,2003
TX,education - elementary and secondary instructional,13,41827,0,0,0,13,41827,2003
TX,education - elementary and secondary other,0,0,0,0,0,0,0,2003
TX,education - higher education instructional,18755,133186261,19635,31207497,1479549,27163,164393758,2003
TX,education - higher education other,49272,168741062,35172,26603350,2344544,62593,195344412,2003
TX,education - other,4536,14977839,620,1031161,63989,4900,16009000,2003
TX,libraries,0,0,0,0,0,0,0,2003
TX,liquor stores,0,0,0,0,0,0,0,2003
TX,other and unallocable,6660,22340696,642,540571,32525,6844,22881267,2003
UT,total,40834,138124872,18657,15016293,1203718,47674,153141165,2003
UT,financial administration,1561,5155807,267,256199,28185,1721,5412006,2003
UT,other government administration,184,835797,103,121697,10984,247,957494,2003
UT,judicial and legal,1411,5274592,232,422143,21211,1533,5696735,2003
UT,police protection - officers,465,1615835,0,0,0,465,1615835,2003
UT,police protection - other,358,1229182,70,65091,5499,389,1294273,2003
UT,corrections,2983,8852220,282,210901,19862,3096,9063121,2003
UT,highways,1780,6434419,51,82148,6339,1816,6516567,2003
UT,air transportation,0,0,0,0,0,0,0,2003
UT,water transport and terminals,0,0,0,0,0,0,0,2003
UT,public welfare,3031,8984687,361,528009,33187,3219,9512696,2003
UT,health,1795,5854514,293,431946,23873,1929,6286460,2003
UT,hospitals,5463,15169778,365,371128,30795,5638,15540906,2003
UT,social insurance administration,764,2389645,83,114581,7005,804,2504226,2003
UT,solid waste management,0,0,0,0,0,0,0,2003
UT,sewerage,0,0,0,0,0,0,0,2003
UT,parks and recreation,240,776145,55,53260,5717,272,829405,2003
UT,housing and community development,0,0,0,0,0,0,0,2003
UT,natural resources,1043,3749880,205,211791,15226,1130,3961671,2003
UT,water transport and terminals,0,0,0,0,0,0,0,2003
UT,electric power,0,0,0,0,0,0,0,2003
UT,gas supply,0,0,0,0,0,0,0,2003
UT,transit,0,0,0,0,0,0,0,2003
UT,education - elementary and secondary instructional,0,0,0,0,0,0,0,2003
UT,education - elementary and secondary other,0,0,0,0,0,0,0,2003
UT,education - higher education instructional,4176,27529510,3100,3314869,172770,5158,30844379,2003
UT,education - higher education other,12936,35393944,12147,7745124,735558,17114,43139068,2003
UT,education - other,795,2591041,480,624173,44858,1049,3215214,2003
UT,libraries,0,0,0,0,0,0,0,2003
UT,liquor stores,224,545233,268,146235,18263,328,691468,2003
UT,other and unallocable,1625,5742643,295,316998,24386,1766,6059641,2003
VT,total,12395,44700786,2714,3380047,195498,13538,48080833,2003
VT,financial administration,549,1834811,14,32342,1692,558,1867153,2003
VT,other government administration,487,1514028,199,481951,28108,647,1995979,2003
VT,judicial and legal,548,2147042,51,102790,5588,579,2249832,2003
VT,police protection - officers,292,1571851,23,22025,1694,302,1593876,2003
VT,police protection - other,88,281576,0,0,0,88,281576,2003
VT,corrections,974,3211786,15,32400,1844,984,3244186,2003
VT,highways,1044,3521808,13,38621,1849,1055,3560429,2003
VT,air transportation,0,0,0,0,0,0,0,2003
VT,water transport and terminals,0,0,0,0,0,0,0,2003
VT,public welfare,1125,3826262,60,156842,7454,1167,3983104,2003
VT,health,524,1968605,324,459817,33190,712,2428422,2003
VT,hospitals,186,575970,7,16833,697,190,592803,2003
VT,social insurance administration,312,1038173,19,50882,2907,329,1089055,2003
VT,solid waste management,0,0,0,0,0,0,0,2003
VT,sewerage,0,0,0,0,0,0,0,2003
VT,parks and recreation,126,443331,5,16851,739,130,460182,2003
VT,housing and community development,0,0,0,0,0,0,0,2003
VT,natural resources,501,1952773,65,243144,8376,550,2195917,2003
VT,water transport and terminals,0,0,0,0,0,0,0,2003
VT,electric power,0,0,0,0,0,0,0,2003
VT,gas supply,0,0,0,0,0,0,0,2003
VT,transit,0,0,0,0,0,0,0,2003
VT,education - elementary and secondary instructional,0,0,0,0,0,0,0,2003
VT,education - elementary and secondary other,0,0,0,0,0,0,0,2003
VT,education - higher education instructional,1283,7222629,437,659916,25396,1436,7882545,2003
VT,education - higher education other,2719,7755286,1332,782021,60334,3083,8537307,2003
VT,education - other,535,1942345,55,103863,5821,569,2046208,2003
VT,libraries,0,0,0,0,0,0,0,2003
VT,liquor stores,57,199592,1,1014,93,58,200606,2003
VT,other and unallocable,1045,3692918,94,178735,9716,1101,3871653,2003
VA,total,100269,348750236,45378,42226004,2733270,115818,390976240,2003
VA,financial administration,3809,13028184,315,360344,33586,4000,13388528,2003
VA,other government administration,510,2069052,280,531420,30198,686,2600472,2003
VA,judicial and legal,3319,12918760,383,544062,20456,3439,13462822,2003
VA,police protection - officers,1860,7957120,0,0,0,1860,7957120,2003
VA,police protection - other,738,2074728,156,159706,13084,812,2234434,2003
VA,corrections,13778,36338474,269,307784,23830,13914,36646258,2003
VA,highways,10128,34438500,810,1027740,79662,10581,35466240,2003
VA,air transportation,0,0,0,0,0,0,0,2003
VA,water transport and terminals,137,591956,5,442,44,137,592398,2003
VA,public welfare,2028,6678898,148,266840,14888,2113,6945738,2003
VA,health,4755,16101410,487,576290,42637,4997,16677700,2003
VA,hospitals,12574,35839190,1179,2027706,106102,13178,37866896,2003
VA,social insurance administration,1240,4087508,542,832920,68052,1627,4920428,2003
VA,solid waste management,0,0,0,0,0,0,0,2003
VA,sewerage,0,0,0,0,0,0,0,2003
VA,parks and recreation,595,1669543,631,427484,43805,844,2097027,2003
VA,housing and community development,0,0,0,0,0,0,0,2003
VA,natural resources,3034,9684063,345,357132,29777,3204,10041195,2003
VA,water transport and terminals,0,0,0,0,0,0,0,2003
VA,electric power,0,0,0,0,0,0,0,2003
VA,gas supply,0,0,0,0,0,0,0,2003
VA,transit,0,0,0,0,0,0,0,2003
VA,education - elementary and secondary instructional,0,0,0,0,0,0,0,2003
VA,education - elementary and secondary other,0,0,0,0,0,0,0,2003
VA,education - higher education instructional,12709,72546543,13922,18978645,788965,17194,91525188,2003
VA,education - higher education other,22215,67821703,23869,13534082,1253169,29339,81355785,2003
VA,education - other,2612,9002802,553,618824,34140,2806,9621626,2003
VA,libraries,0,0,0,0,0,0,0,2003
VA,liquor stores,736,2064178,943,927092,99210,1300,2991270,2003
VA,other and unallocable,3492,13837624,541,747491,51665,3787,14585115,2003
WA,total,93492,362894629,52598,51482492,3353554,112606,414377121,2003
WA,financial administration,2582,10063500,232,498688,25131,2726,10562188,2003
WA,other government administration,1285,4743814,221,514086,23618,1419,5257900,2003
WA,judicial and legal,1752,9225735,190,377200,15818,1844,9602935,2003
WA,police protection - officers,983,5099582,0,0,0,983,5099582,2003
WA,police protection - other,1229,4682804,0,0,0,1229,4682804,2003
WA,corrections,8763,28860766,571,875976,51808,9058,29736742,2003
WA,highways,6369,27840972,727,1349556,82152,6835,29190528,2003
WA,air transportation,0,0,0,0,0,0,0,2003
WA,water transport and terminals,0,0,0,0,0,0,0,2003
WA,public welfare,8243,30967254,850,1617620,85830,8731,32584874,2003
WA,health,4729,16794890,1047,1815342,104543,5323,18610232,2003
WA,hospitals,7503,29005985,2882,6558448,239154,8861,35564433,2003
WA,social insurance administration,3642,13079651,914,1572925,87748,4141,14652576,2003
WA,solid waste management,147,570668,15,54826,1711,157,625494,2003
WA,sewerage,0,0,0,0,0,0,0,2003
WA,parks and recreation,531,1840940,144,206208,17122,628,2047148,2003
WA,housing and community development,0,0,0,0,0,0,0,2003
WA,natural resources,4654,17717728,691,1096772,76995,5091,18814500,2003
WA,water transport and terminals,0,0,0,0,0,0,0,2003
WA,electric power,0,0,0,0,0,0,0,2003
WA,gas supply,0,0,0,0,0,0,0,2003
WA,transit,0,0,0,0,0,0,0,2003
WA,education - elementary and secondary instructional,0,0,0,0,0,0,0,2003
WA,education - elementary and secondary other,0,0,0,0,0,0,0,2003
WA,education - higher education instructional,10633,52310376,12347,18813122,644228,14302,71123498,2003
WA,education - higher education other,23260,83024164,29884,13783442,1758090,33289,96807606,2003
WA,education - other,1780,6950352,964,810470,45677,2050,7760822,2003
WA,libraries,0,0,0,0,0,0,0,2003
WA,liquor stores,475,1488144,479,729692,55816,792,2217836,2003
WA,other and unallocable,4932,18627304,440,808119,38113,5147,19435423,2003
WV,total,34721,102052266,9139,6239256,415970,37215,108291522,2003
WV,financial administration,2359,6086338,33,43350,3720,2381,6129688,2003
WV,other government administration,266,818834,307,691407,21207,400,1510241,2003
WV,judicial and legal,1320,4201766,30,49118,2516,1335,4250884,2003
WV,police protection - officers,616,2243530,0,0,0,616,2243530,2003
WV,police protection - other,343,717351,11,6296,794,348,723647,2003
WV,corrections,3028,6121990,14,16290,1494,3037,6138280,2003
WV,highways,5374,15359648,42,66014,5240,5403,15425662,2003
WV,air transportation,2,10709,0,0,0,2,10709,2003
WV,water transport and terminals,3,12045,0,0,0,3,12045,2003
WV,public welfare,3130,7159050,25,35316,3736,3152,7194366,2003
WV,health,821,2281332,33,36920,3692,842,2318252,2003
WV,hospitals,1544,3407094,150,190012,19474,1656,3597106,2003
WV,social insurance administration,729,1926248,68,67712,6104,766,1993960,2003
WV,solid waste management,13,37990,0,0,0,13,37990,2003
WV,sewerage,0,0,0,0,0,0,0,2003
WV,parks and recreation,419,836906,311,157820,26042,567,994726,2003
WV,housing and community development,0,0,0,0,0,0,0,2003
WV,natural resources,2200,6802160,185,161132,17142,2301,6963292,2003
WV,water transport and terminals,0,0,0,0,0,0,0,2003
WV,electric power,0,0,0,0,0,0,0,2003
WV,gas supply,0,0,0,0,0,0,0,2003
WV,transit,8,22336,0,0,0,8,22336,2003
WV,education - elementary and secondary instructional,0,0,0,0,0,0,0,2003
WV,education - elementary and secondary other,0,0,0,0,0,0,0,2003
WV,education - higher education instructional,3208,16087087,3387,3024611,114675,3898,19111698,2003
WV,education - higher education other,5783,16901472,4239,1456905,172691,6825,18358377,2003
WV,education - other,1357,4310533,187,133644,8204,1406,4444177,2003
WV,libraries,0,0,0,0,0,0,0,2003
WV,liquor stores,59,154164,1,240,24,59,154404,2003
WV,other and unallocable,2139,6553683,116,102469,9215,2197,6656152,2003
WI,total,55579,226339917,41644,41909033,2720524,71040,268248950,2003
WI,financial administration,2689,10342477,692,1005517,72667,3101,11347994,2003
WI,other government administration,947,3745800,275,696617,31043,1123,4442417,2003
WI,judicial and legal,1846,10144615,287,773710,34593,2050,10918325,2003
WI,police protection - officers,615,2461501,0,0,0,615,2461501,2003
WI,police protection - other,286,940172,24,25705,2196,298,965877,2003
WI,corrections,8721,28146493,949,2056202,106255,9325,30202695,2003
WI,highways,1801,7125602,237,281851,18903,1908,7407453,2003
WI,air transportation,0,0,0,0,0,0,0,2003
WI,water transport and terminals,0,0,0,0,0,0,0,2003
WI,public welfare,1141,3892488,332,558384,35261,1341,4450872,2003
WI,health,1537,6222740,599,947917,50135,1822,7170657,2003
WI,hospitals,3184,10052725,1358,2017333,114685,3835,12070058,2003
WI,social insurance administration,1034,3718047,46,65922,3288,1052,3783969,2003
WI,solid waste management,0,0,0,0,0,0,0,2003
WI,sewerage,0,0,0,0,0,0,0,2003
WI,parks and recreation,154,520002,117,146976,9545,208,666978,2003
WI,housing and community development,0,0,0,0,0,0,0,2003
WI,natural resources,1935,7121748,1018,1444426,82050,2400,8566174,2003
WI,water transport and terminals,0,0,0,0,0,0,0,2003
WI,electric power,0,0,0,0,0,0,0,2003
WI,gas supply,0,0,0,0,0,0,0,2003
WI,transit,0,0,0,0,0,0,0,2003
WI,education - elementary and secondary instructional,0,0,0,0,0,0,0,2003
WI,education - elementary and secondary other,0,0,0,0,0,0,0,2003
WI,education - higher education instructional,7803,46928374,9175,10611603,604042,11235,57539977,2003
WI,education - higher education other,15450,60442495,24999,18814024,1420890,23523,79256519,2003
WI,education - other,1059,4048214,269,376912,21116,1179,4425126,2003
WI,libraries,0,0,0,0,0,0,0,2003
WI,liquor stores,0,0,0,0,0,0,0,2003
WI,other and unallocable,5377,20486424,1267,2085934,113855,6025,22572358,2003
WY,total,10742,34427782,3561,2815222,240044,12103,37243004,2003
WY,financial administration,521,1903313,8,15887,693,524,1919200,2003
WY,other government administration,97,383055,183,263921,19092,205,646976,2003
WY,judicial and legal,468,1826831,27,30495,2340,481,1857326,2003
WY,police protection - officers,167,725060,0,0,0,167,725060,2003
WY,police protection - other,82,296408,0,0,0,82,296408,2003
WY,corrections,964,2853085,4,6675,347,966,2859760,2003
WY,highways,1747,5714460,119,178293,16600,1841,5892753,2003
WY,air transportation,0,0,0,0,0,0,0,2003
WY,water transport and terminals,0,0,0,0,0,0,0,2003
WY,public welfare,909,2233957,84,100129,9584,964,2334086,2003
WY,health,488,1752340,113,212795,14518,571,1965135,2003
WY,hospitals,893,2025758,115,66812,9373,946,2092570,2003
WY,social insurance administration,252,755748,40,74373,3467,272,830121,2003
WY,solid waste management,0,0,0,0,0,0,0,2003
WY,sewerage,0,0,0,0,0,0,0,2003
WY,parks and recreation,107,274721,6,7898,520,110,282619,2003
WY,housing and community development,0,0,0,0,0,0,0,2003
WY,natural resources,794,2522011,19,24361,1533,802,2546372,2003
WY,water transport and terminals,0,0,0,0,0,0,0,2003
WY,electric power,0,0,0,0,0,0,0,2003
WY,gas supply,0,0,0,0,0,0,0,2003
WY,transit,0,0,0,0,0,0,0,2003
WY,education - elementary and secondary instructional,0,0,0,0,0,0,0,2003
WY,education - elementary and secondary other,0,0,0,0,0,0,0,2003
WY,education - higher education instructional,779,3964437,803,779068,47971,1052,4743505,2003
WY,education - higher education other,1502,4299212,2006,1015539,111170,2134,5314751,2003
WY,education - other,195,646748,5,5707,434,197,652455,2003
WY,libraries,0,0,0,0,0,0,0,2003
WY,liquor stores,31,97222,0,0,0,31,97222,2003
WY,other and unallocable,746,2153416,29,33269,2402,758,2186685,2003
