state,government_function,full_time_employees,full_time_pay,part_time_employees,part_time_pay,part_time_hours,full_time_equivalent_employees,total_march_pay,year
US,total,3635273,13976250802,1405870,1501270606,96075761,4187648,15477521408,2004
US,financial administration,160327,583412613,12528,19584790,1303161,167793,602997403,2004
US,other government administration,46569,179941836,11922,22133252,1143236,53194,202075088,2004
US,judicial and legal,158225,683679199,9839,20159820,912978,163474,703839019,2004
US,police protection - officers,61810,294254219,767,971964,30883,61986,295226183,2004
US,police protection - other,40164,143451119,1946,2108678,140063,40965,145559797,2004
US,corrections,453402,1531233264,11289,22596141,1218707,460368,1553829405,2004
US,highways,233885,833773718,10137,17682239,999842,239638,851455957,2004
US,air transportation,3216,14227542,186,294826,14612,3299,14522368,2004
US,water transport and terminals,4705,20007965,69,117335,7102,4746,20125300,2004
US,public welfare,219466,702194675,9623,17659921,1061832,225569,719854596,2004
US,health,166563,599720665,13446,26060756,1351878,174301,625781421,2004
US,hospitals,366521,1236085722,57105,116837222,5736561,399170,1352922944,2004
US,social insurance administration,83362,297920543,9393,16973177,1076224,89557,314893720,2004
US,solid waste management,1731,8112129,121,316181,13043,1806,8428310,2004
US,sewerage,1732,8943590,32,108254,4169,1756,9051844,2004
US,parks and recreation,27366,83660783,13842,16217335,1416720,35474,99878118,2004
US,housing and community development,0,0,0,0,0,0,0,2004
US,natural resources,130925,470479596,30587,38827939,2768707,146799,509307535,2004
US,water transport and terminals,648,3137324,25,68283,2851,664,3205607,2004
US,electric power,3998,22473200,44,126324,4973,4026,22599524,2004
US,gas supply,0,0,0,0,0,0,0,2004
US,transit,31720,156668384,2024,3285020,217833,32958,159953404,2004
US,education - elementary and secondary instructional,33773,144196847,10802,9849362,541873,37012,154046209,2004
US,education - elementary and secondary other,11091,32140752,7633,5104310,404682,13559,37245062,2004
US,education - higher education instructional,358634,2145169705,377641,531495427,24354892,498835,2676665132,2004
US,education - higher education other,753179,2654095074,784184,567050370,48792015,1033792,3221145444,2004
US,education - other,84546,307351148,10912,15327395,874637,89557,322678543,2004
US,libraries,482,1441018,240,142716,16004,573,1583734,2004
US,liquor stores,5643,16241380,3398,2770186,272036,7215,19011566,2004
US,other and unallocable,191590,802236792,16135,27401383,1394247,199562,829638175,2004
AL,total,73906,256614142,27255,28365167,2040781,85647,284979309,2004
AL,financial administration,2546,8749278,67,60424,6925,2586,8809702,2004
AL,other government administration,550,2096456,91,107336,6252,585,2203792,2004
AL,judicial and legal,2964,11945513,105,148316,2950,2980,12093829,2004
AL,police protection - officers,636,2862399,0,0,0,636,2862399,2004
AL,police protection - other,595,1726284,0,0,0,595,1726284,2004
AL,corrections,4713,14963808,5,4317,421,4715,14968125,2004
AL,highways,4254,11630266,91,73903,8059,4300,11704169,2004
AL,air transportation,0,0,0,0,0,0,0,2004
AL,water transport and terminals,471,1844501,1,1200,40,471,1845701,2004
AL,public welfare,4324,12857356,36,56647,3496,4344,12914003,2004
AL,health,5009,15380311,436,458687,55173,5323,15838998,2004
AL,hospitals,10615,32533397,1615,2912256,140344,11412,35445653,2004
AL,social insurance administration,1208,3638764,34,23141,3011,1225,3661905,2004
AL,solid waste management,0,0,0,0,0,0,0,2004
AL,sewerage,0,0,0,0,0,0,0,2004
AL,parks and recreation,556,1327457,248,184041,26841,709,1511498,2004
AL,housing and community development,0,0,0,0,0,0,0,2004
AL,natural resources,2070,6662074,218,211194,20145,2184,6873268,2004
AL,water transport and terminals,0,0,0,0,0,0,0,2004
AL,electric power,0,0,0,0,0,0,0,2004
AL,gas supply,0,0,0,0,0,0,0,2004
AL,transit,0,0,0,0,0,0,0,2004
AL,education - elementary and secondary instructional,0,0,0,0,0,0,0,2004
AL,education - elementary and secondary other,0,0,0,0,0,0,0,2004
AL,education - higher education instructional,9009,52459265,8467,11766603,525918,12056,64225868,2004
AL,education - higher education other,19104,59265960,15290,11826502,1182190,25908,71092462,2004
AL,education - other,2659,8695083,82,58954,5850,2692,8754037,2004
AL,libraries,0,0,0,0,0,0,0,2004
AL,liquor stores,642,1436200,6,10149,817,647,1446349,2004
AL,other and unallocable,1981,6539770,463,461497,52349,2279,7001267,2004
AK,total,22579,93684753,5542,5654556,358366,24657,99339309,2004
AK,financial administration,934,3957801,22,34529,1790,946,3992330,2004
AK,other government administration,606,2349427,43,59242,3512,628,2408669,2004
AK,judicial and legal,1182,5272871,74,123642,5414,1215,5396513,2004
AK,police protection - officers,273,1638695,2,699,55,273,1639394,2004
AK,police protection - other,193,652828,54,21175,1628,203,674003,2004
AK,corrections,1758,7125480,29,36395,2710,1775,7161875,2004
AK,highways,2947,13056098,23,36033,2450,2962,13092131,2004
AK,air transportation,0,0,0,0,0,0,0,2004
AK,water transport and terminals,0,0,0,0,0,0,0,2004
AK,public welfare,1674,5958182,126,155876,15011,1764,6114058,2004
AK,health,658,2886988,24,45165,2079,671,2932153,2004
AK,hospitals,248,1015434,19,34659,2825,264,1050093,2004
AK,social insurance administration,429,1573954,3,3256,205,430,1577210,2004
AK,solid waste management,0,0,0,0,0,0,0,2004
AK,sewerage,0,0,0,0,0,0,0,2004
AK,parks and recreation,74,274653,2,2685,145,75,277338,2004
AK,housing and community development,0,0,0,0,0,0,0,2004
AK,natural resources,2237,8964759,114,166139,10367,2297,9130898,2004
AK,water transport and terminals,0,0,0,0,0,0,0,2004
AK,electric power,0,0,0,0,0,0,0,2004
AK,gas supply,0,0,0,0,0,0,0,2004
AK,transit,0,0,0,0,0,0,0,2004
AK,education - elementary and secondary instructional,1866,7322003,582,477607,34439,2071,7799610,2004
AK,education - elementary and secondary other,887,2282085,756,597759,39791,1126,2879844,2004
AK,education - higher education instructional,915,5715634,1006,1123926,31812,1096,6839560,2004
AK,education - higher education other,2554,9773169,2582,2646272,199147,3686,12419441,2004
AK,education - other,418,1664687,23,16924,1146,425,1681611,2004
AK,libraries,0,0,0,0,0,0,0,2004
AK,liquor stores,0,0,0,0,0,0,0,2004
AK,other and unallocable,2726,12200005,58,72573,3840,2750,12272578,2004
AZ,total,55884,192573002,26473,23435900,1783896,66026,216008902,2004
AZ,financial administration,3659,11075016,37,64827,3616,3680,11139843,2004
AZ,other government administration,581,2028105,166,274230,15870,672,2302335,2004
AZ,judicial and legal,1243,5882088,96,200925,10128,1300,6083013,2004
AZ,police protection - officers,1122,4613338,0,0,0,1122,4613338,2004
AZ,police protection - other,891,3396959,1,1612,124,892,3398571,2004
AZ,corrections,9867,27923331,54,148320,4959,9895,28071651,2004
AZ,highways,2875,9157093,0,0,0,2875,9157093,2004
AZ,air transportation,0,0,0,0,0,0,0,2004
AZ,water transport and terminals,0,0,0,0,0,0,0,2004
AZ,public welfare,5285,13982524,101,159353,9983,5349,14141877,2004
AZ,health,2374,8331666,41,87229,4386,2399,8418895,2004
AZ,hospitals,722,2276103,48,99187,4497,748,2375290,2004
AZ,social insurance administration,1711,4211210,12,15972,1266,1718,4227182,2004
AZ,solid waste management,0,0,0,0,0,0,0,2004
AZ,sewerage,0,0,0,0,0,0,0,2004
AZ,parks and recreation,380,1030335,127,70292,9173,432,1100627,2004
AZ,housing and community development,0,0,0,0,0,0,0,2004
AZ,natural resources,2478,9482093,861,1081413,72158,2888,10563506,2004
AZ,water transport and terminals,0,0,0,0,0,0,0,2004
AZ,electric power,9,50832,0,0,0,9,50832,2004
AZ,gas supply,0,0,0,0,0,0,0,2004
AZ,transit,0,0,0,0,0,0,0,2004
AZ,education - elementary and secondary instructional,0,0,0,0,0,0,0,2004
AZ,education - elementary and secondary other,0,0,0,0,0,0,0,2004
AZ,education - higher education instructional,5140,29571158,7262,9179827,538298,8198,38750985,2004
AZ,education - higher education other,11655,42046326,17038,11320443,1062906,17694,53366769,2004
AZ,education - other,2666,7341850,470,561858,35717,2869,7903708,2004
AZ,libraries,0,0,0,0,0,0,0,2004
AZ,liquor stores,0,0,0,0,0,0,0,2004
AZ,other and unallocable,3226,10172975,159,170412,10815,3286,10343387,2004
AR,total,49281,154242924,14396,9818488,831186,54005,164061412,2004
AR,financial administration,1855,5272682,38,39511,4670,1881,5312193,2004
AR,other government administration,640,2289408,10,14530,970,647,2303938,2004
AR,judicial and legal,1245,3480928,115,311479,10623,1305,3792407,2004
AR,police protection - officers,512,1887069,0,0,0,512,1887069,2004
AR,police protection - other,543,1438432,4,3193,294,545,1441625,2004
AR,corrections,4476,10613759,0,0,0,4476,10613759,2004
AR,highways,3555,10649958,43,29818,743,3559,10679776,2004
AR,air transportation,0,0,0,0,0,0,0,2004
AR,water transport and terminals,0,0,0,0,0,0,0,2004
AR,public welfare,3639,9356700,153,207078,14041,3719,9563778,2004
AR,health,4516,12339160,202,268169,18755,4623,12607329,2004
AR,hospitals,4213,11712387,236,350523,19014,4321,12062910,2004
AR,social insurance administration,885,2809480,231,249198,24410,1023,3058678,2004
AR,solid waste management,0,0,0,0,0,0,0,2004
AR,sewerage,0,0,0,0,0,0,0,2004
AR,parks and recreation,621,1408487,242,147665,22636,750,1556152,2004
AR,housing and community development,0,0,0,0,0,0,0,2004
AR,natural resources,1759,4792713,413,263973,35228,1957,5056686,2004
AR,water transport and terminals,0,0,0,0,0,0,0,2004
AR,electric power,0,0,0,0,0,0,0,2004
AR,gas supply,0,0,0,0,0,0,0,2004
AR,transit,0,0,0,0,0,0,0,2004
AR,education - elementary and secondary instructional,0,0,0,0,0,0,0,2004
AR,education - elementary and secondary other,0,0,0,0,0,0,0,2004
AR,education - higher education instructional,6074,33918283,4304,4336032,254671,7524,38254315,2004
AR,education - higher education other,11081,31022086,8175,3332823,404543,13381,34354909,2004
AR,education - other,1316,3960488,44,47463,3064,1333,4007951,2004
AR,libraries,0,0,0,0,0,0,0,2004
AR,liquor stores,0,0,0,0,0,0,0,2004
AR,other and unallocable,2351,7290904,186,217033,17524,2449,7507937,2004
CA,total,327744,1670278308,146096,220532627,11493583,393057,1890810935,2004
CA,financial administration,19383,77985781,3819,5951397,387867,21587,83937178,2004
CA,other government administration,3669,17830084,390,947193,32035,3865,18777277,2004
CA,judicial and legal,3979,23995090,423,977937,33687,4171,24973027,2004
CA,police protection - officers,7920,48608716,542,551579,11017,7983,49160295,2004
CA,police protection - other,5331,19926550,664,642493,35326,5532,20569043,2004
CA,corrections,47441,226937475,2975,8575749,396866,49696,235513224,2004
CA,highways,20118,114214931,921,2876539,123723,20820,117091470,2004
CA,air transportation,0,0,0,0,0,0,0,2004
CA,water transport and terminals,0,0,0,0,0,0,0,2004
CA,public welfare,3487,15170996,274,669654,34645,3683,15840650,2004
CA,health,10748,56151806,1376,4527436,184915,11797,60679242,2004
CA,hospitals,34263,156334597,8424,19903495,826951,38962,176238092,2004
CA,social insurance administration,18593,72498754,2259,4615613,253360,20033,77114367,2004
CA,solid waste management,360,1827285,60,190536,7085,400,2017821,2004
CA,sewerage,0,0,0,0,0,0,0,2004
CA,parks and recreation,2244,9581353,1482,2362653,166478,3189,11944006,2004
CA,housing and community development,0,0,0,0,0,0,0,2004
CA,natural resources,11661,56135533,2862,4360924,372422,13776,60496457,2004
CA,water transport and terminals,0,0,0,0,0,0,0,2004
CA,electric power,0,0,0,0,0,0,0,2004
CA,gas supply,0,0,0,0,0,0,0,2004
CA,transit,0,0,0,0,0,0,0,2004
CA,education - elementary and secondary instructional,0,0,0,0,0,0,0,2004
CA,education - elementary and secondary other,0,0,0,0,0,0,0,2004
CA,education - higher education instructional,20139,147722301,26316,44946134,1784332,30278,192668435,2004
CA,education - higher education other,79304,390000678,88754,106573809,6415133,115753,496574487,2004
CA,education - other,4216,18133763,553,974984,49572,4497,19108747,2004
CA,libraries,0,0,0,0,0,0,0,2004
CA,liquor stores,0,0,0,0,0,0,0,2004
CA,other and unallocable,34888,217222615,4002,10884502,378169,37035,228107117,2004
CO,total,49003,217929060,34097,48586734,2930575,65652,266515794,2004
CO,financial administration,2020,8994598,140,225635,11424,2085,9220233,2004
CO,other government administration,428,1542896,164,396094,25218,571,1938990,2004
CO,judicial and legal,2924,13139602,794,1824379,86499,3415,14963981,2004
CO,police protection - officers,756,3736019,7,21850,826,760,3757869,2004
CO,police protection - other,420,1505723,1,2159,77,420,1507882,2004
CO,corrections,6202,23892494,82,205355,9589,6257,24097849,2004
CO,highways,3030,12259510,163,351113,17963,3132,12610623,2004
CO,air transportation,0,0,0,0,0,0,0,2004
CO,water transport and terminals,0,0,0,0,0,0,0,2004
CO,public welfare,1700,7013672,436,832926,42265,1939,7846598,2004
CO,health,1048,5190722,153,408853,16485,1142,5599575,2004
CO,hospitals,3104,10988218,790,1513966,73347,3520,12502184,2004
CO,social insurance administration,924,3890196,111,205386,12131,993,4095582,2004
CO,solid waste management,0,0,0,0,0,0,0,2004
CO,sewerage,0,0,0,0,0,0,0,2004
CO,parks and recreation,232,993719,76,56473,3467,252,1050192,2004
CO,housing and community development,0,0,0,0,0,0,0,2004
CO,natural resources,1304,6011262,244,401733,16891,1400,6412995,2004
CO,water transport and terminals,0,0,0,0,0,0,0,2004
CO,electric power,0,0,0,0,0,0,0,2004
CO,gas supply,0,0,0,0,0,0,0,2004
CO,transit,0,0,0,0,0,0,0,2004
CO,education - elementary and secondary instructional,0,0,0,0,0,0,0,2004
CO,education - elementary and secondary other,0,0,0,0,0,0,0,2004
CO,education - higher education instructional,9818,59287859,9017,14153558,706645,13834,73441417,2004
CO,education - higher education other,12678,49627877,21272,26919308,1854520,23215,76547185,2004
CO,education - other,1039,4070941,549,852344,42847,1282,4923285,2004
CO,libraries,0,0,0,0,0,0,0,2004
CO,liquor stores,0,0,0,0,0,0,0,2004
CO,other and unallocable,1376,5783752,98,215602,10381,1435,5999354,2004
CT,total,50949,242795109,19974,27834225,1310751,58648,270629334,2004
CT,financial administration,2066,9112360,106,250004,10539,2126,9362364,2004
CT,other government administration,1094,4786839,250,864089,34365,1289,5650928,2004
CT,judicial and legal,4264,17148014,285,541709,10658,4324,17689723,2004
CT,police protection - officers,1422,7562548,8,21527,1269,1429,7584075,2004
CT,police protection - other,540,2355935,41,71270,3775,562,2427205,2004
CT,corrections,7388,33429169,145,433360,14849,7473,33862529,2004
CT,highways,2821,12261920,7,22051,1125,2827,12283971,2004
CT,air transportation,146,755767,0,0,0,146,755767,2004
CT,water transport and terminals,0,0,0,0,0,0,0,2004
CT,public welfare,4083,18542522,390,906903,37563,4296,19449425,2004
CT,health,1789,7912369,96,249073,10506,1848,8161442,2004
CT,hospitals,8933,45685519,2399,6826767,286568,10561,52512286,2004
CT,social insurance administration,659,2879834,57,155657,5170,688,3035491,2004
CT,solid waste management,43,247924,7,20455,908,48,268379,2004
CT,sewerage,0,0,0,0,0,0,0,2004
CT,parks and recreation,137,641066,8,9024,531,140,650090,2004
CT,housing and community development,0,0,0,0,0,0,0,2004
CT,natural resources,644,2910359,95,159895,6451,681,3070254,2004
CT,water transport and terminals,0,0,0,0,0,0,0,2004
CT,electric power,0,0,0,0,0,0,0,2004
CT,gas supply,0,0,0,0,0,0,0,2004
CT,transit,0,0,0,0,0,0,0,2004
CT,education - elementary and secondary instructional,0,0,0,0,0,0,0,2004
CT,education - elementary and secondary other,0,0,0,0,0,0,0,2004
CT,education - higher education instructional,3740,25313890,7498,11112585,439285,6353,36426475,2004
CT,education - higher education other,6958,31296672,7631,5058687,389111,9306,36355359,2004
CT,education - other,2121,10126700,691,755276,37731,2335,10881976,2004
CT,libraries,0,0,0,0,0,0,0,2004
CT,liquor stores,0,0,0,0,0,0,0,2004
CT,other and unallocable,2101,9825702,260,375893,20347,2216,10201595,2004
DE,total,21377,78942825,7648,7986408,476448,24254,86929233,2004
DE,financial administration,674,2327078,62,29335,2693,691,2356413,2004
DE,other government administration,228,886628,116,231788,9804,285,1118416,2004
DE,judicial and legal,1481,5072143,24,36624,1759,1491,5108767,2004
DE,police protection - officers,621,3593329,0,0,0,621,3593329,2004
DE,police protection - other,299,890924,6,11301,709,304,902225,2004
DE,corrections,2756,9176753,151,178910,13962,2839,9355663,2004
DE,highways,1585,4887631,32,48744,3325,1605,4936375,2004
DE,air transportation,0,0,0,0,0,0,0,2004
DE,water transport and terminals,251,905938,0,0,0,251,905938,2004
DE,public welfare,1439,4464504,135,248159,15705,1533,4712663,2004
DE,health,1812,6428171,181,268831,17594,1918,6697002,2004
DE,hospitals,1764,5338075,148,204926,12421,1839,5543001,2004
DE,social insurance administration,289,871988,18,38499,2464,304,910487,2004
DE,solid waste management,106,321907,13,13246,1375,114,335153,2004
DE,sewerage,0,0,0,0,0,0,0,2004
DE,parks and recreation,168,513971,140,102727,11093,235,616698,2004
DE,housing and community development,0,0,0,0,0,0,0,2004
DE,natural resources,420,1488784,118,101444,8600,472,1590228,2004
DE,water transport and terminals,0,0,0,0,0,0,0,2004
DE,electric power,0,0,0,0,0,0,0,2004
DE,gas supply,0,0,0,0,0,0,0,2004
DE,transit,623,2170984,34,40660,3030,640,2211644,2004
DE,education - elementary and secondary instructional,0,0,0,0,0,0,0,2004
DE,education - elementary and secondary other,0,0,0,0,0,0,0,2004
DE,education - higher education instructional,1565,9857824,2861,3880864,183240,2670,13738688,2004
DE,education - higher education other,3536,13059045,3316,2340272,174301,4595,15399317,2004
DE,education - other,358,1660712,12,25248,1456,366,1685960,2004
DE,libraries,0,0,0,0,0,0,0,2004
DE,liquor stores,0,0,0,0,0,0,0,2004
DE,other and unallocable,1402,5026436,281,184830,12917,1481,5211266,2004
FL,total,167147,567802368,41477,45913751,2836314,183265,613716119,2004
FL,financial administration,7269,24844155,190,188247,19164,7378,25032402,2004
FL,other government administration,2074,7752874,16,23809,1230,2081,7776683,2004
FL,judicial and legal,17782,66313344,407,811423,40213,18013,67124767,2004
FL,police protection - officers,1995,6914625,0,0,0,1995,6914625,2004
FL,police protection - other,2340,7866634,24,26763,2117,2352,7893397,2004
FL,corrections,27429,76004711,26,36482,2519,27443,76041193,2004
FL,highways,7758,27783701,26,34088,2510,7773,27817789,2004
FL,air transportation,0,0,0,0,0,0,0,2004
FL,water transport and terminals,0,0,0,0,0,0,0,2004
FL,public welfare,11694,31986905,69,98206,6188,11730,32085111,2004
FL,health,19380,56392476,1165,2168526,117954,20051,58561002,2004
FL,hospitals,4790,13316787,31,52333,2756,4806,13369120,2004
FL,social insurance administration,2565,7313655,36,57685,3739,2586,7371340,2004
FL,solid waste management,0,0,0,0,0,0,0,2004
FL,sewerage,0,0,0,0,0,0,0,2004
FL,parks and recreation,1450,2911055,35,21429,3231,1468,2932484,2004
FL,housing and community development,0,0,0,0,0,0,0,2004
FL,natural resources,9641,27211662,2113,1851577,129796,10379,29063239,2004
FL,water transport and terminals,0,0,0,0,0,0,0,2004
FL,electric power,0,0,0,0,0,0,0,2004
FL,gas supply,0,0,0,0,0,0,0,2004
FL,transit,611,2117970,40,6670,507,614,2124640,2004
FL,education - elementary and secondary instructional,0,0,0,0,0,0,0,2004
FL,education - elementary and secondary other,0,0,0,0,0,0,0,2004
FL,education - higher education instructional,14540,98658697,16880,22903561,1016679,20317,121562258,2004
FL,education - higher education other,25402,79659027,20210,17380446,1469649,33751,97039473,2004
FL,education - other,3434,9688196,58,88327,5411,3464,9776523,2004
FL,libraries,0,0,0,0,0,0,0,2004
FL,liquor stores,0,0,0,0,0,0,0,2004
FL,other and unallocable,6993,21065894,151,164179,12651,7064,21230073,2004
GA,total,106768,355837046,38256,35580105,2595116,121526,391417151,2004
GA,financial administration,4375,14791764,37,62725,2284,4388,14854489,2004
GA,other government administration,722,2572745,629,1282100,70617,1124,3854845,2004
GA,judicial and legal,2524,11553604,34,62080,1872,2535,11615684,2004
GA,police protection - officers,1160,4034950,0,0,0,1160,4034950,2004
GA,police protection - other,1037,3307670,22,31400,2180,1049,3339070,2004
GA,corrections,19218,47659780,562,913222,54880,19530,48573002,2004
GA,highways,5827,15747286,30,14988,700,5831,15762274,2004
GA,air transportation,0,0,0,0,0,0,0,2004
GA,water transport and terminals,788,3666207,0,0,0,788,3666207,2004
GA,public welfare,8701,22866684,143,199726,14708,8785,23066410,2004
GA,health,4307,13569502,240,277459,24344,4445,13846961,2004
GA,hospitals,8065,19966092,164,333116,16512,8158,20299208,2004
GA,social insurance administration,2091,6083316,149,222606,15156,2177,6305922,2004
GA,solid waste management,0,0,0,0,0,0,0,2004
GA,sewerage,0,0,0,0,0,0,0,2004
GA,parks and recreation,1299,3025903,2403,2769375,288122,2936,5795278,2004
GA,housing and community development,0,0,0,0,0,0,0,2004
GA,natural resources,4004,11936853,921,808586,70513,4405,12745439,2004
GA,water transport and terminals,0,0,0,0,0,0,0,2004
GA,electric power,0,0,0,0,0,0,0,2004
GA,gas supply,0,0,0,0,0,0,0,2004
GA,transit,0,0,0,0,0,0,0,2004
GA,education - elementary and secondary instructional,0,0,0,0,0,0,0,2004
GA,education - elementary and secondary other,0,0,0,0,0,0,0,2004
GA,education - higher education instructional,12672,70077289,13343,14649324,779383,17108,84726613,2004
GA,education - higher education other,23912,84333394,18988,12858839,1195603,30707,97192233,2004
GA,education - other,2738,9625452,421,950540,47705,3009,10575992,2004
GA,libraries,0,0,0,0,0,0,0,2004
GA,liquor stores,0,0,0,0,0,0,0,2004
GA,other and unallocable,3328,11018555,170,144019,10537,3391,11162574,2004
HI,total,49954,171676121,21552,19403824,1159242,56540,191079945,2004
HI,financial administration,622,2325580,3,7636,280,624,2333216,2004
HI,other government administration,648,2086020,139,247214,12141,717,2333234,2004
HI,judicial and legal,2250,8375794,61,101666,2947,2267,8477460,2004
HI,police protection - officers,0,0,0,0,0,0,0,2004
HI,police protection - other,0,0,0,0,0,0,0,2004
HI,corrections,2372,8638388,10,13118,796,2376,8651506,2004
HI,highways,879,3218038,0,0,0,879,3218038,2004
HI,air transportation,1000,3157080,10,12644,754,1004,3169724,2004
HI,water transport and terminals,199,683492,0,0,0,199,683492,2004
HI,public welfare,948,3206848,29,11262,2200,960,3218110,2004
HI,health,2465,8750986,76,175866,6992,2505,8926852,2004
HI,hospitals,3763,12645335,430,909891,36988,3975,13555226,2004
HI,social insurance administration,341,1120172,14,28180,1198,348,1148352,2004
HI,solid waste management,0,0,0,0,0,0,0,2004
HI,sewerage,0,0,0,0,0,0,0,2004
HI,parks and recreation,140,441380,184,120126,10824,201,561506,2004
HI,housing and community development,0,0,0,0,0,0,0,2004
HI,natural resources,1000,3968958,278,223820,16039,1091,4192778,2004
HI,water transport and terminals,0,0,0,0,0,0,0,2004
HI,electric power,0,0,0,0,0,0,0,2004
HI,gas supply,0,0,0,0,0,0,0,2004
HI,transit,0,0,0,0,0,0,0,2004
HI,education - elementary and secondary instructional,18689,60500848,8543,6944846,370736,20795,67445694,2004
HI,education - elementary and secondary other,4527,12129222,4754,2806280,225564,5809,14935502,2004
HI,education - higher education instructional,2110,11572003,1510,2673028,91168,2628,14245031,2004
HI,education - higher education other,3837,14592061,5218,4936979,360285,5884,19529040,2004
HI,education - other,147,490622,2,3878,160,148,494500,2004
HI,libraries,482,1441018,240,142716,16004,573,1583734,2004
HI,liquor stores,0,0,0,0,0,0,0,2004
HI,other and unallocable,3535,12332276,51,44674,4166,3557,12376950,2004
ID,total,18446,62118102,11269,10799066,836413,23198,72917168,2004
ID,financial administration,1374,4834650,171,171378,20408,1490,5006028,2004
ID,other government administration,157,586937,207,386609,19713,269,973546,2004
ID,judicial and legal,443,2331207,9,26404,425,445,2357611,2004
ID,police protection - officers,259,1040846,0,0,0,259,1040846,2004
ID,police protection - other,180,540393,47,47555,3963,203,587948,2004
ID,corrections,1722,4825968,35,58594,4198,1746,4884562,2004
ID,highways,1618,5170259,149,235528,25147,1761,5405787,2004
ID,air transportation,0,0,0,0,0,0,0,2004
ID,water transport and terminals,0,0,0,0,0,0,0,2004
ID,public welfare,1653,4872855,188,236900,24205,1791,5109755,2004
ID,health,1016,3447774,167,268087,15348,1104,3715861,2004
ID,hospitals,811,2299777,224,179540,15575,899,2479317,2004
ID,social insurance administration,548,1941955,253,478959,36447,755,2420914,2004
ID,solid waste management,0,0,0,0,0,0,0,2004
ID,sewerage,0,0,0,0,0,0,0,2004
ID,parks and recreation,155,450890,53,47174,4966,183,498064,2004
ID,housing and community development,0,0,0,0,0,0,0,2004
ID,natural resources,1573,5276173,674,1030159,65722,1946,6306332,2004
ID,water transport and terminals,0,0,0,0,0,0,0,2004
ID,electric power,0,0,0,0,0,0,0,2004
ID,gas supply,0,0,0,0,0,0,0,2004
ID,transit,0,0,0,0,0,0,0,2004
ID,education - elementary and secondary instructional,0,0,0,0,0,0,0,2004
ID,education - elementary and secondary other,0,0,0,0,0,0,0,2004
ID,education - higher education instructional,1969,8985887,2032,2645163,135939,2741,11631050,2004
ID,education - higher education other,3545,10853865,6602,4603604,427530,5973,15457469,2004
ID,education - other,443,1509191,130,155540,16709,538,1664731,2004
ID,libraries,0,0,0,0,0,0,0,2004
ID,liquor stores,113,330347,116,93344,9819,169,423691,2004
ID,other and unallocable,867,2819128,212,134528,10299,926,2953656,2004
IL,total,112831,461826137,47577,42820898,3466912,133672,504647035,2004
IL,financial administration,5247,19504781,233,361197,25624,5402,19865978,2004
IL,other government administration,1842,7629850,21,47110,1858,1852,7676960,2004
IL,judicial and legal,2992,19006664,82,152450,4124,3018,19159114,2004
IL,police protection - officers,2025,11376039,0,0,0,2025,11376039,2004
IL,police protection - other,1632,7273387,11,28845,1329,1640,7302232,2004
IL,corrections,14461,57231540,12,32730,1136,14468,57264270,2004
IL,highways,6996,28402039,1165,3102658,126030,7748,31504697,2004
IL,air transportation,0,0,0,0,0,0,0,2004
IL,water transport and terminals,77,366202,3,11024,336,79,377226,2004
IL,public welfare,10498,42740984,132,211580,8385,10549,42952564,2004
IL,health,2812,12455086,19,54568,1958,2824,12509654,2004
IL,hospitals,11561,41559899,669,1421228,67643,11962,42981127,2004
IL,social insurance administration,2106,9578318,338,959512,50380,2409,10537830,2004
IL,solid waste management,0,0,0,0,0,0,0,2004
IL,sewerage,0,0,0,0,0,0,0,2004
IL,parks and recreation,634,2297352,77,166972,9476,692,2464324,2004
IL,housing and community development,0,0,0,0,0,0,0,2004
IL,natural resources,2831,11236757,1142,1561732,166832,3835,12798489,2004
IL,water transport and terminals,0,0,0,0,0,0,0,2004
IL,electric power,0,0,0,0,0,0,0,2004
IL,gas supply,0,0,0,0,0,0,0,2004
IL,transit,0,0,0,0,0,0,0,2004
IL,education - elementary and secondary instructional,0,0,0,0,0,0,0,2004
IL,education - elementary and secondary other,0,0,0,0,0,0,0,2004
IL,education - higher education instructional,12232,64993149,14803,16549054,659851,16193,81542203,2004
IL,education - higher education other,25504,88066789,28608,17837087,2323141,39481,105903876,2004
IL,education - other,2372,9511944,19,34605,1551,2381,9546549,2004
IL,libraries,0,0,0,0,0,0,0,2004
IL,liquor stores,0,0,0,0,0,0,0,2004
IL,other and unallocable,7009,28595357,243,288546,17258,7114,28883903,2004
IN,total,75965,254893211,34263,31217585,2517362,90404,286110796,2004
IN,financial administration,2621,8060342,134,171422,18058,2729,8231764,2004
IN,other government administration,412,1469874,195,309835,15675,506,1779709,2004
IN,judicial and legal,1254,6401683,40,85800,4153,1279,6487483,2004
IN,police protection - officers,1178,5487594,0,0,0,1178,5487594,2004
IN,police protection - other,762,2025350,0,0,0,762,2025350,2004
IN,corrections,8185,22360561,15,29240,1559,8194,22389801,2004
IN,highways,4318,11490928,0,0,0,4318,11490928,2004
IN,air transportation,0,0,0,0,0,0,0,2004
IN,water transport and terminals,31,165252,1,874,84,32,166126,2004
IN,public welfare,5461,14217259,128,60954,7274,5506,14278213,2004
IN,health,1766,6056073,11,18463,908,1771,6074536,2004
IN,hospitals,4080,10498258,136,197314,15188,4171,10695572,2004
IN,social insurance administration,1344,3730585,216,237990,16105,1441,3968575,2004
IN,solid waste management,0,0,0,0,0,0,0,2004
IN,sewerage,0,0,0,0,0,0,0,2004
IN,parks and recreation,137,339683,34,33042,3587,158,372725,2004
IN,housing and community development,0,0,0,0,0,0,0,2004
IN,natural resources,2274,7826194,611,676806,57914,2616,8503000,2004
IN,water transport and terminals,0,0,0,0,0,0,0,2004
IN,electric power,0,0,0,0,0,0,0,2004
IN,gas supply,0,0,0,0,0,0,0,2004
IN,transit,0,0,0,0,0,0,0,2004
IN,education - elementary and secondary instructional,0,0,0,0,0,0,0,2004
IN,education - elementary and secondary other,0,0,0,0,0,0,0,2004
IN,education - higher education instructional,14057,78496472,12456,20540766,1390629,21969,99037238,2004
IN,education - higher education other,25226,67181070,20095,8723489,970345,30821,75904559,2004
IN,education - other,1146,3715583,105,57110,10207,1207,3772693,2004
IN,libraries,0,0,0,0,0,0,0,2004
IN,liquor stores,0,0,0,0,0,0,0,2004
IN,other and unallocable,1713,5370450,86,74480,5676,1746,5444930,2004
IA,total,41242,180746154,24655,32416753,2120416,53291,213162907,2004
IA,financial administration,1259,5151649,77,127300,9372,1313,5278949,2004
IA,other government administration,367,1758782,414,676774,44238,618,2435556,2004
IA,judicial and legal,2158,9349193,182,380285,21558,2281,9729478,2004
IA,police protection - officers,576,2652633,0,0,0,576,2652633,2004
IA,police protection - other,294,1138915,18,11367,651,297,1150282,2004
IA,corrections,3120,11721912,163,372989,18200,3223,12094901,2004
IA,highways,2531,9803262,1,1437,44,2531,9804699,2004
IA,air transportation,0,0,0,0,0,0,0,2004
IA,water transport and terminals,0,0,0,0,0,0,0,2004
IA,public welfare,2724,9697825,53,119044,6144,2759,9816869,2004
IA,health,392,1774745,29,46089,2768,408,1820834,2004
IA,hospitals,5447,21149048,2613,5152835,233878,6774,26301883,2004
IA,social insurance administration,691,2769588,6,9266,576,694,2778854,2004
IA,solid waste management,0,0,0,0,0,0,0,2004
IA,sewerage,0,0,0,0,0,0,0,2004
IA,parks and recreation,111,433185,9,9308,1030,117,442493,2004
IA,housing and community development,0,0,0,0,0,0,0,2004
IA,natural resources,1453,5851179,252,268411,26906,1607,6119590,2004
IA,water transport and terminals,0,0,0,0,0,0,0,2004
IA,electric power,0,0,0,0,0,0,0,2004
IA,gas supply,0,0,0,0,0,0,0,2004
IA,transit,0,0,0,0,0,0,0,2004
IA,education - elementary and secondary instructional,0,0,0,0,0,0,0,2004
IA,education - elementary and secondary other,0,0,0,0,0,0,0,2004
IA,education - higher education instructional,3887,30271843,7168,15785603,821855,8557,46057446,2004
IA,education - higher education other,12440,51679370,13263,8751702,892848,17513,60431072,2004
IA,education - other,1146,4590773,106,143287,8425,1196,4734060,2004
IA,libraries,0,0,0,0,0,0,0,2004
IA,liquor stores,0,0,0,0,0,0,0,2004
IA,other and unallocable,2646,10952252,301,561056,31923,2827,11513308,2004
KS,total,37833,132039651,17902,14023473,1047562,43787,146063124,2004
KS,financial administration,1981,5824338,75,131824,11022,2043,5956162,2004
KS,other government administration,508,1396554,199,504296,25733,654,1900850,2004
KS,judicial and legal,2029,6867893,204,181884,12516,2100,7049777,2004
KS,police protection - officers,607,2483452,0,0,0,607,2483452,2004
KS,police protection - other,489,1408784,11,11280,886,494,1420064,2004
KS,corrections,3555,9335150,29,35182,2535,3571,9370332,2004
KS,highways,3534,10241415,136,126369,10465,3593,10367784,2004
KS,air transportation,0,0,0,0,0,0,0,2004
KS,water transport and terminals,0,0,0,0,0,0,0,2004
KS,public welfare,2634,6610041,82,111741,7397,2676,6721782,2004
KS,health,957,3171486,33,41214,1935,968,3212700,2004
KS,hospitals,2316,5831006,338,160333,5261,2345,5991339,2004
KS,social insurance administration,115,338069,3,2106,241,116,340175,2004
KS,solid waste management,0,0,0,0,0,0,0,2004
KS,sewerage,0,0,0,0,0,0,0,2004
KS,parks and recreation,547,1336151,5,4882,383,549,1341033,2004
KS,housing and community development,0,0,0,0,0,0,0,2004
KS,natural resources,813,2679426,129,92462,8874,864,2771888,2004
KS,water transport and terminals,0,0,0,0,0,0,0,2004
KS,electric power,0,0,0,0,0,0,0,2004
KS,gas supply,0,0,0,0,0,0,0,2004
KS,transit,0,0,0,0,0,0,0,2004
KS,education - elementary and secondary instructional,0,0,0,0,0,0,0,2004
KS,education - elementary and secondary other,0,0,0,0,0,0,0,2004
KS,education - higher education instructional,4108,26394917,3585,4829380,226158,5395,31224297,2004
KS,education - higher education other,9764,35894075,12704,7473363,713563,13818,43367438,2004
KS,education - other,565,1839058,64,77273,3882,586,1916331,2004
KS,libraries,0,0,0,0,0,0,0,2004
KS,liquor stores,0,0,0,0,0,0,0,2004
KS,other and unallocable,3311,10387836,305,239884,16711,3408,10627720,2004
KY,total,69917,237782124,24712,22236793,1617645,79481,260018917,2004
KY,financial administration,2820,9061802,230,263486,26926,2981,9325288,2004
KY,other government administration,1017,4646664,498,1183164,49344,1314,5829828,2004
KY,judicial and legal,4271,14682362,852,1428740,114714,4962,16111102,2004
KY,police protection - officers,967,3738714,2,4892,266,969,3743606,2004
KY,police protection - other,1207,3834374,17,27368,1802,1218,3861742,2004
KY,corrections,3712,9771694,138,119492,3052,3731,9891186,2004
KY,highways,5011,16210226,162,293052,14284,5097,16503278,2004
KY,air transportation,0,0,0,0,0,0,0,2004
KY,water transport and terminals,0,0,0,0,0,0,0,2004
KY,public welfare,6818,19884164,60,113444,6676,6859,19997608,2004
KY,health,2071,6778290,109,88615,5726,2105,6866905,2004
KY,hospitals,5359,17393170,364,1019112,47422,5631,18412282,2004
KY,social insurance administration,1082,3310834,69,108690,6312,1120,3419524,2004
KY,solid waste management,0,0,0,0,0,0,0,2004
KY,sewerage,0,0,0,0,0,0,0,2004
KY,parks and recreation,1478,3311540,158,154416,20574,1602,3465956,2004
KY,housing and community development,0,0,0,0,0,0,0,2004
KY,natural resources,3287,10258539,929,987388,91403,3819,11245927,2004
KY,water transport and terminals,0,0,0,0,0,0,0,2004
KY,electric power,0,0,0,0,0,0,0,2004
KY,gas supply,0,0,0,0,0,0,0,2004
KY,transit,0,0,0,0,0,0,0,2004
KY,education - elementary and secondary instructional,0,0,0,0,0,0,0,2004
KY,education - elementary and secondary other,0,0,0,0,0,0,0,2004
KY,education - higher education instructional,8033,45152503,7262,9705543,537580,11199,54858046,2004
KY,education - higher education other,15944,45775057,13425,6272274,667334,19890,52047331,2004
KY,education - other,2816,10395764,231,264714,13220,2895,10660478,2004
KY,libraries,0,0,0,0,0,0,0,2004
KY,liquor stores,0,0,0,0,0,0,0,2004
KY,other and unallocable,4024,13576427,206,202403,11010,4089,13778830,2004
LA,total,82501,271233145,26175,17878222,1421254,90600,289111367,2004
LA,financial administration,2369,7504617,374,320711,39387,2593,7825328,2004
LA,other government administration,1368,4757471,392,400522,26489,1518,5157993,2004
LA,judicial and legal,1700,7208321,83,82174,4008,1723,7290495,2004
LA,police protection - officers,1011,3916601,0,0,0,1011,3916601,2004
LA,police protection - other,641,1200898,5,3739,270,643,1204637,2004
LA,corrections,7521,21835940,480,541987,53136,7823,22377927,2004
LA,highways,5347,16004798,10,12060,1332,5355,16016858,2004
LA,air transportation,0,0,0,0,0,0,0,2004
LA,water transport and terminals,376,1355758,4,8744,448,379,1364502,2004
LA,public welfare,5032,13906701,2,2615,81,5032,13909316,2004
LA,health,3974,13664955,163,148716,11214,4039,13813671,2004
LA,hospitals,16696,47557643,1102,1804870,69058,17088,49362513,2004
LA,social insurance administration,960,2975353,130,120391,15702,1049,3095744,2004
LA,solid waste management,0,0,0,0,0,0,0,2004
LA,sewerage,0,0,0,0,0,0,0,2004
LA,parks and recreation,1090,2991605,358,200349,24281,1227,3191954,2004
LA,housing and community development,0,0,0,0,0,0,0,2004
LA,natural resources,4601,14816503,936,674553,72674,5016,15491056,2004
LA,water transport and terminals,0,0,0,0,0,0,0,2004
LA,electric power,0,0,0,0,0,0,0,2004
LA,gas supply,0,0,0,0,0,0,0,2004
LA,transit,0,0,0,0,0,0,0,2004
LA,education - elementary and secondary instructional,0,0,0,0,0,0,0,2004
LA,education - elementary and secondary other,0,0,0,0,0,0,0,2004
LA,education - higher education instructional,8204,46923139,5575,6029801,352509,10208,52952940,2004
LA,education - higher education other,15841,45888755,15256,6412791,666427,19641,52301546,2004
LA,education - other,3132,10371399,765,635117,41520,3370,11006516,2004
LA,libraries,0,0,0,0,0,0,0,2004
LA,liquor stores,0,0,0,0,0,0,0,2004
LA,other and unallocable,2638,8352688,540,479082,42718,2885,8831770,2004
ME,total,18900,67237544,7133,7680977,496098,21720,74918521,2004
ME,financial administration,1169,3740356,94,159458,10767,1230,3899814,2004
ME,other government administration,351,1429150,225,582357,32513,535,2011507,2004
ME,judicial and legal,712,2833887,59,95487,5083,741,2929374,2004
ME,police protection - officers,343,1713408,23,89054,2938,360,1802462,2004
ME,police protection - other,194,574163,9,23823,1322,202,597986,2004
ME,corrections,1314,4379742,60,93743,5893,1348,4473485,2004
ME,highways,2458,8478840,102,151600,12809,2531,8630440,2004
ME,air transportation,0,0,0,0,0,0,0,2004
ME,water transport and terminals,69,197307,14,17836,1399,77,215143,2004
ME,public welfare,1969,5985339,76,144226,7939,2014,6129565,2004
ME,health,1277,4634513,84,190665,9598,1332,4825178,2004
ME,hospitals,618,2173507,89,165027,8557,667,2338534,2004
ME,social insurance administration,484,1633347,43,79997,4596,510,1713344,2004
ME,solid waste management,0,0,0,0,0,0,0,2004
ME,sewerage,0,0,0,0,0,0,0,2004
ME,parks and recreation,146,476626,33,38284,2538,160,514910,2004
ME,housing and community development,0,0,0,0,0,0,0,2004
ME,natural resources,1127,4130443,226,401290,21594,1249,4531733,2004
ME,water transport and terminals,0,0,0,0,0,0,0,2004
ME,electric power,0,0,0,0,0,0,0,2004
ME,gas supply,0,0,0,0,0,0,0,2004
ME,transit,0,0,0,0,0,0,0,2004
ME,education - elementary and secondary instructional,22,82715,14,12959,1063,28,95674,2004
ME,education - elementary and secondary other,5,11280,37,34576,2829,21,45856,2004
ME,education - higher education instructional,1405,6932883,671,801743,33029,1592,7734626,2004
ME,education - higher education other,3902,12902030,5180,4387768,320649,5724,17289798,2004
ME,education - other,256,902258,19,40485,2192,269,942743,2004
ME,libraries,0,0,0,0,0,0,0,2004
ME,liquor stores,56,154683,0,0,0,56,154683,2004
ME,other and unallocable,1023,3871067,75,170599,8790,1074,4041666,2004
MD,total,82616,321626744,14170,25244167,1419242,90682,346870911,2004
MD,financial administration,3566,13528446,127,282597,16673,3661,13811043,2004
MD,other government administration,1380,6183196,310,517100,15782,1469,6700296,2004
MD,judicial and legal,4198,14648880,458,839111,61731,4550,15487991,2004
MD,police protection - officers,1622,8267408,0,0,0,1622,8267408,2004
MD,police protection - other,857,2727518,29,73182,3654,878,2800700,2004
MD,corrections,11682,38707928,317,654043,45664,11943,39361971,2004
MD,highways,4702,17531610,0,0,0,4702,17531610,2004
MD,air transportation,524,2174591,0,0,0,524,2174591,2004
MD,water transport and terminals,291,1348939,0,0,0,291,1348939,2004
MD,public welfare,6707,22226269,109,226027,15516,6796,22452296,2004
MD,health,6242,22927705,853,1507936,106099,6844,24435641,2004
MD,hospitals,4923,16631655,589,833990,50195,5208,17465645,2004
MD,social insurance administration,989,3695791,163,349774,22392,1116,4045565,2004
MD,solid waste management,0,0,0,0,0,0,0,2004
MD,sewerage,0,0,0,0,0,0,0,2004
MD,parks and recreation,425,1761846,107,146711,16762,520,1908557,2004
MD,housing and community development,0,0,0,0,0,0,0,2004
MD,natural resources,2026,8423863,87,168979,6613,2064,8592842,2004
MD,water transport and terminals,0,0,0,0,0,0,0,2004
MD,electric power,0,0,0,0,0,0,0,2004
MD,gas supply,0,0,0,0,0,0,0,2004
MD,transit,2099,8955606,248,373958,28930,2263,9329564,2004
MD,education - elementary and secondary instructional,0,0,0,0,0,0,0,2004
MD,education - elementary and secondary other,0,0,0,0,0,0,0,2004
MD,education - higher education instructional,9084,55963574,3451,9347390,327742,10947,65310964,2004
MD,education - higher education other,12017,40237563,6399,8219187,597226,15410,48456750,2004
MD,education - other,1890,7549333,245,586559,28951,2055,8135892,2004
MD,libraries,0,0,0,0,0,0,0,2004
MD,liquor stores,0,0,0,0,0,0,0,2004
MD,other and unallocable,7392,28135023,678,1117623,75312,7819,29252646,2004
MA,total,78325,337595713,28686,35406274,1637537,88051,373001987,2004
MA,financial administration,4049,17472800,347,962264,12255,4124,18435064,2004
MA,other government administration,1792,5629380,314,1200083,29092,1965,6829463,2004
MA,judicial and legal,8794,38418529,504,1212492,23003,8933,39631021,2004
MA,police protection - officers,4960,25815545,35,68299,1731,4970,25883844,2004
MA,police protection - other,596,2591967,13,23221,1059,602,2615188,2004
MA,corrections,6627,29024967,153,397234,7433,6672,29422201,2004
MA,highways,3726,17274598,188,492076,19877,3839,17766674,2004
MA,air transportation,1109,6463573,158,249623,11954,1177,6713196,2004
MA,water transport and terminals,159,815107,7,10525,735,163,825632,2004
MA,public welfare,6137,26145831,701,1786793,80563,6623,27932624,2004
MA,health,6729,27137595,1240,2673934,100663,7336,29811529,2004
MA,hospitals,6348,21569218,906,2166571,80445,6804,23735789,2004
MA,social insurance administration,1430,5627594,204,449161,24517,1578,6076755,2004
MA,solid waste management,3,16148,0,0,0,3,16148,2004
MA,sewerage,844,4371981,32,108254,4169,868,4480235,2004
MA,parks and recreation,780,2752749,55,74454,3618,801,2827203,2004
MA,housing and community development,0,0,0,0,0,0,0,2004
MA,natural resources,1106,5152609,157,379612,10092,1166,5532221,2004
MA,water transport and terminals,502,2518414,22,64324,2678,517,2582738,2004
MA,electric power,0,0,0,0,0,0,0,2004
MA,gas supply,0,0,0,0,0,0,0,2004
MA,transit,0,0,0,0,0,0,0,2004
MA,education - elementary and secondary instructional,58,243006,0,0,0,58,243006,2004
MA,education - elementary and secondary other,36,126353,5,948,120,37,127301,2004
MA,education - higher education instructional,5962,33123201,10194,13988284,555688,9264,47111485,2004
MA,education - higher education other,12397,45500919,13145,8189365,648281,16252,53690284,2004
MA,education - other,1037,4875321,88,269312,7801,1084,5144633,2004
MA,libraries,0,0,0,0,0,0,0,2004
MA,liquor stores,0,0,0,0,0,0,0,2004
MA,other and unallocable,3144,14928308,218,639445,11763,3215,15567753,2004
MI,total,106800,457294884,61907,63353506,4579073,132825,520648390,2004
MI,financial administration,4097,16974382,720,1839040,94415,4633,18813422,2004
MI,other government administration,1454,5897752,2,1815,122,1455,5899567,2004
MI,judicial and legal,1856,9457236,15,33651,1488,1864,9490887,2004
MI,police protection - officers,1797,7068126,0,0,0,1797,7068126,2004
MI,police protection - other,865,3219840,0,0,0,865,3219840,2004
MI,corrections,17583,67116407,57,169937,7590,17626,67286344,2004
MI,highways,2602,10563804,228,569518,30361,2775,11133322,2004
MI,air transportation,0,0,0,0,0,0,0,2004
MI,water transport and terminals,0,0,0,0,0,0,0,2004
MI,public welfare,10352,36684605,200,332888,26074,10500,37017493,2004
MI,health,1433,5996062,222,380385,18004,1535,6376447,2004
MI,hospitals,8630,32364054,3648,7713002,500160,11472,40077056,2004
MI,social insurance administration,1077,4348422,138,329252,19909,1190,4677674,2004
MI,solid waste management,0,0,0,0,0,0,0,2004
MI,sewerage,0,0,0,0,0,0,0,2004
MI,parks and recreation,205,754684,94,222434,11192,269,977118,2004
MI,housing and community development,0,0,0,0,0,0,0,2004
MI,natural resources,4158,16399437,937,1089090,80001,4613,17488527,2004
MI,water transport and terminals,0,0,0,0,0,0,0,2004
MI,electric power,0,0,0,0,0,0,0,2004
MI,gas supply,0,0,0,0,0,0,0,2004
MI,transit,0,0,0,0,0,0,0,2004
MI,education - elementary and secondary instructional,654,2167036,127,135870,9509,709,2302906,2004
MI,education - elementary and secondary other,181,497094,93,93129,7438,226,590223,2004
MI,education - higher education instructional,13804,96089866,14193,23603219,1266579,21003,119693085,2004
MI,education - higher education other,29886,116945193,40357,25136212,2419667,43635,142081405,2004
MI,education - other,1122,4706719,265,819868,38112,1338,5526587,2004
MI,libraries,0,0,0,0,0,0,0,2004
MI,liquor stores,0,0,0,0,0,0,0,2004
MI,other and unallocable,5044,20044165,611,884196,48452,5320,20928361,2004
MN,total,61363,275243822,30029,34604906,2319115,74543,309848728,2004
MN,financial administration,2403,9781436,129,251111,19630,2515,10032547,2004
MN,other government administration,1151,4737187,143,331457,17526,1251,5068644,2004
MN,judicial and legal,2419,12101836,404,1303479,46242,2683,13405315,2004
MN,police protection - officers,507,2782267,0,0,0,507,2782267,2004
MN,police protection - other,391,1441737,21,37082,2272,404,1478819,2004
MN,corrections,3668,13917988,159,373212,20861,3787,14291200,2004
MN,highways,4595,19505539,133,243952,15890,4685,19749491,2004
MN,air transportation,0,0,0,0,0,0,0,2004
MN,water transport and terminals,0,0,0,0,0,0,0,2004
MN,public welfare,1610,6584918,1158,2323024,187191,2674,8907942,2004
MN,health,2099,9552987,228,547270,28078,2259,10100257,2004
MN,hospitals,3350,14258893,1393,3150345,241392,4722,17409238,2004
MN,social insurance administration,1112,4473870,109,244735,12739,1185,4718605,2004
MN,solid waste management,0,0,0,0,0,0,0,2004
MN,sewerage,644,3600325,0,0,0,644,3600325,2004
MN,parks and recreation,491,2042433,147,187338,12124,560,2229771,2004
MN,housing and community development,0,0,0,0,0,0,0,2004
MN,natural resources,2731,11758053,648,1014824,74603,3153,12772877,2004
MN,water transport and terminals,0,0,0,0,0,0,0,2004
MN,electric power,0,0,0,0,0,0,0,2004
MN,gas supply,0,0,0,0,0,0,0,2004
MN,transit,2327,9530568,461,883572,45918,2588,10414140,2004
MN,education - elementary and secondary instructional,0,0,0,0,0,0,0,2004
MN,education - elementary and secondary other,0,0,0,0,0,0,0,2004
MN,education - higher education instructional,9949,51411492,9487,10658436,516537,12881,62069928,2004
MN,education - higher education other,14829,67803569,14750,11867109,1015815,20604,79670678,2004
MN,education - other,3840,15541847,490,793678,42944,4083,16335525,2004
MN,libraries,0,0,0,0,0,0,0,2004
MN,liquor stores,0,0,0,0,0,0,0,2004
MN,other and unallocable,3247,14416877,169,394282,19353,3358,14811159,2004
MS,total,50974,153538896,14407,11104259,1055037,56968,164643155,2004
MS,financial administration,1173,3670841,29,34811,3081,1191,3705652,2004
MS,other government administration,455,1679300,93,100167,7602,498,1779467,2004
MS,judicial and legal,646,3501369,45,32464,2039,658,3533833,2004
MS,police protection - officers,645,2037163,0,0,0,645,2037163,2004
MS,police protection - other,525,1320929,0,0,0,525,1320929,2004
MS,corrections,4154,9041827,26,33232,3133,4172,9075059,2004
MS,highways,3284,8237012,12,23020,1860,3295,8260032,2004
MS,air transportation,0,0,0,0,0,0,0,2004
MS,water transport and terminals,56,197666,0,0,0,56,197666,2004
MS,public welfare,2801,6185652,0,0,0,2801,6185652,2004
MS,health,2957,8340630,75,176345,8787,3007,8516975,2004
MS,hospitals,11717,28441549,610,1414779,77007,12155,29856328,2004
MS,social insurance administration,786,2228115,321,626505,48953,1064,2854620,2004
MS,solid waste management,0,0,0,0,0,0,0,2004
MS,sewerage,0,0,0,0,0,0,0,2004
MS,parks and recreation,313,585502,144,78476,7004,353,663978,2004
MS,housing and community development,0,0,0,0,0,0,0,2004
MS,natural resources,3001,7960339,798,559395,55502,3315,8519734,2004
MS,water transport and terminals,0,0,0,0,0,0,0,2004
MS,electric power,0,0,0,0,0,0,0,2004
MS,gas supply,0,0,0,0,0,0,0,2004
MS,transit,0,0,0,0,0,0,0,2004
MS,education - elementary and secondary instructional,0,0,0,0,0,0,0,2004
MS,education - elementary and secondary other,0,0,0,0,0,0,0,2004
MS,education - higher education instructional,5253,29646261,2063,2347269,162473,6176,31993530,2004
MS,education - higher education other,8851,27987626,10094,5561566,668597,12650,33549192,2004
MS,education - other,1565,4492827,32,64132,4198,1589,4556959,2004
MS,libraries,0,0,0,0,0,0,0,2004
MS,liquor stores,120,288174,0,0,0,120,288174,2004
MS,other and unallocable,2672,7696114,65,52098,4801,2698,7748212,2004
MO,total,81473,240712083,25077,19076877,1626888,90730,259788960,2004
MO,financial administration,2464,6574964,360,272012,31416,2643,6846976,2004
MO,other government administration,765,2215868,281,606616,35459,969,2822484,2004
MO,judicial and legal,3994,13742258,230,338564,14138,4074,14080822,2004
MO,police protection - officers,1134,3999436,0,0,0,1134,3999436,2004
MO,police protection - other,1029,2516743,131,83982,10254,1087,2600725,2004
MO,corrections,11459,25714860,442,395386,25709,11605,26110246,2004
MO,highways,6168,18651444,550,845250,66200,6544,19496694,2004
MO,air transportation,0,0,0,0,0,0,0,2004
MO,water transport and terminals,0,0,0,0,0,0,0,2004
MO,public welfare,7706,17629829,301,321390,23952,7842,17951219,2004
MO,health,3183,8271124,198,303148,18068,3286,8574272,2004
MO,hospitals,11641,29891062,1529,1748081,121534,12331,31639143,2004
MO,social insurance administration,599,1584814,32,40164,2366,612,1624978,2004
MO,solid waste management,0,0,0,0,0,0,0,2004
MO,sewerage,0,0,0,0,0,0,0,2004
MO,parks and recreation,574,1480396,338,204151,17939,676,1684547,2004
MO,housing and community development,0,0,0,0,0,0,0,2004
MO,natural resources,2425,7023011,656,653447,63427,2785,7676458,2004
MO,water transport and terminals,0,0,0,0,0,0,0,2004
MO,electric power,0,0,0,0,0,0,0,2004
MO,gas supply,0,0,0,0,0,0,0,2004
MO,transit,0,0,0,0,0,0,0,2004
MO,education - elementary and secondary instructional,0,0,0,0,0,0,0,2004
MO,education - elementary and secondary other,0,0,0,0,0,0,0,2004
MO,education - higher education instructional,8110,40688249,7650,7135037,484662,10865,47823286,2004
MO,education - higher education other,13630,41705007,11868,5596317,687571,17547,47301324,2004
MO,education - other,2092,5671303,400,4e+05,14719,2176,6071303,2004
MO,libraries,0,0,0,0,0,0,0,2004
MO,liquor stores,0,0,0,0,0,0,0,2004
MO,other and unallocable,4500,13351715,111,133332,9474,4554,13485047,2004
MT,total,15831,50845404,9159,6745887,482295,18571,57591291,2004
MT,financial administration,906,2519685,115,124893,10109,964,2644578,2004
MT,other government administration,313,1089622,57,61431,4116,337,1151053,2004
MT,judicial and legal,414,1532198,114,222684,9821,470,1754882,2004
MT,police protection - officers,196,625501,13,12981,1107,202,638482,2004
MT,police protection - other,214,695107,31,44030,3742,235,739137,2004
MT,corrections,1081,3084804,39,45141,3257,1100,3129945,2004
MT,highways,2099,7005408,121,157907,10846,2161,7163315,2004
MT,air transportation,0,0,0,0,0,0,0,2004
MT,water transport and terminals,0,0,0,0,0,0,0,2004
MT,public welfare,1372,4012993,209,314058,24383,1510,4327051,2004
MT,health,732,2186696,96,135684,10685,793,2322380,2004
MT,hospitals,498,1334415,90,106031,9270,551,1440446,2004
MT,social insurance administration,706,2226615,27,39727,2608,721,2266342,2004
MT,solid waste management,0,0,0,0,0,0,0,2004
MT,sewerage,0,0,0,0,0,0,0,2004
MT,parks and recreation,63,189490,43,20300,1975,74,209790,2004
MT,housing and community development,0,0,0,0,0,0,0,2004
MT,natural resources,1256,4103669,242,236004,19952,1370,4339673,2004
MT,water transport and terminals,0,0,0,0,0,0,0,2004
MT,electric power,0,0,0,0,0,0,0,2004
MT,gas supply,0,0,0,0,0,0,0,2004
MT,transit,0,0,0,0,0,0,0,2004
MT,education - elementary and secondary instructional,0,0,0,0,0,0,0,2004
MT,education - elementary and secondary other,0,0,0,0,0,0,0,2004
MT,education - higher education instructional,1544,7118956,1816,2116183,72898,1958,9235139,2004
MT,education - higher education other,3019,8535818,5941,2832569,277612,4595,11368387,2004
MT,education - other,365,1109395,103,128660,10010,421,1238055,2004
MT,libraries,0,0,0,0,0,0,0,2004
MT,liquor stores,15,42465,1,744,91,16,43209,2004
MT,other and unallocable,1038,3432567,101,146860,9813,1093,3579427,2004
NE,total,28190,86052536,10872,9096205,963185,33662,95148741,2004
NE,financial administration,548,1654952,10,16392,1028,553,1671344,2004
NE,other government administration,271,953496,100,101930,7141,312,1055426,2004
NE,judicial and legal,667,2720903,38,28512,1994,678,2749415,2004
NE,police protection - officers,509,1878819,0,0,0,509,1878819,2004
NE,police protection - other,236,673669,19,19980,2039,248,693649,2004
NE,corrections,2498,6784479,57,73696,5664,2530,6858175,2004
NE,highways,2153,4643832,10,15644,1036,2159,4659476,2004
NE,air transportation,26,85848,0,0,0,26,85848,2004
NE,water transport and terminals,0,0,0,0,0,0,0,2004
NE,public welfare,2730,6647420,127,44870,6758,2769,6692290,2004
NE,health,755,2328816,91,147416,11102,818,2476232,2004
NE,hospitals,4170,11626957,1044,1825104,161908,5090,13452061,2004
NE,social insurance administration,304,922487,10,15748,1132,311,938235,2004
NE,solid waste management,0,0,0,0,0,0,0,2004
NE,sewerage,0,0,0,0,0,0,0,2004
NE,parks and recreation,233,613329,151,127314,16381,326,740643,2004
NE,housing and community development,0,0,0,0,0,0,0,2004
NE,natural resources,1578,4544928,775,1151857,104019,2170,5696785,2004
NE,water transport and terminals,0,0,0,0,0,0,0,2004
NE,electric power,0,0,0,0,0,0,0,2004
NE,gas supply,0,0,0,0,0,0,0,2004
NE,transit,0,0,0,0,0,0,0,2004
NE,education - elementary and secondary instructional,0,0,0,0,0,0,0,2004
NE,education - elementary and secondary other,0,0,0,0,0,0,0,2004
NE,education - higher education instructional,2791,14602068,1120,1498236,87545,3288,16100304,2004
NE,education - higher education other,5920,17110722,6942,3822834,539285,8983,20933556,2004
NE,education - other,531,1902234,49,34704,3419,550,1936938,2004
NE,libraries,0,0,0,0,0,0,0,2004
NE,liquor stores,0,0,0,0,0,0,0,2004
NE,other and unallocable,2270,6357577,329,171968,12734,2342,6529545,2004
NV,total,22068,84669100,10922,8786930,566048,25279,93456030,2004
NV,financial administration,1289,4419180,35,54345,2214,1301,4473525,2004
NV,other government administration,936,3755164,59,77738,4095,959,3832902,2004
NV,judicial and legal,605,3222492,27,48380,1116,611,3270872,2004
NV,police protection - officers,404,1875123,0,0,0,404,1875123,2004
NV,police protection - other,375,1524967,1,1107,91,376,1526074,2004
NV,corrections,3253,12428281,56,135196,3615,3274,12563477,2004
NV,highways,1713,6740412,2,1424,146,1714,6741836,2004
NV,air transportation,0,0,0,0,0,0,0,2004
NV,water transport and terminals,0,0,0,0,0,0,0,2004
NV,public welfare,1476,5066736,16,29280,1009,1482,5096016,2004
NV,health,1212,4885712,67,148322,4382,1238,5034034,2004
NV,hospitals,986,4014022,105,239008,8267,1033,4253030,2004
NV,social insurance administration,474,1679394,3,4100,155,475,1683494,2004
NV,solid waste management,0,0,0,0,0,0,0,2004
NV,sewerage,0,0,0,0,0,0,0,2004
NV,parks and recreation,175,644099,9,15096,608,178,659195,2004
NV,housing and community development,0,0,0,0,0,0,0,2004
NV,natural resources,1098,4120043,407,383754,19343,1207,4503797,2004
NV,water transport and terminals,16,91192,1,576,22,16,91768,2004
NV,electric power,16,91192,1,576,22,16,91768,2004
NV,gas supply,0,0,0,0,0,0,0,2004
NV,transit,0,0,0,0,0,0,0,2004
NV,education - elementary and secondary instructional,0,0,0,0,0,0,0,2004
NV,education - elementary and secondary other,0,0,0,0,0,0,0,2004
NV,education - higher education instructional,1890,10557566,2069,3088714,150174,2743,13646280,2004
NV,education - higher education other,3974,10492070,7990,4467042,366981,6059,14959112,2004
NV,education - other,130,540996,7,16427,454,133,557423,2004
NV,libraries,0,0,0,0,0,0,0,2004
NV,liquor stores,0,0,0,0,0,0,0,2004
NV,other and unallocable,2046,8520459,67,75845,3354,2060,8596304,2004
NH,total,16073,56216261,9047,8502209,644938,19955,64718470,2004
NH,financial administration,815,2808491,47,50327,4037,839,2858818,2004
NH,other government administration,297,969628,99,112708,8164,345,1082336,2004
NH,judicial and legal,930,3359093,1,908,120,931,3360001,2004
NH,police protection - officers,274,1205882,0,0,0,274,1205882,2004
NH,police protection - other,137,448911,17,18655,1610,147,467566,2004
NH,corrections,1330,4503050,64,90019,6507,1369,4593069,2004
NH,highways,1723,5668641,271,284313,24965,1873,5952954,2004
NH,air transportation,0,0,0,0,0,0,0,2004
NH,water transport and terminals,3,10233,4,4202,328,5,14435,2004
NH,public welfare,1367,3997753,87,119102,5831,1402,4116855,2004
NH,health,818,2939046,78,96823,6424,857,3035869,2004
NH,hospitals,765,2339968,66,118274,1758,776,2458242,2004
NH,social insurance administration,347,996703,55,65320,4505,374,1062023,2004
NH,solid waste management,0,0,0,0,0,0,0,2004
NH,sewerage,0,0,0,0,0,0,0,2004
NH,parks and recreation,79,219655,232,152288,18764,192,371943,2004
NH,housing and community development,0,0,0,0,0,0,0,2004
NH,natural resources,528,1699207,115,112254,8081,576,1811461,2004
NH,water transport and terminals,0,0,0,0,0,0,0,2004
NH,electric power,0,0,0,0,0,0,0,2004
NH,gas supply,0,0,0,0,0,0,0,2004
NH,transit,0,0,0,0,0,0,0,2004
NH,education - elementary and secondary instructional,0,0,0,0,0,0,0,2004
NH,education - elementary and secondary other,0,0,0,0,0,0,0,2004
NH,education - higher education instructional,1469,7052116,1882,2857623,125479,2225,9909739,2004
NH,education - higher education other,2683,9758548,5305,3894696,370806,4916,13653244,2004
NH,education - other,315,1044098,22,23015,2154,327,1067113,2004
NH,libraries,0,0,0,0,0,0,0,2004
NH,liquor stores,294,880539,396,256352,32440,489,1136891,2004
NH,other and unallocable,1899,6314699,306,245330,22965,2038,6560029,2004
NJ,total,137773,642686898,32956,32671853,1896279,149374,675358751,2004
NJ,financial administration,5811,22847492,516,793803,61607,6161,23641295,2004
NJ,other government administration,1409,6682202,56,71901,4606,1435,6754103,2004
NJ,judicial and legal,14336,66466625,185,268403,15261,14422,66735028,2004
NJ,police protection - officers,1307,4739395,59,96690,5486,1338,4836085,2004
NJ,police protection - other,2773,18920160,0,0,0,2773,18920160,2004
NJ,corrections,10074,46375234,18,31837,1333,10082,46407071,2004
NJ,highways,6785,30287404,887,1044931,86089,7274,31332335,2004
NJ,air transportation,0,0,0,0,0,0,0,2004
NJ,water transport and terminals,119,518228,6,7219,562,122,525447,2004
NJ,public welfare,6553,27007249,160,246549,12998,6627,27253798,2004
NJ,health,3229,15709883,74,119056,4795,3256,15828939,2004
NJ,hospitals,16264,59268871,2053,2381314,160800,17186,61650185,2004
NJ,social insurance administration,1968,7373364,166,236615,15761,2058,7609979,2004
NJ,solid waste management,634,3375639,1,299,29,634,3375938,2004
NJ,sewerage,0,0,0,0,0,0,0,2004
NJ,parks and recreation,1711,7349763,1042,1073684,78166,2155,8423447,2004
NJ,housing and community development,0,0,0,0,0,0,0,2004
NJ,natural resources,2462,11003232,595,714589,33314,2661,11717821,2004
NJ,water transport and terminals,120,482893,2,3383,151,121,486276,2004
NJ,electric power,0,0,0,0,0,0,0,2004
NJ,gas supply,0,0,0,0,0,0,0,2004
NJ,transit,10014,46272719,827,1274178,83933,10491,47546897,2004
NJ,education - elementary and secondary instructional,12044,71895678,1463,2187071,119524,12868,74082749,2004
NJ,education - elementary and secondary other,5368,16849042,1907,1487027,120223,6197,18336069,2004
NJ,education - higher education instructional,6985,55416673,6793,9086226,292772,8802,64502899,2004
NJ,education - higher education other,18105,78266742,15277,10617421,721696,22570,88884163,2004
NJ,education - other,2943,13535942,586,628482,55762,3259,14164424,2004
NJ,libraries,0,0,0,0,0,0,0,2004
NJ,liquor stores,0,0,0,0,0,0,0,2004
NJ,other and unallocable,6759,32042468,283,301175,21411,6882,32343643,2004
NM,total,42059,126635948,17764,20121246,1271609,49286,146757194,2004
NM,financial administration,1696,5703961,150,232479,25036,1839,5936440,2004
NM,other government administration,224,951977,15,18767,1366,232,970744,2004
NM,judicial and legal,2611,9096102,117,185378,12694,2685,9281480,2004
NM,police protection - officers,462,1756405,0,0,0,462,1756405,2004
NM,police protection - other,171,653694,0,0,0,171,653694,2004
NM,corrections,4061,12452930,53,109221,7866,4106,12562151,2004
NM,highways,2301,6664446,0,0,0,2301,6664446,2004
NM,air transportation,7,27936,0,0,0,7,27936,2004
NM,water transport and terminals,0,0,0,0,0,0,0,2004
NM,public welfare,1464,4098504,106,211433,17245,1562,4309937,2004
NM,health,2159,6222177,123,257887,18325,2263,6480064,2004
NM,hospitals,8013,24016376,2721,7281529,336071,9922,31297905,2004
NM,social insurance administration,545,1461477,7,12357,935,550,1473834,2004
NM,solid waste management,0,0,0,0,0,0,0,2004
NM,sewerage,0,0,0,0,0,0,0,2004
NM,parks and recreation,671,1854944,77,148573,10696,732,2003517,2004
NM,housing and community development,0,0,0,0,0,0,0,2004
NM,natural resources,1721,5585513,103,112272,10976,1784,5697785,2004
NM,water transport and terminals,0,0,0,0,0,0,0,2004
NM,electric power,0,0,0,0,0,0,0,2004
NM,gas supply,0,0,0,0,0,0,0,2004
NM,transit,0,0,0,0,0,0,0,2004
NM,education - elementary and secondary instructional,0,0,0,0,0,0,0,2004
NM,education - elementary and secondary other,0,0,0,0,0,0,0,2004
NM,education - higher education instructional,3576,10585216,3921,4647162,214096,4792,15232378,2004
NM,education - higher education other,9466,26305567,10225,6633057,598337,12865,32938624,2004
NM,education - other,1038,3346688,86,143518,9389,1091,3490206,2004
NM,libraries,0,0,0,0,0,0,0,2004
NM,liquor stores,0,0,0,0,0,0,0,2004
NM,other and unallocable,1873,5852035,60,127613,8577,1922,5979648,2004
NY,total,227834,1024532445,46026,56026591,3130286,246385,1080559036,2004
NY,financial administration,12825,49270667,194,361775,15608,12915,49632442,2004
NY,other government administration,4521,17475953,570,847836,61201,4870,18323789,2004
NY,judicial and legal,21942,109619108,830,2215528,102010,22521,111834636,2004
NY,police protection - officers,4623,28812405,0,0,0,4623,28812405,2004
NY,police protection - other,1592,5664477,157,157280,14805,1676,5821757,2004
NY,corrections,33046,151015100,408,1008698,43201,33292,152023798,2004
NY,highways,11861,44825895,1031,1194737,87714,12360,46020632,2004
NY,air transportation,143,523866,16,27571,1680,153,551437,2004
NY,water transport and terminals,653,3094674,20,41948,1992,665,3136622,2004
NY,public welfare,5978,25030170,574,1282336,74761,6404,26312506,2004
NY,health,8985,42333923,420,1176010,48775,9263,43509933,2004
NY,hospitals,38798,156452754,5207,11993115,562822,41999,168445869,2004
NY,social insurance administration,7943,32213748,118,289385,16692,8039,32503133,2004
NY,solid waste management,0,0,0,0,0,0,0,2004
NY,sewerage,0,0,0,0,0,0,0,2004
NY,parks and recreation,1652,6600669,2798,3712012,293541,3320,10312681,2004
NY,housing and community development,0,0,0,0,0,0,0,2004
NY,natural resources,3552,14613871,65,139904,7664,3594,14753775,2004
NY,water transport and terminals,0,0,0,0,0,0,0,2004
NY,electric power,1743,11725138,20,55538,2024,1754,11780676,2004
NY,gas supply,0,0,0,0,0,0,0,2004
NY,transit,15191,84875260,364,610537,48548,15467,85485797,2004
NY,education - elementary and secondary instructional,0,0,0,0,0,0,0,2004
NY,education - elementary and secondary other,0,0,0,0,0,0,0,2004
NY,education - higher education instructional,13033,79449438,13921,14712200,733350,17542,94161638,2004
NY,education - higher education other,23709,91718739,18581,14565031,944158,29484,106283770,2004
NY,education - other,4522,18575535,257,508992,26679,4673,19084527,2004
NY,libraries,0,0,0,0,0,0,0,2004
NY,liquor stores,0,0,0,0,0,0,0,2004
NY,other and unallocable,11522,50641055,475,1126158,43061,11771,51767213,2004
NC,total,118867,392986534,37275,37244220,2330618,132110,430230754,2004
NC,financial administration,4008,11123892,18,37641,1812,4018,11161533,2004
NC,other government administration,704,2862726,409,672832,43636,952,3535558,2004
NC,judicial and legal,5870,21975541,199,215191,8946,5920,22190732,2004
NC,police protection - officers,2230,8926346,0,0,0,2230,8926346,2004
NC,police protection - other,1081,3224107,15,29348,1340,1089,3253455,2004
NC,corrections,18993,49157534,496,1004630,52408,19291,50162164,2004
NC,highways,11401,24136638,0,0,0,11401,24136638,2004
NC,air transportation,0,0,0,0,0,0,0,2004
NC,water transport and terminals,290,1033883,1,1071,63,290,1034954,2004
NC,public welfare,1845,6108932,12,24576,1126,1851,6133508,2004
NC,health,3995,13766621,141,246945,14956,4080,14013566,2004
NC,hospitals,15993,49405334,1371,1846295,95347,16534,51251629,2004
NC,social insurance administration,2424,7734718,328,518293,37384,2637,8253011,2004
NC,solid waste management,225,843975,5,12805,680,229,856780,2004
NC,sewerage,0,0,0,0,0,0,0,2004
NC,parks and recreation,877,2136159,183,154902,16658,972,2291061,2004
NC,housing and community development,0,0,0,0,0,0,0,2004
NC,natural resources,3615,10795894,750,987148,52224,3911,11783042,2004
NC,water transport and terminals,0,0,0,0,0,0,0,2004
NC,electric power,0,0,0,0,0,0,0,2004
NC,gas supply,0,0,0,0,0,0,0,2004
NC,transit,0,0,0,0,0,0,0,2004
NC,education - elementary and secondary instructional,0,0,0,0,0,0,0,2004
NC,education - elementary and secondary other,0,0,0,0,0,0,0,2004
NC,education - higher education instructional,11717,70210767,11654,15461549,658750,15462,85672316,2004
NC,education - higher education other,26670,86034298,21502,15795296,1333957,34251,101829594,2004
NC,education - other,2673,8596335,120,164107,6603,2711,8760442,2004
NC,libraries,0,0,0,0,0,0,0,2004
NC,liquor stores,0,0,0,0,0,0,0,2004
NC,other and unallocable,4256,14912834,71,71591,4728,4281,14984425,2004
ND,total,14163,44594781,8759,7320931,632113,17754,51915712,2004
ND,financial administration,634,1819020,49,62917,3873,656,1881937,2004
ND,other government administration,183,501905,135,59126,2348,197,561031,2004
ND,judicial and legal,498,1751355,65,61422,3498,519,1812777,2004
ND,police protection - officers,125,418379,0,0,0,125,418379,2004
ND,police protection - other,76,195844,7,9049,508,79,204893,2004
ND,corrections,607,1505776,81,136143,8577,656,1641919,2004
ND,highways,991,2997380,3,4661,323,993,3002041,2004
ND,air transportation,0,0,0,0,0,0,0,2004
ND,water transport and terminals,0,0,0,0,0,0,0,2004
ND,public welfare,402,1086984,98,127557,11670,469,1214541,2004
ND,health,1227,3442266,123,118794,7782,1271,3561060,2004
ND,hospitals,812,1719889,296,176500,30246,984,1896389,2004
ND,social insurance administration,354,1017394,38,50089,3842,376,1067483,2004
ND,solid waste management,0,0,0,0,0,0,0,2004
ND,sewerage,0,0,0,0,0,0,0,2004
ND,parks and recreation,120,271011,22,28182,2049,131,299193,2004
ND,housing and community development,0,0,0,0,0,0,0,2004
ND,natural resources,1050,3626194,622,559186,103512,1639,4185380,2004
ND,water transport and terminals,0,0,0,0,0,0,0,2004
ND,electric power,0,0,0,0,0,0,0,2004
ND,gas supply,0,0,0,0,0,0,0,2004
ND,transit,0,0,0,0,0,0,0,2004
ND,education - elementary and secondary instructional,0,0,0,0,0,0,0,2004
ND,education - elementary and secondary other,0,0,0,0,0,0,0,2004
ND,education - higher education instructional,1940,9693522,2164,3071545,199899,3075,12765067,2004
ND,education - higher education other,3631,9468000,4840,2679870,239250,4989,12147870,2004
ND,education - other,263,806261,41,46270,2938,280,852531,2004
ND,libraries,0,0,0,0,0,0,0,2004
ND,liquor stores,0,0,0,0,0,0,0,2004
ND,other and unallocable,1250,4273601,175,129620,11798,1315,4403221,2004
OH,total,111052,432011644,66144,63355128,4396460,136041,495366772,2004
OH,financial administration,8004,34928537,457,720880,47507,8274,35649417,2004
OH,other government administration,787,3076351,130,100218,8586,837,3176569,2004
OH,judicial and legal,2418,11069265,455,1084824,55338,2732,12154089,2004
OH,police protection - officers,1436,7728273,0,0,0,1436,7728273,2004
OH,police protection - other,1214,4345363,15,31257,2216,1227,4376620,2004
OH,corrections,16037,62529555,59,150410,7786,16082,62679965,2004
OH,highways,6893,27900602,524,628212,43848,7142,28528814,2004
OH,air transportation,0,0,0,0,0,0,0,2004
OH,water transport and terminals,0,0,0,0,0,0,0,2004
OH,public welfare,2672,12713045,235,300823,24853,2813,13013868,2004
OH,health,3540,16531995,293,395980,26632,3691,16927975,2004
OH,hospitals,9261,27586174,3130,7057477,382821,11436,34643651,2004
OH,social insurance administration,2166,7926765,522,503755,33991,2359,8430520,2004
OH,solid waste management,0,0,0,0,0,0,0,2004
OH,sewerage,0,0,0,0,0,0,0,2004
OH,parks and recreation,512,1872105,176,273847,19441,622,2145952,2004
OH,housing and community development,0,0,0,0,0,0,0,2004
OH,natural resources,2995,10617879,803,1235434,81187,3457,11853313,2004
OH,water transport and terminals,0,0,0,0,0,0,0,2004
OH,electric power,0,0,0,0,0,0,0,2004
OH,gas supply,0,0,0,0,0,0,0,2004
OH,transit,0,0,0,0,0,0,0,2004
OH,education - elementary and secondary instructional,0,0,0,0,0,0,0,2004
OH,education - elementary and secondary other,0,0,0,0,0,0,0,2004
OH,education - higher education instructional,14837,85172778,21146,25907794,1178572,21537,111080572,2004
OH,education - higher education other,31405,87705017,37628,24093508,2437877,45260,111798525,2004
OH,education - other,2393,10334425,248,452610,21884,2518,10787035,2004
OH,libraries,0,0,0,0,0,0,0,2004
OH,liquor stores,0,0,0,0,0,0,0,2004
OH,other and unallocable,4482,19973515,323,418099,23921,4618,20391614,2004
OK,total,56326,175769563,23988,17927860,1366786,64094,193697423,2004
OK,financial administration,1633,5116078,72,86539,5649,1665,5202617,2004
OK,other government administration,773,2606352,150,229539,17163,869,2835891,2004
OK,judicial and legal,2453,9044126,208,340426,19682,2565,9384552,2004
OK,police protection - officers,1010,3688682,0,0,0,1010,3688682,2004
OK,police protection - other,853,2175760,30,23135,2337,866,2198895,2004
OK,corrections,5414,15235528,263,292986,16840,5509,15528514,2004
OK,highways,2849,7944535,105,109813,7021,2889,8054348,2004
OK,air transportation,10,41038,0,0,0,10,41038,2004
OK,water transport and terminals,0,0,0,0,0,0,0,2004
OK,public welfare,5582,13931138,197,177732,16287,5674,14108870,2004
OK,health,5608,16739600,246,418826,22894,5738,17158426,2004
OK,hospitals,2394,6285349,71,111092,7134,2434,6396441,2004
OK,social insurance administration,1281,3820322,174,172477,14826,1365,3992799,2004
OK,solid waste management,74,219611,8,3164,449,77,222775,2004
OK,sewerage,0,0,0,0,0,0,0,2004
OK,parks and recreation,728,1790839,278,190448,22496,855,1981287,2004
OK,housing and community development,0,0,0,0,0,0,0,2004
OK,natural resources,1705,4832656,860,623579,48358,1980,5456235,2004
OK,water transport and terminals,0,0,0,0,0,0,0,2004
OK,electric power,494,2262426,0,0,0,494,2262426,2004
OK,gas supply,0,0,0,0,0,0,0,2004
OK,transit,0,0,0,0,0,0,0,2004
OK,education - elementary and secondary instructional,0,0,0,0,0,0,0,2004
OK,education - elementary and secondary other,0,0,0,0,0,0,0,2004
OK,education - higher education instructional,5793,29090600,5840,7297036,348651,7776,36387636,2004
OK,education - higher education other,13709,38734142,15192,7500707,794852,18231,46234849,2004
OK,education - other,1827,5450522,95,116893,7365,1869,5567415,2004
OK,libraries,0,0,0,0,0,0,0,2004
OK,liquor stores,0,0,0,0,0,0,0,2004
OK,other and unallocable,2136,6760259,199,233468,14782,2218,6993727,2004
OR,total,49640,181872527,25065,26511410,1370690,57423,208383937,2004
OR,financial administration,4091,13406765,512,763491,56431,4412,14170256,2004
OR,other government administration,871,3255930,221,369030,21371,991,3624960,2004
OR,judicial and legal,2784,9870621,463,553350,32540,2969,10423971,2004
OR,police protection - officers,649,2941808,49,68398,3800,671,3010206,2004
OR,police protection - other,473,1575312,163,129643,6269,508,1704955,2004
OR,corrections,4610,16160428,182,404957,20284,4725,16565385,2004
OR,highways,3336,12802757,46,112456,7385,3378,12915213,2004
OR,air transportation,16,64000,0,0,0,16,64000,2004
OR,water transport and terminals,0,0,0,0,0,0,0,2004
OR,public welfare,5358,17802647,321,795624,25941,5505,18598271,2004
OR,health,2450,8471429,274,509281,24742,2590,8980710,2004
OR,hospitals,4000,13325414,2790,4795443,141532,4804,18120857,2004
OR,social insurance administration,2052,8518968,297,519921,36794,2261,9038889,2004
OR,solid waste management,0,0,0,0,0,0,0,2004
OR,sewerage,0,0,0,0,0,0,0,2004
OR,parks and recreation,383,1231515,29,46275,3468,403,1277790,2004
OR,housing and community development,0,0,0,0,0,0,0,2004
OR,natural resources,2519,8338821,518,978969,62808,2875,9317790,2004
OR,water transport and terminals,0,0,0,0,0,0,0,2004
OR,electric power,0,0,0,0,0,0,0,2004
OR,gas supply,0,0,0,0,0,0,0,2004
OR,transit,0,0,0,0,0,0,0,2004
OR,education - elementary and secondary instructional,0,0,0,0,0,0,0,2004
OR,education - elementary and secondary other,0,0,0,0,0,0,0,2004
OR,education - higher education instructional,7138,32536955,7498,9548106,417966,9512,42085061,2004
OR,education - higher education other,6345,22193057,11386,6419320,481251,9080,28612377,2004
OR,education - other,886,3274976,128,233978,11694,952,3508954,2004
OR,libraries,0,0,0,0,0,0,0,2004
OR,liquor stores,163,488551,26,44564,3012,180,533115,2004
OR,other and unallocable,1516,5612573,162,218604,13402,1591,5831177,2004
PA,total,139421,541970428,53037,66222101,3688043,161089,608192529,2004
PA,financial administration,6678,25083243,561,871487,56913,7022,25954730,2004
PA,other government administration,3180,10678098,1074,2501642,113274,3851,13179740,2004
PA,judicial and legal,3001,14513655,30,57936,3863,3024,14571591,2004
PA,police protection - officers,4690,21880384,0,0,0,4690,21880384,2004
PA,police protection - other,1225,5723113,62,153202,7043,1265,5876315,2004
PA,corrections,16919,60965734,449,804320,66420,17319,61770054,2004
PA,highways,13203,42848071,706,1468184,88963,13730,44316255,2004
PA,air transportation,45,178676,0,0,0,45,178676,2004
PA,water transport and terminals,157,624284,0,0,0,157,624284,2004
PA,public welfare,12494,44205058,305,849299,36568,12714,45054357,2004
PA,health,1654,6745569,43,125089,4141,1679,6870658,2004
PA,hospitals,12215,36010839,1011,1681554,67910,12619,37692393,2004
PA,social insurance administration,3827,15030213,660,1535455,100686,4434,16565668,2004
PA,solid waste management,0,0,0,0,0,0,0,2004
PA,sewerage,0,0,0,0,0,0,0,2004
PA,parks and recreation,848,2830282,732,1567700,112990,1529,4397982,2004
PA,housing and community development,0,0,0,0,0,0,0,2004
PA,natural resources,6031,24534127,1406,3041691,110471,6685,27575818,2004
PA,water transport and terminals,0,0,0,0,0,0,0,2004
PA,electric power,0,0,0,0,0,0,0,2004
PA,gas supply,0,0,0,0,0,0,0,2004
PA,transit,0,0,0,0,0,0,0,2004
PA,education - elementary and secondary instructional,0,0,0,0,0,0,0,2004
PA,education - elementary and secondary other,0,0,0,0,0,0,0,2004
PA,education - higher education instructional,13030,90332538,10760,26902562,915442,18309,117235100,2004
PA,education - higher education other,28274,96163643,33739,23421479,1904148,39470,119585122,2004
PA,education - other,3755,14172808,72,185114,6918,3797,14357922,2004
PA,libraries,0,0,0,0,0,0,0,2004
PA,liquor stores,2695,8120762,1042,424738,43381,2956,8545500,2004
PA,other and unallocable,5500,21329331,385,630649,48912,5794,21959980,2004
RI,total,18087,76193628,6420,5586088,342452,20158,81779716,2004
RI,financial administration,937,3744292,8,14176,844,943,3758468,2004
RI,other government administration,660,2388633,264,118979,3903,685,2507612,2004
RI,judicial and legal,1137,5099750,31,86212,2642,1153,5185962,2004
RI,police protection - officers,201,1364347,0,0,0,201,1364347,2004
RI,police protection - other,80,335755,3,1561,45,80,337316,2004
RI,corrections,1715,7941303,5,8325,215,1716,7949628,2004
RI,highways,839,3573584,12,28166,1145,846,3601750,2004
RI,air transportation,188,744046,2,4988,224,189,749034,2004
RI,water transport and terminals,0,0,0,0,0,0,0,2004
RI,public welfare,1446,6777450,40,130970,4225,1474,6908420,2004
RI,health,1317,5679896,57,51622,1514,1326,5731518,2004
RI,hospitals,1221,5096217,8,30354,806,1226,5126571,2004
RI,social insurance administration,498,2020339,14,17468,598,502,2037807,2004
RI,solid waste management,126,626048,1,886,89,127,626934,2004
RI,sewerage,244,971284,0,0,0,244,971284,2004
RI,parks and recreation,69,213279,0,0,0,69,213279,2004
RI,housing and community development,0,0,0,0,0,0,0,2004
RI,natural resources,480,2077315,38,67851,3399,500,2145166,2004
RI,water transport and terminals,0,0,0,0,0,0,0,2004
RI,electric power,0,0,0,0,0,0,0,2004
RI,gas supply,0,0,0,0,0,0,0,2004
RI,transit,848,2721359,50,95445,6967,888,2816804,2004
RI,education - elementary and secondary instructional,427,1942124,73,91009,6602,470,2033133,2004
RI,education - elementary and secondary other,87,245676,81,84591,8717,143,330267,2004
RI,education - higher education instructional,1742,8198820,2558,3015248,139505,2598,11214068,2004
RI,education - higher education other,2168,7261210,3032,1468734,146744,3030,8729944,2004
RI,education - other,540,2447394,84,197743,10426,608,2645137,2004
RI,libraries,0,0,0,0,0,0,0,2004
RI,liquor stores,0,0,0,0,0,0,0,2004
RI,other and unallocable,1117,4723507,59,71760,3842,1140,4795267,2004
SC,total,68209,210177032,20172,16733080,1237656,75603,226910112,2004
SC,financial administration,2015,6881548,55,86202,3040,2033,6967750,2004
SC,other government administration,458,1611326,493,499351,35658,673,2110677,2004
SC,judicial and legal,670,2801242,6,8714,488,673,2809956,2004
SC,police protection - officers,1277,4201344,0,0,0,1277,4201344,2004
SC,police protection - other,1673,3881812,9,15904,516,1676,3897716,2004
SC,corrections,7568,18214388,6,9858,354,7570,18224246,2004
SC,highways,4824,12699592,7,12120,390,4826,12711712,2004
SC,air transportation,0,0,0,0,0,0,0,2004
SC,water transport and terminals,572,2563267,4,8148,611,575,2571415,2004
SC,public welfare,4364,10999534,13,22370,678,4367,11021904,2004
SC,health,6791,19183016,156,361803,9078,6844,19544819,2004
SC,hospitals,7875,16486153,220,467593,27215,8031,16953746,2004
SC,social insurance administration,1271,3700410,2,5360,56,1271,3705770,2004
SC,solid waste management,0,0,0,0,0,0,0,2004
SC,sewerage,0,0,0,0,0,0,0,2004
SC,parks and recreation,563,1393630,8,4518,491,565,1398148,2004
SC,housing and community development,0,0,0,0,0,0,0,2004
SC,natural resources,1827,5602680,214,230562,21170,1954,5833242,2004
SC,water transport and terminals,10,44825,0,0,0,10,44825,2004
SC,electric power,1736,8343612,23,70210,2927,1753,8413822,2004
SC,gas supply,0,0,0,0,0,0,0,2004
SC,transit,0,0,0,0,0,0,0,2004
SC,education - elementary and secondary instructional,0,0,0,0,0,0,0,2004
SC,education - elementary and secondary other,0,0,0,0,0,0,0,2004
SC,education - higher education instructional,8369,44538259,8566,9059300,518985,11489,53597559,2004
SC,education - higher education other,12419,34723252,10367,5839477,614889,16084,40562729,2004
SC,education - other,2705,8329528,13,15708,584,2708,8345236,2004
SC,libraries,0,0,0,0,0,0,0,2004
SC,liquor stores,0,0,0,0,0,0,0,2004
SC,other and unallocable,1222,3977614,10,15882,526,1224,3993496,2004
SD,total,10991,35282687,5242,4767670,389083,13201,40050357,2004
SD,financial administration,381,1200678,47,103838,5824,413,1304516,2004
SD,other government administration,278,900908,66,84642,5008,306,985550,2004
SD,judicial and legal,491,1718508,152,276480,14880,576,1994988,2004
SD,police protection - officers,171,644066,4,13122,694,175,657188,2004
SD,police protection - other,98,259708,2,1868,200,99,261576,2004
SD,corrections,706,1822938,120,201810,15100,792,2024748,2004
SD,highways,859,2489194,172,334832,20580,976,2824026,2004
SD,air transportation,0,0,0,0,0,0,0,2004
SD,water transport and terminals,0,0,0,0,0,0,0,2004
SD,public welfare,943,2543520,113,194464,14404,1024,2737984,2004
SD,health,508,1640680,179,421868,22450,636,2062548,2004
SD,hospitals,773,1919684,221,380336,27612,930,2300020,2004
SD,social insurance administration,264,635664,16,22898,1938,275,658562,2004
SD,solid waste management,0,0,0,0,0,0,0,2004
SD,sewerage,0,0,0,0,0,0,0,2004
SD,parks and recreation,111,297330,40,52546,3958,133,349876,2004
SD,housing and community development,0,0,0,0,0,0,0,2004
SD,natural resources,684,2123496,382,358830,29259,850,2482326,2004
SD,water transport and terminals,0,0,0,0,0,0,0,2004
SD,electric power,0,0,0,0,0,0,0,2004
SD,gas supply,0,0,0,0,0,0,0,2004
SD,transit,0,0,0,0,0,0,0,2004
SD,education - elementary and secondary instructional,0,0,0,0,0,0,0,2004
SD,education - elementary and secondary other,0,0,0,0,0,0,0,2004
SD,education - higher education instructional,1344,7699946,1085,1225464,90040,1856,8925410,2004
SD,education - higher education other,2274,6185359,2483,898173,123356,2975,7083532,2004
SD,education - other,371,1016830,53,59631,4484,397,1076461,2004
SD,libraries,0,0,0,0,0,0,0,2004
SD,liquor stores,0,0,0,0,0,0,0,2004
SD,other and unallocable,735,2184178,107,136868,9296,788,2321046,2004
TN,total,72330,224646682,25088,21349129,1619216,81905,245995811,2004
TN,financial administration,2717,9267197,40,53646,4185,2742,9320843,2004
TN,other government administration,822,2701444,28,27563,1406,831,2729007,2004
TN,judicial and legal,2014,8676176,10,9116,605,2018,8685292,2004
TN,police protection - officers,1097,3958738,0,0,0,1097,3958738,2004
TN,police protection - other,858,2283054,1,818,120,859,2283872,2004
TN,corrections,6929,18250184,54,84360,5007,6959,18334544,2004
TN,highways,4452,11353976,0,0,0,4452,11353976,2004
TN,air transportation,0,0,0,0,0,0,0,2004
TN,water transport and terminals,0,0,0,0,0,0,0,2004
TN,public welfare,5993,14862690,7,8158,634,5996,14870848,2004
TN,health,3394,10368275,151,113673,6244,3430,10481948,2004
TN,hospitals,7912,21421077,223,593795,32314,8097,22014872,2004
TN,social insurance administration,1417,3851626,184,251548,20768,1542,4103174,2004
TN,solid waste management,0,0,0,0,0,0,0,2004
TN,sewerage,0,0,0,0,0,0,0,2004
TN,parks and recreation,1029,1995776,92,59022,8954,1083,2054798,2004
TN,housing and community development,0,0,0,0,0,0,0,2004
TN,natural resources,3237,9757553,591,590774,61305,3596,10348327,2004
TN,water transport and terminals,0,0,0,0,0,0,0,2004
TN,electric power,0,0,0,0,0,0,0,2004
TN,gas supply,0,0,0,0,0,0,0,2004
TN,transit,0,0,0,0,0,0,0,2004
TN,education - elementary and secondary instructional,0,0,0,0,0,0,0,2004
TN,education - elementary and secondary other,0,0,0,0,0,0,0,2004
TN,education - higher education instructional,8195,42954028,9008,9597250,508348,11216,52551278,2004
TN,education - higher education other,17658,49305189,14447,9778244,957924,23311,59083433,2004
TN,education - other,1922,5810828,200,151384,9732,1982,5962212,2004
TN,libraries,0,0,0,0,0,0,0,2004
TN,liquor stores,0,0,0,0,0,0,0,2004
TN,other and unallocable,2684,7828871,52,29778,1670,2694,7858649,2004
TX,total,241123,837654558,72303,82066534,4760809,268172,919721092,2004
TX,financial administration,9070,30585228,180,239081,14442,9153,30824309,2004
TX,other government administration,2024,7212965,573,607916,40832,2255,7820881,2004
TX,judicial and legal,5212,21499686,197,1000767,18096,5316,22500453,2004
TX,police protection - officers,2176,8085346,0,0,0,2176,8085346,2004
TX,police protection - other,1860,5120627,23,21704,1840,1870,5142331,2004
TX,corrections,46597,112730066,603,672227,52013,46892,113402293,2004
TX,highways,14923,48158886,628,948361,29026,15087,49107247,2004
TX,air transportation,0,0,0,0,0,0,0,2004
TX,water transport and terminals,0,0,0,0,0,0,0,2004
TX,public welfare,18523,49829229,100,169724,10297,18581,49998953,2004
TX,health,12101,40331434,656,1383030,53415,12408,41714464,2004
TX,hospitals,29256,94736917,1861,3683210,205793,30426,98420127,2004
TX,social insurance administration,4571,14136296,55,85597,5452,4602,14221893,2004
TX,solid waste management,0,0,0,0,0,0,0,2004
TX,sewerage,0,0,0,0,0,0,0,2004
TX,parks and recreation,991,2372135,182,149229,18773,1098,2521364,2004
TX,housing and community development,0,0,0,0,0,0,0,2004
TX,natural resources,9951,34805155,3059,4540695,192490,11043,39345850,2004
TX,water transport and terminals,0,0,0,0,0,0,0,2004
TX,electric power,0,0,0,0,0,0,0,2004
TX,gas supply,0,0,0,0,0,0,0,2004
TX,transit,0,0,0,0,0,0,0,2004
TX,education - elementary and secondary instructional,13,43437,0,0,0,13,43437,2004
TX,education - elementary and secondary other,0,0,0,0,0,0,0,2004
TX,education - higher education instructional,20363,146051515,22925,35325973,1540464,29111,181377488,2004
TX,education - higher education other,52315,183722247,40450,31839963,2494579,66488,215562210,2004
TX,education - other,4532,15536678,455,892406,51027,4823,16429084,2004
TX,libraries,0,0,0,0,0,0,0,2004
TX,liquor stores,0,0,0,0,0,0,0,2004
TX,other and unallocable,6645,22696711,356,506651,32270,6830,23203362,2004
UT,total,41872,143772627,19480,15196410,1228516,48900,158969037,2004
UT,financial administration,1610,5198027,246,247342,22260,1735,5445369,2004
UT,other government administration,167,794141,118,155560,13365,242,949701,2004
UT,judicial and legal,1448,5145046,194,275623,13400,1524,5420669,2004
UT,police protection - officers,418,1410477,0,0,0,418,1410477,2004
UT,police protection - other,335,1176568,54,53313,4342,360,1229881,2004
UT,corrections,3036,8992309,283,212162,20262,3152,9204471,2004
UT,highways,1695,6130469,44,60349,4337,1720,6190818,2004
UT,air transportation,0,0,0,0,0,0,0,2004
UT,water transport and terminals,0,0,0,0,0,0,0,2004
UT,public welfare,3171,9533940,300,440236,28239,3332,9974176,2004
UT,health,1875,5969221,267,424821,25106,2017,6394042,2004
UT,hospitals,5524,15864607,368,354507,29527,5691,16219114,2004
UT,social insurance administration,819,2574180,70,105479,6671,857,2679659,2004
UT,solid waste management,0,0,0,0,0,0,0,2004
UT,sewerage,0,0,0,0,0,0,0,2004
UT,parks and recreation,235,800636,56,61563,6286,270,862199,2004
UT,housing and community development,0,0,0,0,0,0,0,2004
UT,natural resources,1056,3565747,234,201914,15958,1147,3767661,2004
UT,water transport and terminals,0,0,0,0,0,0,0,2004
UT,electric power,0,0,0,0,0,0,0,2004
UT,gas supply,0,0,0,0,0,0,0,2004
UT,transit,0,0,0,0,0,0,0,2004
UT,education - elementary and secondary instructional,0,0,0,0,0,0,0,2004
UT,education - elementary and secondary other,0,0,0,0,0,0,0,2004
UT,education - higher education instructional,4383,29455172,3595,3172378,174741,5393,32627550,2004
UT,education - higher education other,13367,38168878,12659,8466448,785418,17862,46635326,2004
UT,education - other,859,2777988,450,502233,38335,1077,3280221,2004
UT,libraries,0,0,0,0,0,0,0,2004
UT,liquor stores,224,551087,268,135333,16275,316,686420,2004
UT,other and unallocable,1650,5664134,274,327149,23994,1787,5991283,2004
VT,total,12770,47265851,2709,3441049,195795,13922,50706900,2004
VT,financial administration,608,2141053,9,19569,1086,615,2160622,2004
VT,other government administration,472,1499834,200,485732,27338,627,1985566,2004
VT,judicial and legal,569,2233117,51,111457,5728,602,2344574,2004
VT,police protection - officers,292,1632367,23,22873,1694,302,1655240,2004
VT,police protection - other,88,292417,0,0,0,88,292417,2004
VT,corrections,1102,3657570,14,33126,1798,1112,3690696,2004
VT,highways,1059,3712834,14,45124,2094,1071,3757958,2004
VT,air transportation,0,0,0,0,0,0,0,2004
VT,water transport and terminals,0,0,0,0,0,0,0,2004
VT,public welfare,1143,3997612,54,141850,6868,1183,4139462,2004
VT,health,545,2077376,313,473452,32794,731,2550828,2004
VT,hospitals,207,638836,9,24901,1034,213,663737,2004
VT,social insurance administration,288,1006358,7,21846,1202,295,1028204,2004
VT,solid waste management,0,0,0,0,0,0,0,2004
VT,sewerage,0,0,0,0,0,0,0,2004
VT,parks and recreation,123,441356,7,22764,1080,129,464120,2004
VT,housing and community development,0,0,0,0,0,0,0,2004
VT,natural resources,535,2106472,54,213934,7314,577,2320406,2004
VT,water transport and terminals,0,0,0,0,0,0,0,2004
VT,electric power,0,0,0,0,0,0,0,2004
VT,gas supply,0,0,0,0,0,0,0,2004
VT,transit,0,0,0,0,0,0,0,2004
VT,education - elementary and secondary instructional,0,0,0,0,0,0,0,2004
VT,education - elementary and secondary other,0,0,0,0,0,0,0,2004
VT,education - higher education instructional,1290,7477830,448,741203,27372,1455,8219033,2004
VT,education - higher education other,2800,8338105,1369,825669,64432,3188,9163774,2004
VT,education - other,543,2053874,39,77495,4043,567,2131369,2004
VT,libraries,0,0,0,0,0,0,0,2004
VT,liquor stores,56,198908,1,1078,97,57,199986,2004
VT,other and unallocable,1050,3759932,97,178976,9821,1110,3938908,2004
VA,total,101954,358372929,46811,46508413,3051561,119317,404881342,2004
VA,financial administration,3928,13668419,615,804725,68919,4320,14473144,2004
VA,other government administration,500,2069584,557,1002097,68780,912,3071681,2004
VA,judicial and legal,3435,13577954,399,638478,21698,3558,14216432,2004
VA,police protection - officers,1853,7834336,0,0,0,1853,7834336,2004
VA,police protection - other,927,2405356,173,186268,14766,1011,2591624,2004
VA,corrections,13780,37026290,371,520478,38136,13997,37546768,2004
VA,highways,9834,30976956,698,406958,28680,9997,31383914,2004
VA,air transportation,0,0,0,0,0,0,0,2004
VA,water transport and terminals,140,604518,4,4544,504,143,609062,2004
VA,public welfare,2249,7394492,191,336852,19766,2360,7731344,2004
VA,health,4955,16793106,454,607021,43129,5201,17400127,2004
VA,hospitals,12582,36822341,1286,2253381,120974,13267,39075722,2004
VA,social insurance administration,1325,4307538,592,1006760,80168,1780,5314298,2004
VA,solid waste management,0,0,0,0,0,0,0,2004
VA,sewerage,0,0,0,0,0,0,0,2004
VA,parks and recreation,581,1746286,592,437958,45026,836,2184244,2004
VA,housing and community development,0,0,0,0,0,0,0,2004
VA,natural resources,2974,9704312,419,425914,33094,3162,10130226,2004
VA,water transport and terminals,0,0,0,0,0,0,0,2004
VA,electric power,0,0,0,0,0,0,0,2004
VA,gas supply,0,0,0,0,0,0,0,2004
VA,transit,0,0,0,0,0,0,0,2004
VA,education - elementary and secondary instructional,0,0,0,0,0,0,0,2004
VA,education - elementary and secondary other,0,0,0,0,0,0,0,2004
VA,education - higher education instructional,12905,76365665,13851,19872064,740066,17111,96237729,2004
VA,education - higher education other,23102,70908554,24302,15457346,1508678,31676,86365900,2004
VA,education - other,2528,9315360,560,550914,41977,2768,9866274,2004
VA,libraries,0,0,0,0,0,0,0,2004
VA,liquor stores,719,2046598,1071,1064436,112028,1356,3111034,2004
VA,other and unallocable,3637,14805264,676,932219,65172,4009,15737483,2004
WA,total,93661,371700967,52179,53143142,3346009,112738,424844109,2004
WA,financial administration,2609,10343150,232,523928,25236,2753,10867078,2004
WA,other government administration,1134,4482342,374,725490,42188,1373,5207832,2004
WA,judicial and legal,1759,9196144,180,279540,11528,1825,9475684,2004
WA,police protection - officers,983,5295916,0,0,0,983,5295916,2004
WA,police protection - other,1227,4846646,0,0,0,1227,4846646,2004
WA,corrections,8813,29262782,563,787895,45003,9069,30050677,2004
WA,highways,6688,28847118,361,771010,36390,6894,29618128,2004
WA,air transportation,0,0,0,0,0,0,0,2004
WA,water transport and terminals,0,0,0,0,0,0,0,2004
WA,public welfare,8268,32301578,863,1547252,78701,8715,33848830,2004
WA,health,4780,17315866,1023,1826438,102718,5363,19142304,2004
WA,hospitals,7503,30122716,2882,6810948,239154,8861,36933664,2004
WA,social insurance administration,3581,13204795,966,1696729,95009,4122,14901524,2004
WA,solid waste management,150,599894,26,74790,2428,164,674684,2004
WA,sewerage,0,0,0,0,0,0,0,2004
WA,parks and recreation,552,1973581,148,203788,16902,648,2177369,2004
WA,housing and community development,0,0,0,0,0,0,0,2004
WA,natural resources,4545,17343954,661,1118445,72902,4960,18462399,2004
WA,water transport and terminals,0,0,0,0,0,0,0,2004
WA,electric power,0,0,0,0,0,0,0,2004
WA,gas supply,0,0,0,0,0,0,0,2004
WA,transit,0,0,0,0,0,0,0,2004
WA,education - elementary and secondary instructional,0,0,0,0,0,0,0,2004
WA,education - elementary and secondary other,0,0,0,0,0,0,0,2004
WA,education - higher education instructional,10631,53944510,12340,19707352,637054,14262,73651862,2004
WA,education - higher education other,23334,85683485,29684,14452036,1789648,33546,100135521,2004
WA,education - other,1809,6955045,912,985810,53054,2120,7940855,2004
WA,libraries,0,0,0,0,0,0,0,2004
WA,liquor stores,460,1458616,469,736730,53860,766,2195346,2004
WA,other and unallocable,4835,18522829,495,894961,44234,5087,19417790,2004
WV,total,34751,103998345,9288,7414143,468134,37583,111412488,2004
WV,financial administration,2406,6324712,34,26506,2431,2420,6351218,2004
WV,other government administration,277,850394,331,991994,27264,450,1842388,2004
WV,judicial and legal,1346,4439657,14,12204,864,1351,4451861,2004
WV,police protection - officers,611,2208670,0,0,0,611,2208670,2004
WV,police protection - other,352,741556,12,4524,596,355,746080,2004
WV,corrections,3034,6423052,10,10976,1044,3040,6434028,2004
WV,highways,5378,15919606,35,62047,4543,5403,15981653,2004
WV,air transportation,2,11121,0,0,0,2,11121,2004
WV,water transport and terminals,3,12509,0,0,0,3,12509,2004
WV,public welfare,3107,7197996,15,16806,1126,3113,7214802,2004
WV,health,849,2370012,37,46868,2386,863,2416880,2004
WV,hospitals,1584,3615766,162,197692,12882,1657,3813458,2004
WV,social insurance administration,643,1704138,43,37650,3744,666,1741788,2004
WV,solid waste management,10,33698,0,0,0,10,33698,2004
WV,sewerage,0,0,0,0,0,0,0,2004
WV,parks and recreation,413,830348,326,211266,34230,607,1041614,2004
WV,housing and community development,0,0,0,0,0,0,0,2004
WV,natural resources,2179,6817550,205,167242,16055,2273,6984792,2004
WV,water transport and terminals,0,0,0,0,0,0,0,2004
WV,electric power,0,0,0,0,0,0,0,2004
WV,gas supply,0,0,0,0,0,0,0,2004
WV,transit,7,23918,0,0,0,7,23918,2004
WV,education - elementary and secondary instructional,0,0,0,0,0,0,0,2004
WV,education - elementary and secondary other,0,0,0,0,0,0,0,2004
WV,education - higher education instructional,3186,16044530,3772,3741056,142047,4055,19785586,2004
WV,education - higher education other,5725,16990451,3967,1607634,200220,6948,18598085,2004
WV,education - other,1327,4228444,226,194216,11862,1398,4422660,2004
WV,libraries,0,0,0,0,0,0,0,2004
WV,liquor stores,55,154708,2,2718,216,56,157426,2004
WV,other and unallocable,2257,7055509,97,82744,6624,2295,7138253,2004
WI,total,55227,234118454,41158,41346837,2570886,69834,275465291,2004
WI,financial administration,2585,10414815,697,1012111,72091,2995,11426926,2004
WI,other government administration,914,3801520,353,726678,32061,1096,4528198,2004
WI,judicial and legal,1838,10492670,262,808591,31939,2019,11301261,2004
WI,police protection - officers,598,2572509,0,0,0,598,2572509,2004
WI,police protection - other,312,1131202,23,23222,1946,323,1154424,2004
WI,corrections,8873,30833148,905,1910030,93933,9405,32743178,2004
WI,highways,1719,7251855,192,260820,16516,1813,7512675,2004
WI,air transportation,0,0,0,0,0,0,0,2004
WI,water transport and terminals,0,0,0,0,0,0,0,2004
WI,public welfare,1140,4019126,348,548439,36263,1346,4567565,2004
WI,health,1458,6190632,547,933783,49042,1737,7124415,2004
WI,hospitals,3140,10681656,1348,2098927,113666,3787,12780583,2004
WI,social insurance administration,1017,3956219,37,50307,3369,1036,4006526,2004
WI,solid waste management,0,0,0,0,0,0,0,2004
WI,sewerage,0,0,0,0,0,0,0,2004
WI,parks and recreation,162,545795,47,79082,4667,189,624877,2004
WI,housing and community development,0,0,0,0,0,0,0,2004
WI,natural resources,1902,7220361,1030,1425957,91601,2422,8646318,2004
WI,water transport and terminals,0,0,0,0,0,0,0,2004
WI,electric power,0,0,0,0,0,0,0,2004
WI,gas supply,0,0,0,0,0,0,0,2004
WI,transit,0,0,0,0,0,0,0,2004
WI,education - elementary and secondary instructional,0,0,0,0,0,0,0,2004
WI,education - elementary and secondary other,0,0,0,0,0,0,0,2004
WI,education - higher education instructional,7751,46784839,9112,14528078,591682,11113,61312917,2004
WI,education - higher education other,15472,62227939,24799,14635509,1308513,22907,76863448,2004
WI,education - other,1014,4247663,236,334405,18234,1118,4582068,2004
WI,libraries,0,0,0,0,0,0,0,2004
WI,liquor stores,0,0,0,0,0,0,0,2004
WI,other and unallocable,5332,21746505,1222,1970898,105363,5930,23717403,2004
WY,total,11223,35959105,3278,2209999,149482,12063,38169104,2004
WY,financial administration,528,1820034,8,13816,693,532,1833850,2004
WY,other government administration,135,529894,182,187022,15206,220,716916,2004
WY,judicial and legal,473,1827856,26,36531,2255,485,1864387,2004
WY,police protection - officers,170,737781,0,0,0,170,737781,2004
WY,police protection - other,83,272997,0,0,0,83,272997,2004
WY,corrections,943,2529169,5,5411,434,945,2534580,2004
WY,highways,1768,5761421,96,146373,12908,1841,5907794,2004
WY,air transportation,0,0,0,0,0,0,0,2004
WY,water transport and terminals,0,0,0,0,0,0,0,2004
WY,public welfare,750,2249714,50,43145,3999,772,2292859,2004
WY,health,612,1954236,116,139535,10030,668,2093771,2004
WY,hospitals,798,1862707,48,60696,4160,821,1923403,2004
WY,social insurance administration,259,772834,53,56598,4593,285,829432,2004
WY,solid waste management,0,0,0,0,0,0,0,2004
WY,sewerage,0,0,0,0,0,0,0,2004
WY,parks and recreation,98,282750,13,10497,1105,104,293247,2004
WY,housing and community development,0,0,0,0,0,0,0,2004
WY,natural resources,821,2581391,20,20334,1484,828,2601725,2004
WY,water transport and terminals,0,0,0,0,0,0,0,2004
WY,electric power,0,0,0,0,0,0,0,2004
WY,gas supply,0,0,0,0,0,0,0,2004
WY,transit,0,0,0,0,0,0,0,2004
WY,education - elementary and secondary instructional,0,0,0,0,0,0,0,2004
WY,education - elementary and secondary other,0,0,0,0,0,0,0,2004
WY,education - higher education instructional,953,4607759,743,622995,26332,1103,5230754,2004
WY,education - higher education other,1838,4996859,1857,812093,61022,2185,5808952,2004
WY,education - other,221,809487,6,5204,520,223,814691,2004
WY,libraries,0,0,0,0,0,0,0,2004
WY,liquor stores,31,89742,0,0,0,31,89742,2004
WY,other and unallocable,742,2272474,55,49749,4741,767,2322223,2004
