state,government_function,full_time_employees,full_time_pay,part_time_employees,part_time_pay,part_time_hours,full_time_equivalent_employees,total_march_pay,year
US,total,3658859,14510933884,1419409,1550636537,95634091,4208522,16061570421,2005
US,financial administration,161859,605928842,11514,18626924,1196270,168712,624555766,2005
US,other government administration,48647,192847425,12514,24424938,1211357,55665,217272363,2005
US,judicial and legal,159335,714739604,9708,20792566,913849,164595,735532170,2005
US,police protection - officers,62716,312415072,744,393400,18861,62823,312808472,2005
US,police protection - other,39036,145552535,1974,2307420,150260,39890,147859955,2005
US,corrections,458365,1589701989,10734,22242528,1104474,464701,1611944517,2005
US,highways,232076,867230520,10134,18655086,1040344,238061,885885606,2005
US,air transportation,3199,14563901,170,277698,12940,3272,14841599,2005
US,water transport and terminals,4770,21119366,78,118105,7131,4810,21237471,2005
US,public welfare,224207,733722734,11203,20880161,1186712,231038,754602895,2005
US,health,170608,621491188,14326,27894451,1373149,178465,649385639,2005
US,hospitals,366135,1288619346,57039,122632089,5718511,398696,1411251435,2005
US,social insurance administration,79819,292863330,7468,13944742,843485,84685,306808072,2005
US,solid waste management,1755,8505492,127,366343,14778,1841,8871835,2005
US,sewerage,1715,8996816,49,152236,5050,1744,9149052,2005
US,parks and recreation,26971,83766571,13521,15751992,1335178,34624,99518563,2005
US,housing and community development,0,0,0,0,0,0,0,2005
US,natural resources,129906,481994374,31681,40544319,2836986,146161,522538693,2005
US,water transport and terminals,664,3291324,35,79678,4309,688,3371002,2005
US,electric power,4022,23227260,50,154305,5466,4053,23381565,2005
US,gas supply,0,0,0,0,0,0,0,2005
US,transit,31724,161512769,1916,3214583,200969,32865,164727352,2005
US,education - elementary and secondary instructional,32483,158441784,8520,8756943,461572,35259,167198727,2005
US,education - elementary and secondary other,11010,31372756,6765,4634446,359368,13212,36007202,2005
US,education - higher education instructional,362237,2229436104,381870,546842531,24264986,501743,2776278635,2005
US,education - higher education other,763479,2768306924,795616,588287886,48724381,1043636,3356594810,2005
US,education - other,84024,314435716,12754,18406451,1045953,90032,332842167,2005
US,libraries,482,1496498,240,148210,16004,573,1644708,2005
US,liquor stores,5985,17116458,2792,2530585,246451,7396,19647043,2005
US,other and unallocable,191630,818237186,15867,27575921,1335297,199282,845813107,2005
AL,total,75361,269187526,27529,26301593,1731675,85324,295489119,2005
AL,financial administration,2591,8878638,67,59581,7998,2637,8938219,2005
AL,other government administration,532,2087999,91,111223,6304,569,2199222,2005
AL,judicial and legal,3186,12207791,90,148685,3378,3205,12356476,2005
AL,police protection - officers,754,3481953,0,0,0,754,3481953,2005
AL,police protection - other,628,1751483,0,0,0,628,1751483,2005
AL,corrections,4874,15013137,8,11663,1034,4880,15024800,2005
AL,highways,4320,11731118,86,70284,7703,4364,11801402,2005
AL,air transportation,0,0,0,0,0,0,0,2005
AL,water transport and terminals,509,2074694,1,1200,45,509,2075894,2005
AL,public welfare,4324,13352364,36,58828,3496,4344,13411192,2005
AL,health,5028,15658160,437,476725,55224,5342,16134885,2005
AL,hospitals,10576,35328836,1721,3920736,143664,11392,39249572,2005
AL,social insurance administration,1153,3550348,19,13844,1804,1163,3564192,2005
AL,solid waste management,0,0,0,0,0,0,0,2005
AL,sewerage,0,0,0,0,0,0,0,2005
AL,parks and recreation,476,1192066,135,90501,13466,553,1282567,2005
AL,housing and community development,0,0,0,0,0,0,0,2005
AL,natural resources,2050,6809853,218,221771,21802,2175,7031624,2005
AL,water transport and terminals,0,0,0,0,0,0,0,2005
AL,electric power,0,0,0,0,0,0,0,2005
AL,gas supply,0,0,0,0,0,0,0,2005
AL,transit,0,0,0,0,0,0,0,2005
AL,education - elementary and secondary instructional,0,0,0,0,0,0,0,2005
AL,education - elementary and secondary other,0,0,0,0,0,0,0,2005
AL,education - higher education instructional,9032,54773194,8570,8718293,438048,11570,63491487,2005
AL,education - higher education other,19521,63562702,15508,11857301,973544,25128,75420003,2005
AL,education - other,3169,9653202,126,112079,6382,3204,9765281,2005
AL,libraries,0,0,0,0,0,0,0,2005
AL,liquor stores,659,1460861,5,8342,675,663,1469203,2005
AL,other and unallocable,1979,6619127,411,420537,47108,2244,7039664,2005
AK,total,22456,95083325,5548,5832108,360190,24553,100915433,2005
AK,financial administration,928,4006972,25,29126,1802,939,4036098,2005
AK,other government administration,630,2469544,51,62493,3591,652,2532037,2005
AK,judicial and legal,1232,5488984,73,122956,5016,1262,5611940,2005
AK,police protection - officers,280,1631471,0,0,0,280,1631471,2005
AK,police protection - other,156,521677,63,20245,1628,166,541922,2005
AK,corrections,1698,7116272,36,44282,3499,1719,7160554,2005
AK,highways,2875,12728637,25,33298,2348,2889,12761935,2005
AK,air transportation,0,0,0,0,0,0,0,2005
AK,water transport and terminals,0,0,0,0,0,0,0,2005
AK,public welfare,1636,5797804,135,174368,17216,1740,5972172,2005
AK,health,661,2917751,26,40977,2390,675,2958728,2005
AK,hospitals,207,846100,10,14920,798,212,861020,2005
AK,social insurance administration,466,1672983,7,9632,650,470,1682615,2005
AK,solid waste management,0,0,0,0,0,0,0,2005
AK,sewerage,0,0,0,0,0,0,0,2005
AK,parks and recreation,83,294534,2,2630,140,84,297164,2005
AK,housing and community development,0,0,0,0,0,0,0,2005
AK,natural resources,2247,9187007,100,155396,9288,2301,9342403,2005
AK,water transport and terminals,0,0,0,0,0,0,0,2005
AK,electric power,0,0,0,0,0,0,0,2005
AK,gas supply,0,0,0,0,0,0,0,2005
AK,transit,0,0,0,0,0,0,0,2005
AK,education - elementary and secondary instructional,1838,7559622,624,579323,36402,2061,8138945,2005
AK,education - elementary and secondary other,849,2263825,629,566986,38172,1083,2830811,2005
AK,education - higher education instructional,948,6262700,1164,1345880,36682,1156,7608580,2005
AK,education - higher education other,2644,10389009,2471,2516193,195286,3754,12905202,2005
AK,education - other,242,967129,26,12528,965,248,979657,2005
AK,libraries,0,0,0,0,0,0,0,2005
AK,liquor stores,0,0,0,0,0,0,0,2005
AK,other and unallocable,2836,12961304,81,100875,4317,2862,13062179,2005
AZ,total,59077,209192910,26783,24290904,1787009,69226,233483814,2005
AZ,financial administration,3681,11435885,30,48056,2257,3694,11483941,2005
AZ,other government administration,678,2563662,150,262905,11199,741,2826567,2005
AZ,judicial and legal,2250,8880267,108,237043,11299,2313,9117310,2005
AZ,police protection - officers,1122,4790952,0,0,0,1122,4790952,2005
AZ,police protection - other,891,3523411,2,3560,263,892,3526971,2005
AZ,corrections,10270,29003150,65,160039,6022,10304,29163189,2005
AZ,highways,2875,9509641,0,0,0,2875,9509641,2005
AZ,air transportation,0,0,0,0,0,0,0,2005
AZ,water transport and terminals,0,0,0,0,0,0,0,2005
AZ,public welfare,7381,20665715,122,214885,12768,7453,20880600,2005
AZ,health,2412,7713445,54,117802,5542,2444,7831247,2005
AZ,hospitals,719,2341555,40,67447,3204,737,2409002,2005
AZ,social insurance administration,402,991626,13,17006,1297,409,1008632,2005
AZ,solid waste management,0,0,0,0,0,0,0,2005
AZ,sewerage,0,0,0,0,0,0,0,2005
AZ,parks and recreation,355,1046535,111,69854,8734,405,1116389,2005
AZ,housing and community development,0,0,0,0,0,0,0,2005
AZ,natural resources,2489,10058481,834,1054208,69369,2884,11112689,2005
AZ,water transport and terminals,0,0,0,0,0,0,0,2005
AZ,electric power,10,51100,0,0,0,10,51100,2005
AZ,gas supply,0,0,0,0,0,0,0,2005
AZ,transit,0,0,0,0,0,0,0,2005
AZ,education - elementary and secondary instructional,0,0,0,0,0,0,0,2005
AZ,education - elementary and secondary other,0,0,0,0,0,0,0,2005
AZ,education - higher education instructional,5273,31636118,7719,9951936,561254,8462,41588054,2005
AZ,education - higher education other,11990,45661499,16856,11252879,1044561,17925,56914378,2005
AZ,education - other,3142,9059442,463,605981,36350,3348,9665423,2005
AZ,libraries,0,0,0,0,0,0,0,2005
AZ,liquor stores,0,0,0,0,0,0,0,2005
AZ,other and unallocable,3137,10260426,216,227303,12890,3208,10487729,2005
AR,total,49336,164519784,14526,9872124,852777,54185,174391908,2005
AR,financial administration,1852,5803088,16,23265,2169,1864,5826353,2005
AR,other government administration,657,2584479,60,119286,8452,705,2703765,2005
AR,judicial and legal,1388,4254722,114,360505,11347,1452,4615227,2005
AR,police protection - officers,528,2119885,0,0,0,528,2119885,2005
AR,police protection - other,559,1597447,0,0,0,559,1597447,2005
AR,corrections,4463,11713431,0,0,0,4463,11713431,2005
AR,highways,3557,11132229,45,36106,866,3562,11168335,2005
AR,air transportation,0,0,0,0,0,0,0,2005
AR,water transport and terminals,0,0,0,0,0,0,0,2005
AR,public welfare,3639,10325878,32,55606,2931,3656,10381484,2005
AR,health,4535,13588076,149,256401,17291,4634,13844477,2005
AR,hospitals,4212,12473237,167,289635,10736,4273,12762872,2005
AR,social insurance administration,855,3041137,218,227351,22665,984,3268488,2005
AR,solid waste management,0,0,0,0,0,0,0,2005
AR,sewerage,0,0,0,0,0,0,0,2005
AR,parks and recreation,623,1560502,242,151249,22503,751,1711751,2005
AR,housing and community development,0,0,0,0,0,0,0,2005
AR,natural resources,1704,5140036,379,200952,21143,1825,5340988,2005
AR,water transport and terminals,0,0,0,0,0,0,0,2005
AR,electric power,0,0,0,0,0,0,0,2005
AR,gas supply,0,0,0,0,0,0,0,2005
AR,transit,0,0,0,0,0,0,0,2005
AR,education - elementary and secondary instructional,0,0,0,0,0,0,0,2005
AR,education - elementary and secondary other,0,0,0,0,0,0,0,2005
AR,education - higher education instructional,5896,34300510,4628,4413012,279258,7484,38713522,2005
AR,education - higher education other,11227,32589095,8435,3671398,449752,13785,36260493,2005
AR,education - other,1340,4431356,13,21577,1017,1345,4452933,2005
AR,libraries,0,0,0,0,0,0,0,2005
AR,liquor stores,0,0,0,0,0,0,0,2005
AR,other and unallocable,2301,7864676,28,45781,2647,2315,7910457,2005
CA,total,325064,1729004464,144647,220473592,10909719,387060,1949478056,2005
CA,financial administration,19239,81513643,3288,5544238,366567,21322,87057881,2005
CA,other government administration,3720,18890398,354,954067,31349,3916,19844465,2005
CA,judicial and legal,4117,24716679,434,958101,30800,4291,25674780,2005
CA,police protection - officers,7627,51210430,500,6259,120,7628,51216689,2005
CA,police protection - other,4926,18786734,583,490028,25963,5073,19276762,2005
CA,corrections,47883,252517006,2144,6770966,273585,49437,259287972,2005
CA,highways,19444,116901313,1031,3595105,139057,20234,120496418,2005
CA,air transportation,0,0,0,0,0,0,0,2005
CA,water transport and terminals,0,0,0,0,0,0,0,2005
CA,public welfare,3408,15165326,428,772528,40914,3639,15937854,2005
CA,health,10561,56899069,1404,4505347,179215,11575,61404416,2005
CA,hospitals,33661,172131633,8548,20842824,805252,38237,192974457,2005
CA,social insurance administration,18657,75309899,1952,4197713,210301,19851,79507612,2005
CA,solid waste management,371,1939140,62,206231,7188,412,2145371,2005
CA,sewerage,0,0,0,0,0,0,0,2005
CA,parks and recreation,2345,10054462,1730,2650816,187215,3409,12705278,2005
CA,housing and community development,0,0,0,0,0,0,0,2005
CA,natural resources,11593,57668760,2789,4536769,353892,13604,62205529,2005
CA,water transport and terminals,0,0,0,0,0,0,0,2005
CA,electric power,0,0,0,0,0,0,0,2005
CA,gas supply,0,0,0,0,0,0,0,2005
CA,transit,0,0,0,0,0,0,0,2005
CA,education - elementary and secondary instructional,0,0,0,0,0,0,0,2005
CA,education - elementary and secondary other,0,0,0,0,0,0,0,2005
CA,education - higher education instructional,19718,143678312,26541,45847773,1700274,29378,189526085,2005
CA,education - higher education other,78999,398155353,88359,106381433,6142181,113897,504536786,2005
CA,education - other,4013,18155350,555,1034377,49237,4293,19189727,2005
CA,libraries,0,0,0,0,0,0,0,2005
CA,liquor stores,0,0,0,0,0,0,0,2005
CA,other and unallocable,34782,215310957,3945,11179017,366609,36864,226489974,2005
CO,total,49838,227355401,35657,52008404,2851194,66035,279363805,2005
CO,financial administration,2038,9123152,128,212590,10038,2095,9335742,2005
CO,other government administration,413,1514201,153,360262,21982,537,1874463,2005
CO,judicial and legal,3032,13756615,788,1818708,83372,3505,15575323,2005
CO,police protection - officers,761,4468369,0,0,0,761,4468369,2005
CO,police protection - other,399,1707394,19,40861,1748,409,1748255,2005
CO,corrections,6472,25275196,75,187569,8813,6522,25462765,2005
CO,highways,3023,12592797,159,358240,17648,3123,12951037,2005
CO,air transportation,0,0,0,0,0,0,0,2005
CO,water transport and terminals,0,0,0,0,0,0,0,2005
CO,public welfare,1660,7046392,514,973919,47291,1928,8020311,2005
CO,health,1086,5456615,155,381539,14791,1170,5838154,2005
CO,hospitals,3128,11418025,813,1516789,73822,3547,12934814,2005
CO,social insurance administration,923,3969312,106,196867,11197,987,4166179,2005
CO,solid waste management,0,0,0,0,0,0,0,2005
CO,sewerage,0,0,0,0,0,0,0,2005
CO,parks and recreation,239,1048348,73,68145,4028,262,1116493,2005
CO,housing and community development,0,0,0,0,0,0,0,2005
CO,natural resources,1310,6150658,251,422023,17105,1407,6572681,2005
CO,water transport and terminals,0,0,0,0,0,0,0,2005
CO,electric power,0,0,0,0,0,0,0,2005
CO,gas supply,0,0,0,0,0,0,0,2005
CO,transit,0,0,0,0,0,0,0,2005
CO,education - elementary and secondary instructional,0,0,0,0,0,0,0,2005
CO,education - elementary and secondary other,0,0,0,0,0,0,0,2005
CO,education - higher education instructional,10120,62485049,9399,14879348,747641,14370,77364397,2005
CO,education - higher education other,12860,51183260,22164,29164785,1722662,22647,80348045,2005
CO,education - other,984,4007806,759,1178430,57630,1311,5186236,2005
CO,libraries,0,0,0,0,0,0,0,2005
CO,liquor stores,0,0,0,0,0,0,0,2005
CO,other and unallocable,1390,6152212,101,248329,11426,1454,6400541,2005
CT,total,52276,257582560,20443,29396458,1283279,59827,286979018,2005
CT,financial administration,2170,9724109,101,250291,10322,2228,9974400,2005
CT,other government administration,1128,5050882,251,875056,34734,1325,5925938,2005
CT,judicial and legal,4524,19009225,236,376568,7854,4568,19385793,2005
CT,police protection - officers,1413,7767204,4,11446,649,1417,7778650,2005
CT,police protection - other,545,2502727,38,75588,3839,567,2578315,2005
CT,corrections,7645,35194013,147,442193,14470,7727,35636206,2005
CT,highways,2910,13199507,2,6943,341,2912,13206450,2005
CT,air transportation,151,758297,0,0,0,151,758297,2005
CT,water transport and terminals,0,0,0,0,0,0,0,2005
CT,public welfare,4162,19756707,385,886236,35986,4366,20642943,2005
CT,health,1836,8427162,91,268133,11152,1899,8695295,2005
CT,hospitals,8794,47860502,2289,7007757,276196,10363,54868259,2005
CT,social insurance administration,728,3448219,24,76290,2440,742,3524509,2005
CT,solid waste management,54,310440,7,33480,1021,60,343920,2005
CT,sewerage,0,0,0,0,0,0,0,2005
CT,parks and recreation,160,725329,5,6773,383,162,732102,2005
CT,housing and community development,0,0,0,0,0,0,0,2005
CT,natural resources,763,3528949,92,181750,7142,804,3710699,2005
CT,water transport and terminals,0,0,0,0,0,0,0,2005
CT,electric power,0,0,0,0,0,0,0,2005
CT,gas supply,0,0,0,0,0,0,0,2005
CT,transit,0,0,0,0,0,0,0,2005
CT,education - elementary and secondary instructional,0,0,0,0,0,0,0,2005
CT,education - elementary and secondary other,0,0,0,0,0,0,0,2005
CT,education - higher education instructional,3862,26261305,8164,12218117,439673,6485,38479422,2005
CT,education - higher education other,7132,33381705,7523,5122261,357335,9298,38503966,2005
CT,education - other,2189,10812743,856,1198706,61501,2538,12011449,2005
CT,libraries,0,0,0,0,0,0,0,2005
CT,liquor stores,0,0,0,0,0,0,0,2005
CT,other and unallocable,2110,9863535,228,358870,18241,2215,10222405,2005
DE,total,21594,83551593,7965,8587024,490107,24546,92138617,2005
DE,financial administration,690,2482818,71,43406,3696,713,2526224,2005
DE,other government administration,233,955388,135,262202,11525,300,1217590,2005
DE,judicial and legal,1483,5272436,38,47541,3099,1501,5319977,2005
DE,police protection - officers,637,3885132,0,0,0,637,3885132,2005
DE,police protection - other,272,914630,39,43030,3828,294,957660,2005
DE,corrections,2650,9349016,146,237739,15224,2739,9586755,2005
DE,highways,1585,5075805,32,50621,3325,1605,5126426,2005
DE,air transportation,0,0,0,0,0,0,0,2005
DE,water transport and terminals,251,940817,0,0,0,251,940817,2005
DE,public welfare,1459,4663923,144,269090,16241,1556,4933013,2005
DE,health,1788,6579780,192,289153,17800,1895,6868933,2005
DE,hospitals,1777,5590662,152,215499,11595,1847,5806161,2005
DE,social insurance administration,289,905560,18,39981,2464,304,945541,2005
DE,solid waste management,122,370263,15,15421,1459,131,385684,2005
DE,sewerage,0,0,0,0,0,0,0,2005
DE,parks and recreation,182,569113,135,117579,11480,251,686692,2005
DE,housing and community development,0,0,0,0,0,0,0,2005
DE,natural resources,438,1598368,166,143783,10308,500,1742151,2005
DE,water transport and terminals,0,0,0,0,0,0,0,2005
DE,electric power,0,0,0,0,0,0,0,2005
DE,gas supply,0,0,0,0,0,0,0,2005
DE,transit,615,2738869,32,41178,2956,632,2780047,2005
DE,education - elementary and secondary instructional,0,0,0,0,0,0,0,2005
DE,education - elementary and secondary other,0,0,0,0,0,0,0,2005
DE,education - higher education instructional,1600,10398744,2924,4137974,188116,2735,14536718,2005
DE,education - higher education other,3695,14028208,3401,2389064,171562,4737,16417272,2005
DE,education - other,367,1791317,12,26473,1456,375,1817790,2005
DE,libraries,0,0,0,0,0,0,0,2005
DE,liquor stores,0,0,0,0,0,0,0,2005
DE,other and unallocable,1461,5440744,313,217290,13973,1543,5658034,2005
FL,total,169940,578969825,42215,47060713,2803169,185955,626030538,2005
FL,financial administration,6991,24193895,234,232205,23245,7125,24426100,2005
FL,other government administration,2089,7822574,43,53780,3295,2108,7876354,2005
FL,judicial and legal,18139,66039744,475,889720,45867,18400,66929464,2005
FL,police protection - officers,2047,7344053,2,1271,182,2048,7345324,2005
FL,police protection - other,2319,7989644,27,30207,2166,2331,8019851,2005
FL,corrections,28013,80188141,29,41342,2673,28029,80229483,2005
FL,highways,7602,27839444,22,34660,2046,7614,27874104,2005
FL,air transportation,0,0,0,0,0,0,0,2005
FL,water transport and terminals,0,0,0,0,0,0,0,2005
FL,public welfare,11175,29324919,63,95151,5559,11207,29420070,2005
FL,health,21153,56112839,1303,2405152,129633,21890,58517991,2005
FL,hospitals,4389,11601451,30,70059,2688,4404,11671510,2005
FL,social insurance administration,2546,7296061,34,64937,3388,2565,7360998,2005
FL,solid waste management,0,0,0,0,0,0,0,2005
FL,sewerage,0,0,0,0,0,0,0,2005
FL,parks and recreation,1314,2838535,137,93301,11125,1377,2931836,2005
FL,housing and community development,0,0,0,0,0,0,0,2005
FL,natural resources,9724,28111060,2676,2441504,165303,10663,30552564,2005
FL,water transport and terminals,0,0,0,0,0,0,0,2005
FL,electric power,0,0,0,0,0,0,0,2005
FL,gas supply,0,0,0,0,0,0,0,2005
FL,transit,740,2677889,21,20219,1479,748,2698108,2005
FL,education - elementary and secondary instructional,0,0,0,0,0,0,0,2005
FL,education - elementary and secondary other,0,0,0,0,0,0,0,2005
FL,education - higher education instructional,14303,100173532,13688,19566814,760764,18643,119740346,2005
FL,education - higher education other,26446,87034846,23171,20753947,1622849,35734,107788793,2005
FL,education - other,3738,10606773,78,76317,5127,3767,10683090,2005
FL,libraries,0,0,0,0,0,0,0,2005
FL,liquor stores,0,0,0,0,0,0,0,2005
FL,other and unallocable,7212,21774425,182,190127,15780,7302,21964552,2005
GA,total,106750,362485142,38694,35900931,2478906,120843,398386073,2005
GA,financial administration,4421,15146208,40,66507,2452,4435,15212715,2005
GA,other government administration,672,2458699,591,1200815,63914,1036,3659514,2005
GA,judicial and legal,3078,14009941,38,60291,2092,3090,14070232,2005
GA,police protection - officers,1021,3626808,0,0,0,1021,3626808,2005
GA,police protection - other,993,3175890,24,35643,2380,1007,3211533,2005
GA,corrections,19190,47864268,592,1039030,58784,19524,48903298,2005
GA,highways,5841,16143254,31,17524,780,5845,16160778,2005
GA,air transportation,0,0,0,0,0,0,0,2005
GA,water transport and terminals,819,3933705,2,202,18,819,3933907,2005
GA,public welfare,8590,22943198,106,153504,9944,8647,23096702,2005
GA,health,4360,14271828,208,292334,22484,4488,14564162,2005
GA,hospitals,7843,19739178,201,509018,19746,7955,20248196,2005
GA,social insurance administration,1911,5856660,122,180440,12152,1980,6037100,2005
GA,solid waste management,0,0,0,0,0,0,0,2005
GA,sewerage,0,0,0,0,0,0,0,2005
GA,parks and recreation,1241,2916088,2455,2974390,297332,2931,5890478,2005
GA,housing and community development,0,0,0,0,0,0,0,2005
GA,natural resources,3381,10938450,866,798539,66554,3759,11736989,2005
GA,water transport and terminals,0,0,0,0,0,0,0,2005
GA,electric power,0,0,0,0,0,0,0,2005
GA,gas supply,0,0,0,0,0,0,0,2005
GA,transit,0,0,0,0,0,0,0,2005
GA,education - elementary and secondary instructional,0,0,0,0,0,0,0,2005
GA,education - elementary and secondary other,0,0,0,0,0,0,0,2005
GA,education - higher education instructional,11927,65600001,13350,14678656,761606,16255,80278657,2005
GA,education - higher education other,25480,92785821,19178,12760444,1096039,31707,105546265,2005
GA,education - other,2819,10286332,437,987383,48309,3093,11273715,2005
GA,libraries,0,0,0,0,0,0,0,2005
GA,liquor stores,0,0,0,0,0,0,0,2005
GA,other and unallocable,3163,10788813,453,146211,14320,3251,10935024,2005
HI,total,48218,177059779,18711,18702721,1067478,54286,195762500,2005
HI,financial administration,618,2167812,1,3754,120,619,2171566,2005
HI,other government administration,619,2050254,150,277784,10794,681,2328038,2005
HI,judicial and legal,2236,8853710,54,89276,2800,2252,8942986,2005
HI,police protection - officers,0,0,0,0,0,0,0,2005
HI,police protection - other,0,0,0,0,0,0,0,2005
HI,corrections,2267,8517862,23,61206,1834,2278,8579068,2005
HI,highways,859,3150786,3,3036,234,860,3153822,2005
HI,air transportation,957,2963818,10,12790,762,961,2976608,2005
HI,water transport and terminals,197,677994,0,0,0,197,677994,2005
HI,public welfare,921,3048078,34,22566,2772,937,3070644,2005
HI,health,2413,8574082,87,176912,6926,2452,8750994,2005
HI,hospitals,3716,13264276,517,1242290,49150,3998,14506566,2005
HI,social insurance administration,299,1018584,11,19334,958,304,1037918,2005
HI,solid waste management,0,0,0,0,0,0,0,2005
HI,sewerage,0,0,0,0,0,0,0,2005
HI,parks and recreation,136,429680,540,132036,11308,200,561716,2005
HI,housing and community development,0,0,0,0,0,0,0,2005
HI,natural resources,980,3879039,278,231574,16033,1071,4110613,2005
HI,water transport and terminals,0,0,0,0,0,0,0,2005
HI,electric power,0,0,0,0,0,0,0,2005
HI,gas supply,0,0,0,0,0,0,0,2005
HI,transit,0,0,0,0,0,0,0,2005
HI,education - elementary and secondary instructional,17447,66697024,6098,5836770,300032,19152,72533794,2005
HI,education - elementary and secondary other,4545,10775800,3902,2501654,193624,5645,13277454,2005
HI,education - higher education instructional,2110,12017525,1510,2775940,91168,2628,14793465,2005
HI,education - higher education other,3837,15153855,5218,5127053,360285,5884,20280908,2005
HI,education - other,139,461336,2,3878,160,140,465214,2005
HI,libraries,482,1496498,240,148210,16004,573,1644708,2005
HI,liquor stores,0,0,0,0,0,0,0,2005
HI,other and unallocable,3440,11861766,33,36658,2514,3454,11898424,2005
ID,total,18066,62403958,11385,11172186,851408,22903,73576144,2005
ID,financial administration,1367,4571923,197,178249,20164,1482,4750172,2005
ID,other government administration,163,618020,217,404042,19853,277,1022062,2005
ID,judicial and legal,430,2358021,21,48164,759,434,2406185,2005
ID,police protection - officers,286,1150270,0,0,0,286,1150270,2005
ID,police protection - other,182,546763,10,8435,903,187,555198,2005
ID,corrections,1765,4910922,49,75400,5347,1795,4986322,2005
ID,highways,1621,5178734,158,245077,25678,1767,5423811,2005
ID,air transportation,0,0,0,0,0,0,0,2005
ID,water transport and terminals,0,0,0,0,0,0,0,2005
ID,public welfare,1580,4932455,223,320539,29703,1750,5252994,2005
ID,health,957,3543083,192,295949,15219,1043,3839032,2005
ID,hospitals,749,2236727,226,122591,12343,819,2359318,2005
ID,social insurance administration,525,1936437,260,514748,38127,742,2451185,2005
ID,solid waste management,0,0,0,0,0,0,0,2005
ID,sewerage,0,0,0,0,0,0,0,2005
ID,parks and recreation,174,502786,60,52602,5331,204,555388,2005
ID,housing and community development,0,0,0,0,0,0,0,2005
ID,natural resources,1555,5409164,720,1101659,80275,2010,6510823,2005
ID,water transport and terminals,0,0,0,0,0,0,0,2005
ID,electric power,0,0,0,0,0,0,0,2005
ID,gas supply,0,0,0,0,0,0,0,2005
ID,transit,0,0,0,0,0,0,0,2005
ID,education - elementary and secondary instructional,0,0,0,0,0,0,0,2005
ID,education - elementary and secondary other,0,0,0,0,0,0,0,2005
ID,education - higher education instructional,1999,9036642,2069,2679741,141527,2802,11716383,2005
ID,education - higher education other,3382,10918149,6484,4687517,413704,5732,15605666,2005
ID,education - other,413,1481122,163,202223,21840,538,1683345,2005
ID,libraries,0,0,0,0,0,0,0,2005
ID,liquor stores,113,333493,116,94234,9545,167,427727,2005
ID,other and unallocable,805,2739247,220,141016,11090,868,2880263,2005
IL,total,111422,475142271,47976,44741225,3571380,132934,519883496,2005
IL,financial administration,4961,20333864,251,396270,27178,5124,20730134,2005
IL,other government administration,2273,10435759,35,71121,2983,2291,10506880,2005
IL,judicial and legal,3035,20467547,94,187040,5274,3067,20654587,2005
IL,police protection - officers,2204,12438506,0,0,0,2204,12438506,2005
IL,police protection - other,1694,6983026,11,29292,1472,1703,7012318,2005
IL,corrections,14041,58291208,8,30046,704,14045,58321254,2005
IL,highways,6851,29546490,999,2662738,119729,7571,32209228,2005
IL,air transportation,0,0,0,0,0,0,0,2005
IL,water transport and terminals,65,317530,0,0,0,65,317530,2005
IL,public welfare,10035,41902898,35,92286,3740,10058,41995184,2005
IL,health,2704,12336561,17,40975,1432,2712,12377536,2005
IL,hospitals,11303,43266115,620,1413348,64779,11693,44679463,2005
IL,social insurance administration,2118,10132707,338,996453,50380,2421,11129160,2005
IL,solid waste management,0,0,0,0,0,0,0,2005
IL,sewerage,0,0,0,0,0,0,0,2005
IL,parks and recreation,561,2061010,33,73460,3960,585,2134470,2005
IL,housing and community development,0,0,0,0,0,0,0,2005
IL,natural resources,2681,10932441,1107,1534296,162898,3662,12466737,2005
IL,water transport and terminals,0,0,0,0,0,0,0,2005
IL,electric power,0,0,0,0,0,0,0,2005
IL,gas supply,0,0,0,0,0,0,0,2005
IL,transit,0,0,0,0,0,0,0,2005
IL,education - elementary and secondary instructional,0,0,0,0,0,0,0,2005
IL,education - elementary and secondary other,0,0,0,0,0,0,0,2005
IL,education - higher education instructional,12341,67386655,14948,17264357,666755,16357,84651012,2005
IL,education - higher education other,25573,90432504,29237,19543241,2439977,40273,109975745,2005
IL,education - other,2223,8918748,21,33398,1630,2233,8952146,2005
IL,libraries,0,0,0,0,0,0,0,2005
IL,liquor stores,0,0,0,0,0,0,0,2005
IL,other and unallocable,6759,28958702,222,372904,18489,6870,29331606,2005
IN,total,75802,266227905,37271,38106480,2993192,92934,304334385,2005
IN,financial administration,2773,9090860,121,162172,10991,2840,9253032,2005
IN,other government administration,387,1490872,321,631016,29496,565,2121888,2005
IN,judicial and legal,1235,6554912,34,60343,3795,1258,6615255,2005
IN,police protection - officers,1182,5584879,0,0,0,1182,5584879,2005
IN,police protection - other,804,2116042,0,0,0,804,2116042,2005
IN,corrections,8951,25287814,21,46104,2241,8965,25333918,2005
IN,highways,4283,12910337,0,0,0,4283,12910337,2005
IN,air transportation,0,0,0,0,0,0,0,2005
IN,water transport and terminals,30,132408,1,894,84,31,133302,2005
IN,public welfare,5578,15116963,158,67794,6636,5619,15184757,2005
IN,health,1840,6529497,9,16162,881,1845,6545659,2005
IN,hospitals,3752,10002632,85,105111,8501,3803,10107743,2005
IN,social insurance administration,1347,3903855,208,215416,16109,1444,4119271,2005
IN,solid waste management,0,0,0,0,0,0,0,2005
IN,sewerage,0,0,0,0,0,0,0,2005
IN,parks and recreation,130,398631,37,31339,3312,150,429970,2005
IN,housing and community development,0,0,0,0,0,0,0,2005
IN,natural resources,2336,8256583,762,650998,64888,2718,8907581,2005
IN,water transport and terminals,0,0,0,0,0,0,0,2005
IN,electric power,0,0,0,0,0,0,0,2005
IN,gas supply,0,0,0,0,0,0,0,2005
IN,transit,0,0,0,0,0,0,0,2005
IN,education - elementary and secondary instructional,0,0,0,0,0,0,0,2005
IN,education - elementary and secondary other,0,0,0,0,0,0,0,2005
IN,education - higher education instructional,13321,76611232,12805,23268726,1499250,21850,99879958,2005
IN,education - higher education other,25051,73107736,22485,12729099,1335131,32705,85836835,2005
IN,education - other,1154,3846813,129,75112,9046,1208,3921925,2005
IN,libraries,0,0,0,0,0,0,0,2005
IN,liquor stores,0,0,0,0,0,0,0,2005
IN,other and unallocable,1648,5285839,95,46194,2831,1664,5332033,2005
IA,total,41127,182654306,24416,32683656,2080334,52946,215337962,2005
IA,financial administration,1241,5306557,68,124982,9111,1293,5431539,2005
IA,other government administration,394,1985410,420,740133,47041,661,2725543,2005
IA,judicial and legal,2159,9694043,159,345379,18323,2263,10039422,2005
IA,police protection - officers,550,2645515,0,0,0,550,2645515,2005
IA,police protection - other,333,1303056,26,20563,1521,341,1323619,2005
IA,corrections,3029,12081970,168,426727,19318,3138,12508697,2005
IA,highways,2488,10124239,0,0,0,2488,10124239,2005
IA,air transportation,0,0,0,0,0,0,0,2005
IA,water transport and terminals,0,0,0,0,0,0,0,2005
IA,public welfare,2774,10389408,72,164815,8689,2823,10554223,2005
IA,health,389,1854825,51,87891,4127,412,1942716,2005
IA,hospitals,5533,22178083,2662,5169378,239664,6895,27347461,2005
IA,social insurance administration,829,3254666,64,100936,7505,872,3355602,2005
IA,solid waste management,0,0,0,0,0,0,0,2005
IA,sewerage,0,0,0,0,0,0,0,2005
IA,parks and recreation,109,445866,14,17508,1966,120,463374,2005
IA,housing and community development,0,0,0,0,0,0,0,2005
IA,natural resources,1544,6298780,376,308159,31164,1720,6606939,2005
IA,water transport and terminals,0,0,0,0,0,0,0,2005
IA,electric power,0,0,0,0,0,0,0,2005
IA,gas supply,0,0,0,0,0,0,0,2005
IA,transit,0,0,0,0,0,0,0,2005
IA,education - elementary and secondary instructional,0,0,0,0,0,0,0,2005
IA,education - elementary and secondary other,0,0,0,0,0,0,0,2005
IA,education - higher education instructional,3787,30027312,7027,15813284,797793,8320,45840596,2005
IA,education - higher education other,12187,48854928,12874,8585643,852562,17031,57440571,2005
IA,education - other,1108,4755147,119,173598,9806,1164,4928745,2005
IA,libraries,0,0,0,0,0,0,0,2005
IA,liquor stores,0,0,0,0,0,0,0,2005
IA,other and unallocable,2673,11454501,316,604660,31744,2855,12059161,2005
KS,total,38338,138844231,17422,14442746,1050605,44307,153286977,2005
KS,financial administration,1983,6074335,68,97526,7839,2029,6171861,2005
KS,other government administration,512,1427388,199,528451,25862,659,1955839,2005
KS,judicial and legal,2046,7233814,194,181464,12381,2116,7415278,2005
KS,police protection - officers,611,2605409,0,0,0,611,2605409,2005
KS,police protection - other,496,1498568,13,16835,1096,502,1515403,2005
KS,corrections,3575,9697916,26,29084,1827,3586,9727000,2005
KS,highways,3495,10405937,136,143985,11543,3560,10549922,2005
KS,air transportation,0,0,0,0,0,0,0,2005
KS,water transport and terminals,0,0,0,0,0,0,0,2005
KS,public welfare,2667,7531049,136,182739,15159,2753,7713788,2005
KS,health,972,3366252,32,47005,1975,983,3413257,2005
KS,hospitals,2348,6061578,365,179848,7453,2390,6241426,2005
KS,social insurance administration,120,369506,2,1552,170,121,371058,2005
KS,solid waste management,0,0,0,0,0,0,0,2005
KS,sewerage,0,0,0,0,0,0,0,2005
KS,parks and recreation,566,1416486,7,5520,551,569,1422006,2005
KS,housing and community development,0,0,0,0,0,0,0,2005
KS,natural resources,815,2781151,123,91585,8699,864,2872736,2005
KS,water transport and terminals,0,0,0,0,0,0,0,2005
KS,electric power,0,0,0,0,0,0,0,2005
KS,gas supply,0,0,0,0,0,0,0,2005
KS,transit,0,0,0,0,0,0,0,2005
KS,education - elementary and secondary instructional,0,0,0,0,0,0,0,2005
KS,education - elementary and secondary other,0,0,0,0,0,0,0,2005
KS,education - higher education instructional,4157,27595773,3572,5134600,227978,5454,32730373,2005
KS,education - higher education other,9849,37478671,12154,7498485,710801,13887,44977156,2005
KS,education - other,583,1954118,69,78597,3698,604,2032715,2005
KS,libraries,0,0,0,0,0,0,0,2005
KS,liquor stores,0,0,0,0,0,0,0,2005
KS,other and unallocable,3543,11346280,326,225470,13573,3619,11571750,2005
KY,total,70608,241515121,23914,21086942,1461167,79231,262602063,2005
KY,financial administration,2608,8991977,21,32494,1050,2614,9024471,2005
KY,other government administration,1008,4478219,440,828938,27906,1177,5307157,2005
KY,judicial and legal,4377,14444175,826,1464740,103170,4998,15908915,2005
KY,police protection - officers,996,3380460,0,0,0,996,3380460,2005
KY,police protection - other,1321,4660779,0,0,0,1321,4660779,2005
KY,corrections,3855,9724224,154,83760,2008,3867,9807984,2005
KY,highways,5046,15375845,56,108938,4776,5074,15484783,2005
KY,air transportation,0,0,0,0,0,0,0,2005
KY,water transport and terminals,0,0,0,0,0,0,0,2005
KY,public welfare,6803,19505717,0,0,0,6803,19505717,2005
KY,health,2157,7126594,84,89563,5525,2189,7216157,2005
KY,hospitals,5497,16868725,368,1243917,61404,5848,18112642,2005
KY,social insurance administration,1054,3214484,1,2774,80,1054,3217258,2005
KY,solid waste management,0,0,0,0,0,0,0,2005
KY,sewerage,0,0,0,0,0,0,0,2005
KY,parks and recreation,1437,3171606,142,123270,16682,1537,3294876,2005
KY,housing and community development,0,0,0,0,0,0,0,2005
KY,natural resources,3365,10534300,969,1115429,94424,3913,11649729,2005
KY,water transport and terminals,0,0,0,0,0,0,0,2005
KY,electric power,0,0,0,0,0,0,0,2005
KY,gas supply,0,0,0,0,0,0,0,2005
KY,transit,0,0,0,0,0,0,0,2005
KY,education - elementary and secondary instructional,0,0,0,0,0,0,0,2005
KY,education - elementary and secondary other,0,0,0,0,0,0,0,2005
KY,education - higher education instructional,8406,48222323,6964,9169450,499115,11341,57391773,2005
KY,education - higher education other,16253,50264308,13661,6631813,634113,20008,56896121,2005
KY,education - other,2719,9944945,148,108352,6084,2756,10053297,2005
KY,libraries,0,0,0,0,0,0,0,2005
KY,liquor stores,0,0,0,0,0,0,0,2005
KY,other and unallocable,3706,11606440,80,83504,4830,3735,11689944,2005
LA,total,82629,285459990,25807,18143113,1450535,90887,303603103,2005
LA,financial administration,2381,7881516,371,334017,39180,2603,8215533,2005
LA,other government administration,1699,6293831,449,470330,34782,1896,6764161,2005
LA,judicial and legal,1767,7500335,52,99748,2536,1782,7600083,2005
LA,police protection - officers,1191,5935395,0,0,0,1191,5935395,2005
LA,police protection - other,569,1717083,42,21980,3184,587,1739063,2005
LA,corrections,7599,22542959,400,270261,48044,7872,22813220,2005
LA,highways,5229,16025421,7,10710,1100,5235,16036131,2005
LA,air transportation,0,0,0,0,0,0,0,2005
LA,water transport and terminals,362,1370881,5,10465,517,364,1381346,2005
LA,public welfare,5144,15708743,18,14092,580,5147,15722835,2005
LA,health,4056,14670232,169,150155,15843,4146,14820387,2005
LA,hospitals,15645,48095023,1206,2080755,94507,16182,50175778,2005
LA,social insurance administration,948,3012756,83,85998,8356,995,3098754,2005
LA,solid waste management,0,0,0,0,0,0,0,2005
LA,sewerage,0,0,0,0,0,0,0,2005
LA,parks and recreation,1208,3163221,353,296957,35327,1408,3460178,2005
LA,housing and community development,0,0,0,0,0,0,0,2005
LA,natural resources,4523,15508220,941,729812,76728,4958,16238032,2005
LA,water transport and terminals,0,0,0,0,0,0,0,2005
LA,electric power,0,0,0,0,0,0,0,2005
LA,gas supply,0,0,0,0,0,0,0,2005
LA,transit,0,0,0,0,0,0,0,2005
LA,education - elementary and secondary instructional,0,0,0,0,0,0,0,2005
LA,education - elementary and secondary other,0,0,0,0,0,0,0,2005
LA,education - higher education instructional,8429,48950243,5257,6107262,349338,10415,55057505,2005
LA,education - higher education other,16503,49041457,15353,6518813,663314,20288,55560270,2005
LA,education - other,3120,10798329,798,696531,54396,3429,11494860,2005
LA,libraries,0,0,0,0,0,0,0,2005
LA,liquor stores,0,0,0,0,0,0,0,2005
LA,other and unallocable,2256,7244345,303,245227,22803,2389,7489572,2005
ME,total,18909,68216022,8198,6887183,393407,21140,75103205,2005
ME,financial administration,1157,3707898,64,119106,7121,1198,3827004,2005
ME,other government administration,342,1428698,227,612650,33046,529,2041348,2005
ME,judicial and legal,712,2904734,4,7286,471,715,2912020,2005
ME,police protection - officers,336,1735266,19,62038,2497,350,1797304,2005
ME,police protection - other,190,581488,7,16596,1123,196,598084,2005
ME,corrections,1266,4338306,60,96116,6030,1301,4434422,2005
ME,highways,2453,8941132,148,314446,19930,2566,9255578,2005
ME,air transportation,0,0,0,0,0,0,0,2005
ME,water transport and terminals,71,210835,15,19058,1439,79,229893,2005
ME,public welfare,1975,6157840,86,163327,9086,2027,6321167,2005
ME,health,1249,4606422,63,152367,7435,1291,4758789,2005
ME,hospitals,592,2164224,58,101967,5947,626,2266191,2005
ME,social insurance administration,463,1579011,34,60612,3582,483,1639623,2005
ME,solid waste management,0,0,0,0,0,0,0,2005
ME,sewerage,0,0,0,0,0,0,0,2005
ME,parks and recreation,140,460773,30,46636,2923,157,507409,2005
ME,housing and community development,0,0,0,0,0,0,0,2005
ME,natural resources,971,3692355,180,249192,11243,1033,3941547,2005
ME,water transport and terminals,0,0,0,0,0,0,0,2005
ME,electric power,0,0,0,0,0,0,0,2005
ME,gas supply,0,0,0,0,0,0,0,2005
ME,transit,0,0,0,0,0,0,0,2005
ME,education - elementary and secondary instructional,22,84782,18,15775,1246,29,100557,2005
ME,education - elementary and secondary other,5,11562,33,38477,3031,22,50039,2005
ME,education - higher education instructional,1352,6557994,695,868936,34612,1548,7426930,2005
ME,education - higher education other,4136,13681750,6365,3722260,231610,5450,17404010,2005
ME,education - other,249,885837,19,41264,2291,262,927101,2005
ME,libraries,0,0,0,0,0,0,0,2005
ME,liquor stores,56,158550,0,0,0,56,158550,2005
ME,other and unallocable,1172,4326565,73,179074,8744,1222,4505639,2005
MD,total,82344,339632309,14475,26601873,1442553,90542,366234182,2005
MD,financial administration,3528,13940138,153,341512,18906,3636,14281650,2005
MD,other government administration,1376,6528107,277,481251,14414,1457,7009358,2005
MD,judicial and legal,4321,20520064,446,875741,62375,4675,21395805,2005
MD,police protection - officers,1622,8585704,0,0,0,1622,8585704,2005
MD,police protection - other,870,2910015,27,67071,3912,892,2977086,2005
MD,corrections,11750,41574977,270,591996,41224,11985,42166973,2005
MD,highways,4702,18206577,0,0,0,4702,18206577,2005
MD,air transportation,524,2258313,0,0,0,524,2258313,2005
MD,water transport and terminals,291,1400873,0,0,0,291,1400873,2005
MD,public welfare,6675,22965443,96,215070,13899,6754,23180513,2005
MD,health,6213,23802983,836,1569383,97905,6770,25372366,2005
MD,hospitals,4711,16725721,644,914463,55005,5024,17640184,2005
MD,social insurance administration,844,3053154,154,337677,19401,954,3390831,2005
MD,solid waste management,0,0,0,0,0,0,0,2005
MD,sewerage,0,0,0,0,0,0,0,2005
MD,parks and recreation,365,1565006,186,252164,25093,508,1817170,2005
MD,housing and community development,0,0,0,0,0,0,0,2005
MD,natural resources,1968,8523618,110,220514,14718,2052,8744132,2005
MD,water transport and terminals,0,0,0,0,0,0,0,2005
MD,electric power,0,0,0,0,0,0,0,2005
MD,gas supply,0,0,0,0,0,0,0,2005
MD,transit,2099,9300397,248,388355,28930,2263,9688752,2005
MD,education - elementary and secondary instructional,0,0,0,0,0,0,0,2005
MD,education - elementary and secondary other,0,0,0,0,0,0,0,2005
MD,education - higher education instructional,9088,58103547,3574,9884489,334597,10990,67988036,2005
MD,education - higher education other,12025,41802318,6428,8493834,593599,15398,50296152,2005
MD,education - other,1917,8079616,363,728167,36951,2127,8807783,2005
MD,libraries,0,0,0,0,0,0,0,2005
MD,liquor stores,0,0,0,0,0,0,0,2005
MD,other and unallocable,7455,29785738,663,1240186,81624,7918,31025924,2005
MA,total,80366,355181582,27864,36913600,1378943,88533,392095182,2005
MA,financial administration,4102,17976048,354,998023,12277,4177,18974071,2005
MA,other government administration,1784,5725781,319,1257327,29118,1958,6983108,2005
MA,judicial and legal,8835,39924503,504,1270099,22848,8973,41194602,2005
MA,police protection - officers,4951,27035798,76,129733,5087,4981,27165531,2005
MA,police protection - other,714,2765716,21,43136,1267,721,2808852,2005
MA,corrections,6554,28735709,156,411868,7506,6600,29147577,2005
MA,highways,3739,17136067,195,585118,22636,3868,17721185,2005
MA,air transportation,1111,6719368,158,259234,11954,1179,6978602,2005
MA,water transport and terminals,159,846489,7,10930,735,163,857419,2005
MA,public welfare,7110,30752329,697,1874839,80560,7595,32627168,2005
MA,health,6755,26826483,1321,2658115,96768,7338,29484598,2005
MA,hospitals,6491,21955674,911,2154768,74655,6916,24110442,2005
MA,social insurance administration,1401,5723922,51,171675,6294,1439,5895597,2005
MA,solid waste management,3,16770,0,0,0,3,16770,2005
MA,sewerage,844,4540302,32,112422,4169,868,4652724,2005
MA,parks and recreation,805,3039853,65,81909,3839,827,3121762,2005
MA,housing and community development,0,0,0,0,0,0,0,2005
MA,natural resources,1146,5589121,169,437775,12976,1224,6026896,2005
MA,water transport and terminals,502,2615374,22,66801,2678,517,2682175,2005
MA,electric power,0,0,0,0,0,0,0,2005
MA,gas supply,0,0,0,0,0,0,0,2005
MA,transit,0,0,0,0,0,0,0,2005
MA,education - elementary and secondary instructional,57,249852,0,0,0,57,249852,2005
MA,education - elementary and secondary other,38,138062,11,450,53,38,138512,2005
MA,education - higher education instructional,6207,34458087,9850,15628594,507567,9217,50086681,2005
MA,education - higher education other,12850,51992812,12570,7699634,454471,15536,59692446,2005
MA,education - other,1022,4901886,75,246520,7235,1065,5148406,2005
MA,libraries,0,0,0,0,0,0,0,2005
MA,liquor stores,0,0,0,0,0,0,0,2005
MA,other and unallocable,3186,15515576,300,814630,14250,3273,16330206,2005
MI,total,107346,475197279,60946,63435907,4206821,131254,538633186,2005
MI,financial administration,3998,17555238,743,1950870,98703,4558,19506108,2005
MI,other government administration,1497,6260674,1,801,106,1498,6261475,2005
MI,judicial and legal,1473,9491006,62,167848,6602,1511,9658854,2005
MI,police protection - officers,1994,7902630,0,0,0,1994,7902630,2005
MI,police protection - other,735,2292233,55,80996,2422,749,2373229,2005
MI,corrections,17199,71944232,220,826797,31665,17379,72771029,2005
MI,highways,2692,11664184,246,637437,32010,2874,12301621,2005
MI,air transportation,0,0,0,0,0,0,0,2005
MI,water transport and terminals,0,0,0,0,0,0,0,2005
MI,public welfare,9850,38289925,455,1555423,70456,10251,39845348,2005
MI,health,1779,7907164,209,359407,17485,1878,8266571,2005
MI,hospitals,10481,38771003,3165,6782102,424326,12892,45553105,2005
MI,social insurance administration,958,3310730,33,51197,2981,975,3361927,2005
MI,solid waste management,0,0,0,0,0,0,0,2005
MI,sewerage,0,0,0,0,0,0,0,2005
MI,parks and recreation,204,775211,94,230998,11192,268,1006209,2005
MI,housing and community development,0,0,0,0,0,0,0,2005
MI,natural resources,4063,16568392,967,1269835,86492,4554,17838227,2005
MI,water transport and terminals,0,0,0,0,0,0,0,2005
MI,electric power,0,0,0,0,0,0,0,2005
MI,gas supply,0,0,0,0,0,0,0,2005
MI,transit,0,0,0,0,0,0,0,2005
MI,education - elementary and secondary instructional,468,1542512,141,161743,10878,534,1704255,2005
MI,education - elementary and secondary other,93,252748,56,41653,3584,114,294401,2005
MI,education - higher education instructional,14399,104849469,14309,25621830,1244018,21469,130471299,2005
MI,education - higher education other,29275,111657104,39529,22141941,2089310,41145,133799045,2005
MI,education - other,1143,4958212,283,926920,41924,1381,5885132,2005
MI,libraries,0,0,0,0,0,0,0,2005
MI,liquor stores,0,0,0,0,0,0,0,2005
MI,other and unallocable,5045,19204612,378,628109,32667,5230,19832721,2005
MN,total,60984,281335110,30509,35584418,2339598,74278,316919528,2005
MN,financial administration,2433,10136933,122,238944,17921,2536,10375877,2005
MN,other government administration,1163,4827008,183,424763,23515,1298,5251771,2005
MN,judicial and legal,2427,12358448,459,1462785,53567,2731,13821233,2005
MN,police protection - officers,507,2889385,0,0,0,507,2889385,2005
MN,police protection - other,391,1497244,21,38510,2272,404,1535754,2005
MN,corrections,3712,14213428,155,400391,22298,3839,14613819,2005
MN,highways,4617,19745920,202,337575,23194,4749,20083495,2005
MN,air transportation,0,0,0,0,0,0,0,2005
MN,water transport and terminals,0,0,0,0,0,0,0,2005
MN,public welfare,1633,6665072,1162,2430536,192235,2725,9095608,2005
MN,health,2122,9751865,232,543440,27996,2281,10295305,2005
MN,hospitals,3401,14395302,1389,3276003,241716,4774,17671305,2005
MN,social insurance administration,1163,4749473,91,215637,10842,1225,4965110,2005
MN,solid waste management,0,0,0,0,0,0,0,2005
MN,sewerage,631,3476272,17,39814,881,636,3516086,2005
MN,parks and recreation,495,2071275,157,208951,13182,570,2280226,2005
MN,housing and community development,0,0,0,0,0,0,0,2005
MN,natural resources,2757,11993363,765,1151002,87452,3254,13144365,2005
MN,water transport and terminals,0,0,0,0,0,0,0,2005
MN,electric power,0,0,0,0,0,0,0,2005
MN,gas supply,0,0,0,0,0,0,0,2005
MN,transit,2205,9510600,451,933726,46726,2470,10444326,2005
MN,education - elementary and secondary instructional,0,0,0,0,0,0,0,2005
MN,education - elementary and secondary other,0,0,0,0,0,0,0,2005
MN,education - higher education instructional,10045,53729320,9487,10698062,515357,12970,64427382,2005
MN,education - higher education other,14862,71008637,14981,12039315,1000310,20548,83047952,2005
MN,education - other,3335,14456786,466,761171,40703,3565,15217957,2005
MN,libraries,0,0,0,0,0,0,0,2005
MN,liquor stores,0,0,0,0,0,0,0,2005
MN,other and unallocable,3085,13858779,169,383793,19431,3196,14242572,2005
MS,total,50481,156298374,14077,12005431,1071394,56568,168303805,2005
MS,financial administration,1134,3541046,32,41250,3645,1155,3582296,2005
MS,other government administration,460,1670526,91,99192,4886,488,1769718,2005
MS,judicial and legal,647,3413535,40,30956,2115,660,3444491,2005
MS,police protection - officers,658,2162747,0,0,0,658,2162747,2005
MS,police protection - other,525,1361284,0,0,0,525,1361284,2005
MS,corrections,3686,9107157,31,36000,2690,3701,9143157,2005
MS,highways,3354,8498984,11,22040,1714,3364,8521024,2005
MS,air transportation,0,0,0,0,0,0,0,2005
MS,water transport and terminals,58,203656,1,508,78,58,204164,2005
MS,public welfare,2536,5625438,0,0,0,2536,5625438,2005
MS,health,3034,8652563,76,186346,8969,3085,8838909,2005
MS,hospitals,12025,29909753,600,1538787,76108,12457,31448540,2005
MS,social insurance administration,784,2283405,323,640774,48023,1057,2924179,2005
MS,solid waste management,0,0,0,0,0,0,0,2005
MS,sewerage,0,0,0,0,0,0,0,2005
MS,parks and recreation,339,682372,160,101239,10493,399,783611,2005
MS,housing and community development,0,0,0,0,0,0,0,2005
MS,natural resources,2968,8027435,743,636519,53533,3272,8663954,2005
MS,water transport and terminals,11,25605,10,10313,1483,19,35918,2005
MS,electric power,0,0,0,0,0,0,0,2005
MS,gas supply,0,0,0,0,0,0,0,2005
MS,transit,0,0,0,0,0,0,0,2005
MS,education - elementary and secondary instructional,0,0,0,0,0,0,0,2005
MS,education - elementary and secondary other,0,0,0,0,0,0,0,2005
MS,education - higher education instructional,5235,30448977,1547,2104191,134403,5998,32553168,2005
MS,education - higher education other,8827,28660773,10290,6430704,710130,12862,35091477,2005
MS,education - other,1494,4295165,74,81980,9099,1546,4377145,2005
MS,libraries,0,0,0,0,0,0,0,2005
MS,liquor stores,115,274723,0,0,0,115,274723,2005
MS,other and unallocable,2591,7453230,48,44632,4025,2613,7497862,2005
MO,total,81512,251641610,26864,21458676,1808338,91801,273100286,2005
MO,financial administration,2586,7303639,327,219734,24098,2723,7523373,2005
MO,other government administration,745,2223038,277,612590,34710,945,2835628,2005
MO,judicial and legal,4058,14286894,309,337632,14138,4139,14624526,2005
MO,police protection - officers,1166,4627826,0,0,0,1166,4627826,2005
MO,police protection - other,1046,2900618,91,74100,9058,1097,2974718,2005
MO,corrections,12826,31513754,309,259604,20578,12942,31773358,2005
MO,highways,6341,19736012,580,1038628,83544,6816,20774640,2005
MO,air transportation,0,0,0,0,0,0,0,2005
MO,water transport and terminals,0,0,0,0,0,0,0,2005
MO,public welfare,8181,19289512,517,579008,36216,8386,19868520,2005
MO,health,3106,8834963,300,341955,18835,3214,9176918,2005
MO,hospitals,11308,30176284,1625,2010145,144738,12130,32186429,2005
MO,social insurance administration,621,1707344,64,21376,1408,629,1728720,2005
MO,solid waste management,0,0,0,0,0,0,0,2005
MO,sewerage,0,0,0,0,0,0,0,2005
MO,parks and recreation,566,1462698,160,113928,14212,647,1576626,2005
MO,housing and community development,0,0,0,0,0,0,0,2005
MO,natural resources,2384,7252744,592,573197,61341,2732,7825941,2005
MO,water transport and terminals,0,0,0,0,0,0,0,2005
MO,electric power,0,0,0,0,0,0,0,2005
MO,gas supply,0,0,0,0,0,0,0,2005
MO,transit,0,0,0,0,0,0,0,2005
MO,education - elementary and secondary instructional,0,0,0,0,0,0,0,2005
MO,education - elementary and secondary other,0,0,0,0,0,0,0,2005
MO,education - higher education instructional,7834,40661814,7310,7257781,472109,10518,47919595,2005
MO,education - higher education other,13337,42487758,13011,5927414,737085,17536,48415172,2005
MO,education - other,1204,3595026,1152,1856744,118790,1879,5451770,2005
MO,libraries,0,0,0,0,0,0,0,2005
MO,liquor stores,0,0,0,0,0,0,0,2005
MO,other and unallocable,4203,13581686,240,234840,17478,4302,13816526,2005
MT,total,16356,54116935,9313,7404044,561372,19543,61520979,2005
MT,financial administration,926,2633564,77,88350,7395,968,2721914,2005
MT,other government administration,392,1349016,250,379537,37024,602,1728553,2005
MT,judicial and legal,408,1546539,117,230460,10282,467,1776999,2005
MT,police protection - officers,190,615211,3,5732,399,192,620943,2005
MT,police protection - other,220,705562,15,22845,1576,230,728407,2005
MT,corrections,1082,3205865,45,54214,3881,1104,3260079,2005
MT,highways,2073,7168755,125,165824,10687,2134,7334579,2005
MT,air transportation,0,0,0,0,0,0,0,2005
MT,water transport and terminals,0,0,0,0,0,0,0,2005
MT,public welfare,1430,4308382,203,329580,26266,1579,4637962,2005
MT,health,734,2284370,97,131593,10268,792,2415963,2005
MT,hospitals,518,1439321,88,103024,8495,566,1542345,2005
MT,social insurance administration,737,2355559,30,43933,3206,755,2399492,2005
MT,solid waste management,0,0,0,0,0,0,0,2005
MT,sewerage,0,0,0,0,0,0,0,2005
MT,parks and recreation,66,199539,38,18343,1705,76,217882,2005
MT,housing and community development,0,0,0,0,0,0,0,2005
MT,natural resources,1285,4287003,238,256110,20382,1399,4543113,2005
MT,water transport and terminals,0,0,0,0,0,0,0,2005
MT,electric power,0,0,0,0,0,0,0,2005
MT,gas supply,0,0,0,0,0,0,0,2005
MT,transit,0,0,0,0,0,0,0,2005
MT,education - elementary and secondary instructional,0,0,0,0,0,0,0,2005
MT,education - elementary and secondary other,0,0,0,0,0,0,0,2005
MT,education - higher education instructional,1345,6948941,1910,2318637,110807,1974,9267578,2005
MT,education - higher education other,3503,10227434,5900,3025361,292160,5163,13252795,2005
MT,education - other,383,1196171,84,106750,8546,431,1302921,2005
MT,libraries,0,0,0,0,0,0,0,2005
MT,liquor stores,14,41253,2,2298,226,15,43551,2005
MT,other and unallocable,1050,3604450,91,121453,8067,1096,3725903,2005
NE,total,27315,89138003,11063,8881860,907875,32472,98019863,2005
NE,financial administration,559,1790871,15,20603,1591,567,1811474,2005
NE,other government administration,269,963225,102,100172,7173,310,1063397,2005
NE,judicial and legal,678,2792029,62,54073,4296,702,2846102,2005
NE,police protection - officers,487,1842455,0,0,0,487,1842455,2005
NE,police protection - other,235,683895,3,3675,319,237,687570,2005
NE,corrections,2451,6970007,55,75529,5128,2480,7045536,2005
NE,highways,2144,6685636,10,17276,1116,2150,6702912,2005
NE,air transportation,26,89822,0,0,0,26,89822,2005
NE,water transport and terminals,0,0,0,0,0,0,0,2005
NE,public welfare,2426,6341961,217,213729,13283,2502,6555690,2005
NE,health,592,2108513,72,128068,9180,645,2236581,2005
NE,hospitals,3668,10739607,833,1325250,105323,4267,12064857,2005
NE,social insurance administration,310,878952,9,14772,1019,316,893724,2005
NE,solid waste management,0,0,0,0,0,0,0,2005
NE,sewerage,0,0,0,0,0,0,0,2005
NE,parks and recreation,236,635599,151,129562,16328,329,765161,2005
NE,housing and community development,0,0,0,0,0,0,0,2005
NE,natural resources,1584,4706839,767,1188036,103538,2172,5894875,2005
NE,water transport and terminals,0,0,0,0,0,0,0,2005
NE,electric power,0,0,0,0,0,0,0,2005
NE,gas supply,0,0,0,0,0,0,0,2005
NE,transit,0,0,0,0,0,0,0,2005
NE,education - elementary and secondary instructional,0,0,0,0,0,0,0,2005
NE,education - elementary and secondary other,0,0,0,0,0,0,0,2005
NE,education - higher education instructional,2771,15126208,1020,1378894,79013,3220,16505102,2005
NE,education - higher education other,5925,17790450,7325,4013967,544870,9021,21804417,2005
NE,education - other,533,1974028,32,39735,2860,549,2013763,2005
NE,libraries,0,0,0,0,0,0,0,2005
NE,liquor stores,0,0,0,0,0,0,0,2005
NE,other and unallocable,2421,7017906,390,178519,12838,2492,7196425,2005
NV,total,22566,89417953,10877,9110070,563881,25766,98528023,2005
NV,financial administration,1371,4701920,35,45636,1638,1381,4747556,2005
NV,other government administration,1279,5396551,25,47311,2148,1292,5443862,2005
NV,judicial and legal,623,3580961,27,57938,1194,629,3638899,2005
NV,police protection - officers,391,2375110,1,1160,46,391,2376270,2005
NV,police protection - other,416,1635735,0,0,0,416,1635735,2005
NV,corrections,3421,13412751,56,157450,2865,3437,13570201,2005
NV,highways,1714,6931480,7,12797,819,1719,6944277,2005
NV,air transportation,0,0,0,0,0,0,0,2005
NV,water transport and terminals,0,0,0,0,0,0,0,2005
NV,public welfare,1422,4872720,10,19658,654,1426,4892378,2005
NV,health,1117,4578454,59,126800,4161,1140,4705254,2005
NV,hospitals,1042,4299798,119,293275,10275,1100,4593073,2005
NV,social insurance administration,442,1547416,3,3312,97,443,1550728,2005
NV,solid waste management,0,0,0,0,0,0,0,2005
NV,sewerage,0,0,0,0,0,0,0,2005
NV,parks and recreation,171,655404,8,14942,538,174,670346,2005
NV,housing and community development,0,0,0,0,0,0,0,2005
NV,natural resources,1077,4153201,407,391393,18824,1183,4544594,2005
NV,water transport and terminals,18,98709,1,516,24,18,99225,2005
NV,electric power,18,98709,1,516,24,18,99225,2005
NV,gas supply,0,0,0,0,0,0,0,2005
NV,transit,0,0,0,0,0,0,0,2005
NV,education - elementary and secondary instructional,0,0,0,0,0,0,0,2005
NV,education - elementary and secondary other,0,0,0,0,0,0,0,2005
NV,education - higher education instructional,1890,10964033,2069,3207629,150174,2743,14171662,2005
NV,education - higher education other,3974,10896015,7990,4639023,366981,6059,15535038,2005
NV,education - other,126,567587,8,18501,544,129,586088,2005
NV,libraries,0,0,0,0,0,0,0,2005
NV,liquor stores,0,0,0,0,0,0,0,2005
NV,other and unallocable,2054,8651399,51,72213,2875,2068,8723612,2005
NH,total,15849,57534919,8646,8391896,602087,19477,65926815,2005
NH,financial administration,838,2969727,54,59913,4873,867,3029640,2005
NH,other government administration,301,1009370,94,100183,7631,347,1109553,2005
NH,judicial and legal,910,3274956,1,908,120,911,3275864,2005
NH,police protection - officers,274,1252307,0,0,0,274,1252307,2005
NH,police protection - other,137,459168,17,19372,1610,147,478540,2005
NH,corrections,1332,4691541,63,80749,6137,1369,4772290,2005
NH,highways,1633,6174049,297,342864,27252,1797,6516913,2005
NH,air transportation,0,0,0,0,0,0,0,2005
NH,water transport and terminals,3,10627,4,4364,328,5,14991,2005
NH,public welfare,1396,4079742,110,159837,9638,1455,4239579,2005
NH,health,804,2936725,66,94519,5531,837,3031244,2005
NH,hospitals,760,2356004,79,125217,1791,771,2481221,2005
NH,social insurance administration,347,992618,45,59074,3686,369,1051692,2005
NH,solid waste management,0,0,0,0,0,0,0,2005
NH,sewerage,0,0,0,0,0,0,0,2005
NH,parks and recreation,81,230298,249,154918,20077,201,385216,2005
NH,housing and community development,0,0,0,0,0,0,0,2005
NH,natural resources,528,1693134,91,97649,6962,569,1790783,2005
NH,water transport and terminals,0,0,0,0,0,0,0,2005
NH,electric power,0,0,0,0,0,0,0,2005
NH,gas supply,0,0,0,0,0,0,0,2005
NH,transit,0,0,0,0,0,0,0,2005
NH,education - elementary and secondary instructional,0,0,0,0,0,0,0,2005
NH,education - elementary and secondary other,0,0,0,0,0,0,0,2005
NH,education - higher education instructional,1452,7165181,1912,3040144,128543,2226,10205325,2005
NH,education - higher education other,2569,9982983,4804,3468796,317667,4482,13451779,2005
NH,education - other,296,999159,23,36219,2207,309,1035378,2005
NH,libraries,0,0,0,0,0,0,0,2005
NH,liquor stores,293,870923,404,262525,33095,492,1133448,2005
NH,other and unallocable,1895,6386407,333,284645,24939,2049,6671052,2005
NJ,total,142599,692334972,34248,33372568,1901462,154105,725707540,2005
NJ,financial administration,6241,25163197,558,873069,68623,6631,26036266,2005
NJ,other government administration,1448,7070304,62,81059,5025,1477,7151363,2005
NJ,judicial and legal,14721,70909323,190,281569,16128,14812,71190892,2005
NJ,police protection - officers,1419,5139199,84,108741,5885,1452,5247940,2005
NJ,police protection - other,3011,20516217,0,0,0,3011,20516217,2005
NJ,corrections,10258,49887077,25,43970,1875,10269,49931047,2005
NJ,highways,6877,32046584,915,1131401,88612,7380,33177985,2005
NJ,air transportation,0,0,0,0,0,0,0,2005
NJ,water transport and terminals,140,562142,5,6201,465,143,568343,2005
NJ,public welfare,7390,31123746,175,288787,15551,7478,31412533,2005
NJ,health,4476,21708354,443,1042044,22436,4608,22750398,2005
NJ,hospitals,17316,66444337,2209,2833314,210994,18523,69277651,2005
NJ,social insurance administration,1972,7758759,67,85611,5515,2003,7844370,2005
NJ,solid waste management,642,3503943,0,0,0,642,3503943,2005
NJ,sewerage,0,0,0,0,0,0,0,2005
NJ,parks and recreation,1490,6509174,1882,1626900,101455,2071,8136074,2005
NJ,housing and community development,0,0,0,0,0,0,0,2005
NJ,natural resources,2323,10721974,507,642868,25147,2473,11364842,2005
NJ,water transport and terminals,124,506807,2,2048,124,125,508855,2005
NJ,electric power,0,0,0,0,0,0,0,2005
NJ,gas supply,0,0,0,0,0,0,0,2005
NJ,transit,10014,47429537,827,1306032,82842,10485,48735569,2005
NJ,education - elementary and secondary instructional,12211,80245987,1566,2068819,106412,12943,82314806,2005
NJ,education - elementary and secondary other,5393,17675624,2053,1397378,112187,6167,19073002,2005
NJ,education - higher education instructional,7417,61395768,6780,8885993,253855,8970,70281761,2005
NJ,education - higher education other,17706,77524020,15165,9766025,704858,22016,87290045,2005
NJ,education - other,2998,14133706,591,681974,62165,3351,14815680,2005
NJ,libraries,0,0,0,0,0,0,0,2005
NJ,liquor stores,0,0,0,0,0,0,0,2005
NJ,other and unallocable,7012,34359193,142,218765,11308,7075,34577958,2005
NM,total,43164,136414829,16630,18894998,1241970,50221,155309827,2005
NM,financial administration,1610,5509164,136,213647,21538,1732,5722811,2005
NM,other government administration,226,995626,432,1168892,69845,623,2164518,2005
NM,judicial and legal,2754,9810576,135,233393,14932,2839,10043969,2005
NM,police protection - officers,462,1824027,0,0,0,462,1824027,2005
NM,police protection - other,171,678861,0,0,0,171,678861,2005
NM,corrections,4160,12904543,88,179469,13428,4236,13084012,2005
NM,highways,2301,6921027,0,0,0,2301,6921027,2005
NM,air transportation,7,29012,0,0,0,7,29012,2005
NM,water transport and terminals,0,0,0,0,0,0,0,2005
NM,public welfare,1523,4308043,68,155879,10067,1580,4463922,2005
NM,health,2225,6643094,82,181506,11371,2290,6824600,2005
NM,hospitals,8810,29804329,2051,4925838,277743,10388,34730167,2005
NM,social insurance administration,467,1291603,5,6991,516,470,1298594,2005
NM,solid waste management,0,0,0,0,0,0,0,2005
NM,sewerage,0,0,0,0,0,0,0,2005
NM,parks and recreation,686,1976354,94,171403,12664,758,2147757,2005
NM,housing and community development,0,0,0,0,0,0,0,2005
NM,natural resources,1741,5840250,114,138854,12520,1812,5979104,2005
NM,water transport and terminals,0,0,0,0,0,0,0,2005
NM,electric power,0,0,0,0,0,0,0,2005
NM,gas supply,0,0,0,0,0,0,0,2005
NM,transit,0,0,0,0,0,0,0,2005
NM,education - elementary and secondary instructional,0,0,0,0,0,0,0,2005
NM,education - elementary and secondary other,0,0,0,0,0,0,0,2005
NM,education - higher education instructional,3561,10903883,3864,4741015,216105,4788,15644898,2005
NM,education - higher education other,9522,27358919,9437,6551288,565145,12734,33910207,2005
NM,education - other,1112,3688406,65,87105,6839,1150,3775511,2005
NM,libraries,0,0,0,0,0,0,0,2005
NM,liquor stores,0,0,0,0,0,0,0,2005
NM,other and unallocable,1826,5927112,59,139718,9257,1880,6066830,2005
NY,total,227644,1052128883,47106,59158477,3032320,245437,1111287360,2005
NY,financial administration,12750,50811202,193,337854,14850,12835,51149056,2005
NY,other government administration,4520,17808869,644,904983,63230,4881,18713852,2005
NY,judicial and legal,18862,107889174,775,2172187,96306,19410,110061361,2005
NY,police protection - officers,4800,32248929,0,0,0,4800,32248929,2005
NY,police protection - other,1586,5914395,157,259363,21491,1708,6173758,2005
NY,corrections,33232,142506758,469,1163114,47969,33503,143669872,2005
NY,highways,11865,51711282,1030,1215959,86839,12360,52927241,2005
NY,air transportation,161,589391,0,0,0,161,589391,2005
NY,water transport and terminals,645,3147671,28,48752,2194,658,3196423,2005
NY,public welfare,5922,25157683,589,1271737,68247,6311,26429420,2005
NY,health,8979,42908231,395,1047571,42377,9220,43955802,2005
NY,hospitals,38445,155259465,4948,10316861,473608,41143,165576326,2005
NY,social insurance administration,7919,32598028,108,275374,15115,8007,32873402,2005
NY,solid waste management,0,0,0,0,0,0,0,2005
NY,sewerage,0,0,0,0,0,0,0,2005
NY,parks and recreation,1670,6685853,1179,1993290,151828,2533,8679143,2005
NY,housing and community development,0,0,0,0,0,0,0,2005
NY,natural resources,3342,14666353,61,136840,7157,3382,14803193,2005
NY,water transport and terminals,0,0,0,0,0,0,0,2005
NY,electric power,1745,11811013,33,101074,3310,1764,11912087,2005
NY,gas supply,0,0,0,0,0,0,0,2005
NY,transit,15260,86962731,292,398457,30613,15434,87361188,2005
NY,education - elementary and secondary instructional,0,0,0,0,0,0,0,2005
NY,education - elementary and secondary other,0,0,0,0,0,0,0,2005
NY,education - higher education instructional,14168,89346566,15347,19616408,661480,18125,108962974,2005
NY,education - higher education other,25807,99917050,20208,16436873,1184751,32885,116353923,2005
NY,education - other,4379,18806083,266,513296,26213,4529,19319379,2005
NY,libraries,0,0,0,0,0,0,0,2005
NY,liquor stores,0,0,0,0,0,0,0,2005
NY,other and unallocable,11587,55382156,384,948484,34742,11788,56330640,2005
NC,total,119844,415575659,39903,45491959,2706157,135285,461067618,2005
NC,financial administration,4073,12042139,18,31914,1333,4080,12074053,2005
NC,other government administration,692,2945917,414,707091,44057,942,3653008,2005
NC,judicial and legal,5880,22942518,197,220059,8890,5930,23162577,2005
NC,police protection - officers,2250,9350721,0,0,0,2250,9350721,2005
NC,police protection - other,1136,3338554,14,31177,1305,1143,3369731,2005
NC,corrections,20142,54564686,636,1406490,69001,20534,55971176,2005
NC,highways,11552,33188272,33,42124,2739,11568,33230396,2005
NC,air transportation,0,0,0,0,0,0,0,2005
NC,water transport and terminals,290,1175698,0,0,0,290,1175698,2005
NC,public welfare,1980,6807269,12,24385,1026,1986,6831654,2005
NC,health,4246,14812966,156,288923,15431,4334,15101889,2005
NC,hospitals,15897,49148430,2242,6449347,286343,17523,55597777,2005
NC,social insurance administration,2250,7512315,281,494586,33997,2444,8006901,2005
NC,solid waste management,230,896399,8,16224,872,235,912623,2005
NC,sewerage,0,0,0,0,0,0,0,2005
NC,parks and recreation,891,2306837,149,170308,16414,985,2477145,2005
NC,housing and community development,0,0,0,0,0,0,0,2005
NC,natural resources,3681,11315295,1022,967503,52101,3977,12282798,2005
NC,water transport and terminals,0,0,0,0,0,0,0,2005
NC,electric power,0,0,0,0,0,0,0,2005
NC,gas supply,0,0,0,0,0,0,0,2005
NC,transit,0,0,0,0,0,0,0,2005
NC,education - elementary and secondary instructional,0,0,0,0,0,0,0,2005
NC,education - elementary and secondary other,0,0,0,0,0,0,0,2005
NC,education - higher education instructional,11911,74374541,12158,17399640,699598,15900,91774181,2005
NC,education - higher education other,25496,83157366,22324,16835815,1457109,33827,99993181,2005
NC,education - other,2786,9512518,153,315042,9815,2842,9827560,2005
NC,libraries,0,0,0,0,0,0,0,2005
NC,liquor stores,0,0,0,0,0,0,0,2005
NC,other and unallocable,4461,16183218,86,91331,6126,4495,16274549,2005
ND,total,14379,46625707,9238,8418286,658500,18120,55043993,2005
ND,financial administration,618,1805052,39,54592,2499,632,1859644,2005
ND,other government administration,230,675321,239,774817,24378,369,1450138,2005
ND,judicial and legal,501,1795257,58,60216,3901,524,1855473,2005
ND,police protection - officers,130,410000,0,0,0,130,410000,2005
ND,police protection - other,47,143000,3,8085,437,49,151085,2005
ND,corrections,631,1619371,97,137155,7957,676,1756526,2005
ND,highways,996,2915659,2,2670,163,997,2918329,2005
ND,air transportation,0,0,0,0,0,0,0,2005
ND,water transport and terminals,0,0,0,0,0,0,0,2005
ND,public welfare,408,1137292,80,108408,9908,465,1245700,2005
ND,health,1223,3529200,140,145309,8799,1273,3674509,2005
ND,hospitals,812,1786105,296,183295,30246,984,1969400,2005
ND,social insurance administration,352,1008727,35,47732,4256,376,1056459,2005
ND,solid waste management,0,0,0,0,0,0,0,2005
ND,sewerage,0,0,0,0,0,0,0,2005
ND,parks and recreation,126,295716,21,25487,1921,137,321203,2005
ND,housing and community development,0,0,0,0,0,0,0,2005
ND,natural resources,1055,3730262,619,579649,103496,1644,4309911,2005
ND,water transport and terminals,0,0,0,0,0,0,0,2005
ND,electric power,0,0,0,0,0,0,0,2005
ND,gas supply,0,0,0,0,0,0,0,2005
ND,transit,0,0,0,0,0,0,0,2005
ND,education - elementary and secondary instructional,0,0,0,0,0,0,0,2005
ND,education - elementary and secondary other,0,0,0,0,0,0,0,2005
ND,education - higher education instructional,1958,9691359,2135,3361644,201640,3103,13053003,2005
ND,education - higher education other,3603,10081480,5198,2698991,242158,4980,12780471,2005
ND,education - other,266,802697,43,46349,2645,281,849046,2005
ND,libraries,0,0,0,0,0,0,0,2005
ND,liquor stores,0,0,0,0,0,0,0,2005
ND,other and unallocable,1423,5199209,233,183887,14096,1500,5383096,2005
OH,total,111785,436925793,66531,65676295,4321821,136370,502602088,2005
OH,financial administration,7812,34431565,523,824603,52465,8113,35256168,2005
OH,other government administration,776,3067642,123,105019,9010,828,3172661,2005
OH,judicial and legal,2426,11132909,477,1203904,59377,2763,12336813,2005
OH,police protection - officers,1450,7279271,0,0,0,1450,7279271,2005
OH,police protection - other,1224,4485344,17,33606,2161,1236,4518950,2005
OH,corrections,16360,59718865,65,146972,7977,16405,59865837,2005
OH,highways,6841,29131635,590,737101,50516,7128,29868736,2005
OH,air transportation,0,0,0,0,0,0,0,2005
OH,water transport and terminals,0,0,0,0,0,0,0,2005
OH,public welfare,2808,13140373,297,399999,32384,2992,13540372,2005
OH,health,3520,16307936,281,429822,25959,3667,16737758,2005
OH,hospitals,9149,26594615,3095,6851300,363923,11217,33445915,2005
OH,social insurance administration,2247,8126766,440,471405,30631,2421,8598171,2005
OH,solid waste management,0,0,0,0,0,0,0,2005
OH,sewerage,0,0,0,0,0,0,0,2005
OH,parks and recreation,490,1769258,249,375012,28138,650,2144270,2005
OH,housing and community development,0,0,0,0,0,0,0,2005
OH,natural resources,3061,10874832,841,1316947,85699,3548,12191779,2005
OH,water transport and terminals,0,0,0,0,0,0,0,2005
OH,electric power,0,0,0,0,0,0,0,2005
OH,gas supply,0,0,0,0,0,0,0,2005
OH,transit,0,0,0,0,0,0,0,2005
OH,education - elementary and secondary instructional,0,0,0,0,0,0,0,2005
OH,education - elementary and secondary other,0,0,0,0,0,0,0,2005
OH,education - higher education instructional,15032,89007387,21055,27206705,1151378,21591,116214092,2005
OH,education - higher education other,31680,91049886,37796,24550796,2368267,45146,115600682,2005
OH,education - other,2421,10607608,275,479599,22739,2550,11087207,2005
OH,libraries,0,0,0,0,0,0,0,2005
OH,liquor stores,0,0,0,0,0,0,0,2005
OH,other and unallocable,4488,20199901,407,543505,31197,4665,20743406,2005
OK,total,57099,185782978,24236,17706453,1372860,64977,203489431,2005
OK,financial administration,1744,5734070,101,152252,8740,1793,5886322,2005
OK,other government administration,750,2549668,170,288756,18860,857,2838424,2005
OK,judicial and legal,2519,9512734,146,195510,10769,2580,9708244,2005
OK,police protection - officers,978,3930750,25,38179,2015,989,3968929,2005
OK,police protection - other,823,2279404,75,80956,6786,861,2360360,2005
OK,corrections,5481,15775139,227,257718,15607,5570,16032857,2005
OK,highways,2859,8218198,92,89965,5771,2892,8308163,2005
OK,air transportation,11,43589,0,0,0,11,43589,2005
OK,water transport and terminals,0,0,0,0,0,0,0,2005
OK,public welfare,5713,14614980,236,222539,19951,5827,14837519,2005
OK,health,5791,17929568,306,520332,28523,5953,18449900,2005
OK,hospitals,2421,6858844,116,177000,11835,2488,7035844,2005
OK,social insurance administration,1338,4441581,155,154348,12451,1409,4595929,2005
OK,solid waste management,71,228341,12,7448,813,76,235789,2005
OK,sewerage,0,0,0,0,0,0,0,2005
OK,parks and recreation,649,1683743,52,47658,4172,672,1731401,2005
OK,housing and community development,0,0,0,0,0,0,0,2005
OK,natural resources,1736,5089478,861,632425,47972,2007,5721903,2005
OK,water transport and terminals,0,0,0,0,0,0,0,2005
OK,electric power,512,2406712,0,0,0,512,2406712,2005
OK,gas supply,0,0,0,0,0,0,0,2005
OK,transit,0,0,0,0,0,0,0,2005
OK,education - elementary and secondary instructional,0,0,0,0,0,0,0,2005
OK,education - elementary and secondary other,0,0,0,0,0,0,0,2005
OK,education - higher education instructional,5551,29311303,6733,7085288,394913,7838,36396591,2005
OK,education - higher education other,14020,41463524,14658,7433575,763686,18401,48897099,2005
OK,education - other,1871,6045812,92,111062,6616,1907,6156874,2005
OK,libraries,0,0,0,0,0,0,0,2005
OK,liquor stores,0,0,0,0,0,0,0,2005
OK,other and unallocable,2261,7665540,179,211442,13380,2334,7876982,2005
OR,total,50698,188829328,24543,26207955,1273449,57932,215037283,2005
OR,financial administration,3938,13454315,342,518895,40428,4168,13973210,2005
OR,other government administration,1064,3719055,188,284710,14804,1148,4003765,2005
OR,judicial and legal,2895,10522390,287,683166,34503,3091,11205556,2005
OR,police protection - officers,702,2929839,0,0,0,702,2929839,2005
OR,police protection - other,489,1754957,149,104482,5063,518,1859439,2005
OR,corrections,4880,17016880,116,297204,14254,4961,17314084,2005
OR,highways,3336,13295663,46,116786,7385,3378,13412449,2005
OR,air transportation,16,54383,0,0,0,16,54383,2005
OR,water transport and terminals,0,0,0,0,0,0,0,2005
OR,public welfare,5540,18230070,482,884767,22435,5666,19114837,2005
OR,health,2541,8763071,336,550070,30115,2714,9313141,2005
OR,hospitals,4045,13777713,2865,4984443,133058,4801,18762156,2005
OR,social insurance administration,2164,9112358,121,268340,12212,2234,9380698,2005
OR,solid waste management,0,0,0,0,0,0,0,2005
OR,sewerage,0,0,0,0,0,0,0,2005
OR,parks and recreation,421,1287717,14,21196,1305,428,1308913,2005
OR,housing and community development,0,0,0,0,0,0,0,2005
OR,natural resources,2530,8431085,427,593637,40345,2759,9024722,2005
OR,water transport and terminals,0,0,0,0,0,0,0,2005
OR,electric power,0,0,0,0,0,0,0,2005
OR,gas supply,0,0,0,0,0,0,0,2005
OR,transit,0,0,0,0,0,0,0,2005
OR,education - elementary and secondary instructional,0,0,0,0,0,0,0,2005
OR,education - elementary and secondary other,0,0,0,0,0,0,0,2005
OR,education - higher education instructional,7138,33789628,7498,9915708,417966,9512,43705336,2005
OR,education - higher education other,6345,23047489,11386,6666463,481251,9080,29713952,2005
OR,education - other,887,3208313,104,139908,8069,933,3348221,2005
OR,libraries,0,0,0,0,0,0,0,2005
OR,liquor stores,193,692727,9,11652,740,197,704379,2005
OR,other and unallocable,1574,5741675,173,166528,9516,1626,5908203,2005
PA,total,139035,545372456,51764,67444527,3516598,159682,612816983,2005
PA,financial administration,6665,24764662,443,724988,45242,6938,25489650,2005
PA,other government administration,3039,10238888,1065,2551001,111277,3698,12789889,2005
PA,judicial and legal,2992,14867932,10,24460,1570,3001,14892392,2005
PA,police protection - officers,4690,22722778,0,0,0,4690,22722778,2005
PA,police protection - other,1225,5943452,62,159100,7043,1265,6102552,2005
PA,corrections,17072,60346595,453,838207,25776,17227,61184802,2005
PA,highways,13126,42322018,667,1393547,81475,13608,43715565,2005
PA,air transportation,43,171988,0,0,0,43,171988,2005
PA,water transport and terminals,164,652820,0,0,0,164,652820,2005
PA,public welfare,12268,42781198,295,822470,34540,12476,43603668,2005
PA,health,1626,6767035,36,102223,3253,1646,6869258,2005
PA,hospitals,12090,35728249,988,1661962,66486,12485,37390211,2005
PA,social insurance administration,3351,12337238,655,1542576,97403,3938,13879814,2005
PA,solid waste management,0,0,0,0,0,0,0,2005
PA,sewerage,0,0,0,0,0,0,0,2005
PA,parks and recreation,758,2548629,732,1606894,111520,1430,4155523,2005
PA,housing and community development,0,0,0,0,0,0,0,2005
PA,natural resources,5771,23848857,1446,3033802,101019,6368,26882659,2005
PA,water transport and terminals,0,0,0,0,0,0,0,2005
PA,electric power,0,0,0,0,0,0,0,2005
PA,gas supply,0,0,0,0,0,0,0,2005
PA,transit,0,0,0,0,0,0,0,2005
PA,education - elementary and secondary instructional,0,0,0,0,0,0,0,2005
PA,education - elementary and secondary other,0,0,0,0,0,0,0,2005
PA,education - higher education instructional,13125,93133605,10980,28191190,931929,18501,121324795,2005
PA,education - higher education other,28418,99804377,33485,23996911,1849897,39301,123801288,2005
PA,education - other,3870,14578778,149,272506,8192,3919,14851284,2005
PA,libraries,0,0,0,0,0,0,0,2005
PA,liquor stores,2919,8655710,0,0,0,2919,8655710,2005
PA,other and unallocable,5823,23157647,298,522690,39976,6065,23680337,2005
RI,total,17981,78515156,6532,5654884,333563,19942,84170040,2005
RI,financial administration,938,3887034,9,17103,899,944,3904137,2005
RI,other government administration,660,2460385,229,245163,7209,706,2705548,2005
RI,judicial and legal,1241,5610389,22,79943,2604,1258,5690332,2005
RI,police protection - officers,224,1398455,0,0,0,224,1398455,2005
RI,police protection - other,84,363732,6,12329,252,85,376061,2005
RI,corrections,1738,8271048,5,8564,213,1739,8279612,2005
RI,highways,856,3756709,17,36237,1528,865,3792946,2005
RI,air transportation,190,876844,2,5674,224,191,882518,2005
RI,water transport and terminals,0,0,0,0,0,0,0,2005
RI,public welfare,1456,7064914,50,98893,4220,1484,7163807,2005
RI,health,1251,5570860,57,49994,1505,1260,5620854,2005
RI,hospitals,1060,4580416,5,12905,458,1063,4593321,2005
RI,social insurance administration,498,2098121,14,18141,598,502,2116262,2005
RI,solid waste management,123,646550,1,1329,133,124,647879,2005
RI,sewerage,240,980242,0,0,0,240,980242,2005
RI,parks and recreation,69,221490,0,0,0,69,221490,2005
RI,housing and community development,0,0,0,0,0,0,0,2005
RI,natural resources,480,2185759,38,70464,3399,500,2256223,2005
RI,water transport and terminals,0,0,0,0,0,0,0,2005
RI,electric power,0,0,0,0,0,0,0,2005
RI,gas supply,0,0,0,0,0,0,0,2005
RI,transit,784,2868982,45,126616,7423,826,2995598,2005
RI,education - elementary and secondary instructional,427,2016896,73,94513,6602,470,2111409,2005
RI,education - elementary and secondary other,87,255135,81,87848,8717,143,342983,2005
RI,education - higher education instructional,1754,8472173,2741,2927961,130606,2510,11400134,2005
RI,education - higher education other,2178,7476645,3010,1511948,144894,3020,8988593,2005
RI,education - other,514,2497677,68,180038,8774,571,2677715,2005
RI,libraries,0,0,0,0,0,0,0,2005
RI,liquor stores,0,0,0,0,0,0,0,2005
RI,other and unallocable,1129,4954700,59,69221,3305,1148,5023921,2005
SC,total,68548,216953029,21784,18172430,1331669,76498,235125459,2005
SC,financial administration,3126,9711578,54,85324,3008,3144,9796902,2005
SC,other government administration,569,2021094,499,477100,33605,771,2498194,2005
SC,judicial and legal,685,2965080,7,7026,360,687,2972106,2005
SC,police protection - officers,1236,4241384,0,0,0,1236,4241384,2005
SC,police protection - other,622,1722434,0,0,0,622,1722434,2005
SC,corrections,7362,18179628,3,6110,212,7363,18185738,2005
SC,highways,4937,13431528,8,13444,416,4940,13444972,2005
SC,air transportation,0,0,0,0,0,0,0,2005
SC,water transport and terminals,577,2817350,5,11471,828,582,2828821,2005
SC,public welfare,4435,11577624,12,18512,548,4437,11596136,2005
SC,health,6652,19491948,175,411457,9930,6711,19903405,2005
SC,hospitals,7705,16660852,219,489291,27281,7862,17150143,2005
SC,social insurance administration,1248,3738666,0,0,0,1248,3738666,2005
SC,solid waste management,0,0,0,0,0,0,0,2005
SC,sewerage,0,0,0,0,0,0,0,2005
SC,parks and recreation,552,1433781,9,8589,687,556,1442370,2005
SC,housing and community development,0,0,0,0,0,0,0,2005
SC,natural resources,1824,5368834,216,242703,21915,1956,5611537,2005
SC,water transport and terminals,9,44829,0,0,0,9,44829,2005
SC,electric power,1737,8859726,16,52715,2132,1749,8912441,2005
SC,gas supply,0,0,0,0,0,0,0,2005
SC,transit,0,0,0,0,0,0,0,2005
SC,education - elementary and secondary instructional,0,0,0,0,0,0,0,2005
SC,education - elementary and secondary other,0,0,0,0,0,0,0,2005
SC,education - higher education instructional,8499,45792382,9635,10046619,576150,11952,55839001,2005
SC,education - higher education other,12841,36117745,10910,6278245,653729,16738,42395990,2005
SC,education - other,2716,8611844,6,7776,350,2717,8619620,2005
SC,libraries,0,0,0,0,0,0,0,2005
SC,liquor stores,0,0,0,0,0,0,0,2005
SC,other and unallocable,1216,4164722,10,16048,518,1218,4180770,2005
SD,total,11255,36864934,5303,5118683,391373,13477,41983617,2005
SD,financial administration,381,1232444,69,144688,7764,426,1377132,2005
SD,other government administration,279,887320,67,104682,4974,307,992002,2005
SD,judicial and legal,442,1536928,138,233872,13840,521,1770800,2005
SD,police protection - officers,192,719042,3,5616,312,194,724658,2005
SD,police protection - other,104,280714,4,4654,474,107,285368,2005
SD,corrections,726,1937540,97,178134,12152,795,2115674,2005
SD,highways,881,2704144,209,408776,23338,1014,3112920,2005
SD,air transportation,0,0,0,0,0,0,0,2005
SD,water transport and terminals,0,0,0,0,0,0,0,2005
SD,public welfare,944,2459132,137,288290,19528,1055,2747422,2005
SD,health,495,1636554,209,483754,24380,633,2120308,2005
SD,hospitals,750,1909422,205,386874,25444,894,2296296,2005
SD,social insurance administration,276,680976,16,20840,2136,288,701816,2005
SD,solid waste management,0,0,0,0,0,0,0,2005
SD,sewerage,0,0,0,0,0,0,0,2005
SD,parks and recreation,111,307610,36,56310,4116,134,363920,2005
SD,housing and community development,0,0,0,0,0,0,0,2005
SD,natural resources,685,2094977,456,485008,35914,888,2579985,2005
SD,water transport and terminals,0,0,0,0,0,0,0,2005
SD,electric power,0,0,0,0,0,0,0,2005
SD,gas supply,0,0,0,0,0,0,0,2005
SD,transit,0,0,0,0,0,0,0,2005
SD,education - elementary and secondary instructional,0,0,0,0,0,0,0,2005
SD,education - elementary and secondary other,0,0,0,0,0,0,0,2005
SD,education - higher education instructional,1419,8264838,1085,1213417,84879,1900,9478255,2005
SD,education - higher education other,2458,6781353,2389,833025,114184,3107,7614378,2005
SD,education - other,379,1074302,64,90763,6134,414,1165065,2005
SD,libraries,0,0,0,0,0,0,0,2005
SD,liquor stores,0,0,0,0,0,0,0,2005
SD,other and unallocable,733,2357638,119,179980,11804,800,2537618,2005
TN,total,73487,238759896,25511,21618068,1571752,82786,260377964,2005
TN,financial administration,3063,10818630,45,59788,4724,3091,10878418,2005
TN,other government administration,839,2960063,33,31625,1619,849,2991688,2005
TN,judicial and legal,2245,9715514,9,11331,754,2250,9726845,2005
TN,police protection - officers,1149,4448296,0,0,0,1149,4448296,2005
TN,police protection - other,815,2349100,11,16120,672,819,2365220,2005
TN,corrections,7120,19681824,38,66618,3608,7142,19748442,2005
TN,highways,4396,12178916,0,0,0,4396,12178916,2005
TN,air transportation,0,0,0,0,0,0,0,2005
TN,water transport and terminals,0,0,0,0,0,0,0,2005
TN,public welfare,6328,15957189,7,8716,670,6332,15965905,2005
TN,health,3560,11336535,133,107087,5637,3593,11443622,2005
TN,hospitals,7729,21900675,217,588985,30945,7906,22489660,2005
TN,social insurance administration,1487,4248960,174,229372,18428,1598,4478332,2005
TN,solid waste management,0,0,0,0,0,0,0,2005
TN,sewerage,0,0,0,0,0,0,0,2005
TN,parks and recreation,1061,2113418,118,66898,9866,1120,2180316,2005
TN,housing and community development,0,0,0,0,0,0,0,2005
TN,natural resources,3291,10218556,586,618384,61889,3652,10836940,2005
TN,water transport and terminals,0,0,0,0,0,0,0,2005
TN,electric power,0,0,0,0,0,0,0,2005
TN,gas supply,0,0,0,0,0,0,0,2005
TN,transit,0,0,0,0,0,0,0,2005
TN,education - elementary and secondary instructional,0,0,0,0,0,0,0,2005
TN,education - elementary and secondary other,0,0,0,0,0,0,0,2005
TN,education - higher education instructional,8347,45893253,9076,9618766,521975,11453,55512019,2005
TN,education - higher education other,17344,50305379,14349,9732948,885578,22569,60038327,2005
TN,education - other,1957,6241951,657,426514,23474,2099,6668465,2005
TN,libraries,0,0,0,0,0,0,0,2005
TN,liquor stores,0,0,0,0,0,0,0,2005
TN,other and unallocable,2756,8391637,58,34916,1913,2768,8426553,2005
TX,total,243294,859406889,76287,90425110,5436910,274352,949831999,2005
TX,financial administration,9459,32160286,181,228149,12833,9539,32388435,2005
TX,other government administration,2542,8480570,583,678366,40200,2773,9158936,2005
TX,judicial and legal,5327,22214979,208,1095690,22112,5470,23310669,2005
TX,police protection - officers,2242,8247398,0,0,0,2242,8247398,2005
TX,police protection - other,1861,5146409,30,30664,2400,1875,5177073,2005
TX,corrections,45141,109178061,601,660755,51517,45474,109838816,2005
TX,highways,14691,44149433,555,807385,25409,14836,44956818,2005
TX,air transportation,0,0,0,0,0,0,0,2005
TX,water transport and terminals,0,0,0,0,0,0,0,2005
TX,public welfare,18908,49810176,319,513279,32700,19119,50323455,2005
TX,health,12510,41726059,691,1500173,56161,12832,43226232,2005
TX,hospitals,29329,98768133,1994,4536068,239018,30687,103304201,2005
TX,social insurance administration,4422,13738038,59,84645,5568,4458,13822683,2005
TX,solid waste management,0,0,0,0,0,0,0,2005
TX,sewerage,0,0,0,0,0,0,0,2005
TX,parks and recreation,1011,2560552,214,161655,19408,1121,2722207,2005
TX,housing and community development,0,0,0,0,0,0,0,2005
TX,natural resources,10033,37251060,3143,5018906,241449,11408,42269966,2005
TX,water transport and terminals,0,0,0,0,0,0,0,2005
TX,electric power,0,0,0,0,0,0,0,2005
TX,gas supply,0,0,0,0,0,0,0,2005
TX,transit,0,0,0,0,0,0,0,2005
TX,education - elementary and secondary instructional,13,45109,0,0,0,13,45109,2005
TX,education - elementary and secondary other,0,0,0,0,0,0,0,2005
TX,education - higher education instructional,21154,157408168,24090,36123718,1678077,30691,193531886,2005
TX,education - higher education other,53493,189928302,42778,37568120,2928055,70129,227496422,2005
TX,education - other,4362,15177544,452,891127,48752,4675,16068671,2005
TX,libraries,0,0,0,0,0,0,0,2005
TX,liquor stores,0,0,0,0,0,0,0,2005
TX,other and unallocable,6796,23416612,389,526410,33251,7010,23943022,2005
UT,total,41933,146934866,19677,15435813,1264506,49164,162370679,2005
UT,financial administration,1567,5102464,249,185497,16271,1658,5287961,2005
UT,other government administration,165,784610,111,133440,11305,230,918050,2005
UT,judicial and legal,1442,5078522,190,318248,12454,1512,5396770,2005
UT,police protection - officers,441,1496954,0,0,0,441,1496954,2005
UT,police protection - other,353,1242488,51,50375,4010,376,1292863,2005
UT,corrections,3245,9592678,295,222924,20846,3364,9815602,2005
UT,highways,1645,5737207,39,46957,3201,1663,5784164,2005
UT,air transportation,0,0,0,0,0,0,0,2005
UT,water transport and terminals,0,0,0,0,0,0,0,2005
UT,public welfare,3077,9316462,293,391575,26174,3227,9708037,2005
UT,health,1853,5830871,296,422256,26107,2001,6253127,2005
UT,hospitals,5501,16331255,364,343809,27494,5657,16675064,2005
UT,social insurance administration,796,2550789,69,75679,5105,825,2626468,2005
UT,solid waste management,0,0,0,0,0,0,0,2005
UT,sewerage,0,0,0,0,0,0,0,2005
UT,parks and recreation,232,747920,56,57889,5710,265,805809,2005
UT,housing and community development,0,0,0,0,0,0,0,2005
UT,natural resources,1112,3682894,201,190764,14023,1191,3873658,2005
UT,water transport and terminals,0,0,0,0,0,0,0,2005
UT,electric power,0,0,0,0,0,0,0,2005
UT,gas supply,0,0,0,0,0,0,0,2005
UT,transit,0,0,0,0,0,0,0,2005
UT,education - elementary and secondary instructional,0,0,0,0,0,0,0,2005
UT,education - elementary and secondary other,0,0,0,0,0,0,0,2005
UT,education - higher education instructional,4481,30948758,3564,3295250,164087,5428,34244008,2005
UT,education - higher education other,13325,39512473,12948,8795219,855344,18216,48307692,2005
UT,education - other,828,2748914,416,458854,34434,1023,3207768,2005
UT,libraries,0,0,0,0,0,0,0,2005
UT,liquor stores,218,541843,255,135461,15686,307,677304,2005
UT,other and unallocable,1652,5687764,280,311616,22255,1780,5999380,2005
VT,total,13215,51479439,2764,3543547,194424,14353,55022986,2005
VT,financial administration,633,2472469,8,17750,1001,640,2490219,2005
VT,other government administration,483,1636951,204,395052,21020,602,2032003,2005
VT,judicial and legal,587,2416396,58,123778,6503,624,2540174,2005
VT,police protection - officers,300,1570654,26,22964,1660,309,1593618,2005
VT,police protection - other,205,808976,36,40729,3596,225,849705,2005
VT,corrections,1161,4020914,14,33675,1756,1171,4054589,2005
VT,highways,1085,3806758,10,28116,1277,1092,3834874,2005
VT,air transportation,0,0,0,0,0,0,0,2005
VT,water transport and terminals,0,0,0,0,0,0,0,2005
VT,public welfare,1202,4486637,52,141853,7360,1244,4628490,2005
VT,health,530,2249738,295,457264,30106,701,2707002,2005
VT,hospitals,201,691842,7,22930,837,206,714772,2005
VT,social insurance administration,270,995658,3,9217,427,272,1004875,2005
VT,solid waste management,0,0,0,0,0,0,0,2005
VT,sewerage,0,0,0,0,0,0,0,2005
VT,parks and recreation,118,464747,7,17982,892,123,482729,2005
VT,housing and community development,0,0,0,0,0,0,0,2005
VT,natural resources,559,2347741,56,222774,7843,605,2570515,2005
VT,water transport and terminals,0,0,0,0,0,0,0,2005
VT,electric power,0,0,0,0,0,0,0,2005
VT,gas supply,0,0,0,0,0,0,0,2005
VT,transit,0,0,0,0,0,0,0,2005
VT,education - elementary and secondary instructional,0,0,0,0,0,0,0,2005
VT,education - elementary and secondary other,0,0,0,0,0,0,0,2005
VT,education - higher education instructional,1296,7817558,467,857155,30534,1480,8674713,2005
VT,education - higher education other,2867,8953900,1358,847557,63269,3248,9801457,2005
VT,education - other,548,2192804,38,77694,3791,570,2270498,2005
VT,libraries,0,0,0,0,0,0,0,2005
VT,liquor stores,55,206250,1,651,58,55,206901,2005
VT,other and unallocable,1115,4339446,124,226406,12494,1186,4565852,2005
VA,total,102148,376734153,47518,47635211,3062804,119548,424369364,2005
VA,financial administration,3849,13872038,603,801798,64982,4217,14673836,2005
VA,other government administration,507,2185148,249,538214,27223,664,2723362,2005
VA,judicial and legal,3537,14560582,424,622994,25956,3686,15183576,2005
VA,police protection - officers,1908,8271504,0,0,0,1908,8271504,2005
VA,police protection - other,744,2262808,158,221104,16982,840,2483912,2005
VA,corrections,13963,38220036,443,616886,45890,14224,38836922,2005
VA,highways,9241,32912524,736,599959,41238,9475,33512483,2005
VA,air transportation,0,0,0,0,0,0,0,2005
VA,water transport and terminals,137,636322,4,4060,400,139,640382,2005
VA,public welfare,2215,7725794,218,411820,23472,2348,8137614,2005
VA,health,4845,17088706,459,672684,42186,5085,17761390,2005
VA,hospitals,12340,37518016,1237,2162841,106516,12945,39680857,2005
VA,social insurance administration,1268,4183758,520,826756,63586,1629,5010514,2005
VA,solid waste management,0,0,0,0,0,0,0,2005
VA,sewerage,0,0,0,0,0,0,0,2005
VA,parks and recreation,594,1817162,663,508328,49516,875,2325490,2005
VA,housing and community development,0,0,0,0,0,0,0,2005
VA,natural resources,2998,10086746,344,441640,31626,3177,10528386,2005
VA,water transport and terminals,0,0,0,0,0,0,0,2005
VA,electric power,0,0,0,0,0,0,0,2005
VA,gas supply,0,0,0,0,0,0,0,2005
VA,transit,0,0,0,0,0,0,0,2005
VA,education - elementary and secondary instructional,0,0,0,0,0,0,0,2005
VA,education - elementary and secondary other,0,0,0,0,0,0,0,2005
VA,education - higher education instructional,13343,81431094,14104,20536309,782049,17783,101967403,2005
VA,education - higher education other,23720,76965882,24673,15881187,1510890,32302,92847069,2005
VA,education - other,2566,10021604,593,613712,41092,2800,10635316,2005
VA,libraries,0,0,0,0,0,0,0,2005
VA,liquor stores,780,2291514,1491,1244588,128470,1510,3536102,2005
VA,other and unallocable,3593,14682915,599,930331,60730,3941,15613246,2005
WA,total,97842,399789832,52462,57301785,3413001,117282,457091617,2005
WA,financial administration,2601,10363410,222,408007,19830,2715,10771417,2005
WA,other government administration,1243,4995217,380,754138,41884,1482,5749355,2005
WA,judicial and legal,1796,9416129,180,385701,16546,1891,9801830,2005
WA,police protection - officers,983,5499808,0,0,0,983,5499808,2005
WA,police protection - other,1230,5052418,0,0,0,1230,5052418,2005
WA,corrections,8819,30479271,576,867012,48740,9095,31346283,2005
WA,highways,6822,29620490,320,732358,35200,7022,30352848,2005
WA,air transportation,0,0,0,0,0,0,0,2005
WA,water transport and terminals,0,0,0,0,0,0,0,2005
WA,public welfare,9352,37492346,1237,2002122,98942,9914,39494468,2005
WA,health,4974,18527554,1137,2135534,114962,5628,20663088,2005
WA,hospitals,8282,34498507,3070,8814224,254082,9726,43312731,2005
WA,social insurance administration,2436,9126526,336,643618,37000,2646,9770144,2005
WA,solid waste management,129,558314,22,86210,3292,148,644524,2005
WA,sewerage,0,0,0,0,0,0,0,2005
WA,parks and recreation,587,1842930,132,215516,21974,712,2058446,2005
WA,housing and community development,0,0,0,0,0,0,0,2005
WA,natural resources,4544,18108864,718,1054087,66392,4921,19162951,2005
WA,water transport and terminals,0,0,0,0,0,0,0,2005
WA,electric power,0,0,0,0,0,0,0,2005
WA,gas supply,0,0,0,0,0,0,0,2005
WA,transit,0,0,0,0,0,0,0,2005
WA,education - elementary and secondary instructional,0,0,0,0,0,0,0,2005
WA,education - elementary and secondary other,0,0,0,0,0,0,0,2005
WA,education - higher education instructional,11277,58757944,12344,20513411,715355,15346,79271355,2005
WA,education - higher education other,25547,97711129,29884,16034784,1790435,35752,113745913,2005
WA,education - other,1779,7175834,887,984680,47975,2059,8160514,2005
WA,libraries,0,0,0,0,0,0,0,2005
WA,liquor stores,487,1356224,508,769754,57822,816,2125978,2005
WA,other and unallocable,4954,19206917,509,900629,42570,5196,20107546,2005
WV,total,34934,106499253,9395,7500346,463042,37710,113999599,2005
WV,financial administration,2531,7143598,26,26641,1862,2542,7170239,2005
WV,other government administration,211,677486,336,979790,32855,422,1657276,2005
WV,judicial and legal,1363,4588274,20,16614,1800,1373,4604888,2005
WV,police protection - officers,625,2364070,0,0,0,625,2364070,2005
WV,police protection - other,351,735700,16,8308,832,356,744008,2005
WV,corrections,3304,7078622,7,11408,1022,3310,7090030,2005
WV,highways,5185,16140920,31,60055,4125,5208,16200975,2005
WV,air transportation,2,9076,0,0,0,2,9076,2005
WV,water transport and terminals,2,6854,0,0,0,2,6854,2005
WV,public welfare,3294,7562622,36,49646,3882,3316,7612268,2005
WV,health,866,2442478,40,39264,2690,881,2481742,2005
WV,hospitals,1609,3582972,107,118094,9614,1664,3701066,2005
WV,social insurance administration,607,1674182,21,16938,1606,617,1691120,2005
WV,solid waste management,10,35332,0,0,0,10,35332,2005
WV,sewerage,0,0,0,0,0,0,0,2005
WV,parks and recreation,403,795768,327,197282,31892,584,993050,2005
WV,housing and community development,0,0,0,0,0,0,0,2005
WV,natural resources,2181,6819844,189,175370,15378,2273,6995214,2005
WV,water transport and terminals,0,0,0,0,0,0,0,2005
WV,electric power,0,0,0,0,0,0,0,2005
WV,gas supply,0,0,0,0,0,0,0,2005
WV,transit,7,23764,0,0,0,7,23764,2005
WV,education - elementary and secondary instructional,0,0,0,0,0,0,0,2005
WV,education - elementary and secondary other,0,0,0,0,0,0,0,2005
WV,education - higher education instructional,3215,16617429,3815,3778439,137595,4042,20395868,2005
WV,education - higher education other,5772,17681902,4081,1746648,196073,6953,19428550,2005
WV,education - other,1374,4340304,196,150176,10996,1439,4490480,2005
WV,libraries,0,0,0,0,0,0,0,2005
WV,liquor stores,52,137230,1,1080,134,53,138310,2005
WV,other and unallocable,1970,6040826,146,124593,10686,2031,6165419,2005
WI,total,54985,237568141,41027,38256078,2675185,70189,275824219,2005
WI,financial administration,2565,10556371,613,945803,62338,2919,11502174,2005
WI,other government administration,856,3582287,345,739258,30950,1032,4321545,2005
WI,judicial and legal,1804,10354348,292,794674,31119,1981,11149022,2005
WI,police protection - officers,573,2510800,1,261,9,573,2511061,2005
WI,police protection - other,303,1147115,31,43800,3206,322,1190915,2005
WI,corrections,9138,32192575,962,2145703,98725,9700,34338278,2005
WI,highways,1618,7048462,166,263307,15753,1708,7311769,2005
WI,air transportation,0,0,0,0,0,0,0,2005
WI,water transport and terminals,0,0,0,0,0,0,0,2005
WI,public welfare,1111,4076069,370,674863,39653,1336,4750932,2005
WI,health,1413,6233442,560,930360,50256,1699,7163802,2005
WI,hospitals,3026,10637403,1226,2080851,104632,3621,12718254,2005
WI,social insurance administration,950,3778513,40,55493,3580,970,3834006,2005
WI,solid waste management,0,0,0,0,0,0,0,2005
WI,sewerage,0,0,0,0,0,0,0,2005
WI,parks and recreation,145,495391,60,98700,5772,178,594091,2005
WI,housing and community development,0,0,0,0,0,0,0,2005
WI,natural resources,1912,7350184,1144,1573064,106130,2515,8923248,2005
WI,water transport and terminals,0,0,0,0,0,0,0,2005
WI,electric power,0,0,0,0,0,0,0,2005
WI,gas supply,0,0,0,0,0,0,0,2005
WI,transit,0,0,0,0,0,0,0,2005
WI,education - elementary and secondary instructional,0,0,0,0,0,0,0,2005
WI,education - elementary and secondary other,0,0,0,0,0,0,0,2005
WI,education - higher education instructional,7811,47719219,9677,10911446,595013,11192,58630665,2005
WI,education - higher education other,15626,63912270,24003,14498676,1389134,23519,78410946,2005
WI,education - other,1003,4198516,281,404304,20670,1120,4602820,2005
WI,libraries,0,0,0,0,0,0,0,2005
WI,liquor stores,0,0,0,0,0,0,0,2005
WI,other and unallocable,5131,21775176,1256,2095515,118245,5804,23870691,2005
WY,total,11060,37487504,3209,2125186,120332,11736,39612690,2005
WY,financial administration,530,1908880,8,11892,693,533,1920772,2005
WY,other government administration,133,545431,185,152101,9194,184,697532,2005
WY,judicial and legal,510,2063020,26,36233,2255,522,2099253,2005
WY,police protection - officers,176,720063,0,0,0,176,720063,2005
WY,police protection - other,86,297145,0,0,0,86,297145,2005
WY,corrections,913,2533646,6,6315,520,916,2539961,2005
WY,highways,1600,5532761,55,77669,5283,1630,5610430,2005
WY,air transportation,0,0,0,0,0,0,0,2005
WY,water transport and terminals,0,0,0,0,0,0,0,2005
WY,public welfare,763,2367214,44,41668,3536,783,2408882,2005
WY,health,619,2070632,108,146656,8982,671,2217288,2005
WY,hospitals,772,1900737,47,54934,4073,795,1955671,2005
WY,social insurance administration,261,795384,32,35769,2773,277,831153,2005
WY,solid waste management,0,0,0,0,0,0,0,2005
WY,sewerage,0,0,0,0,0,0,0,2005
WY,parks and recreation,100,289695,18,13175,1503,109,302870,2005
WY,housing and community development,0,0,0,0,0,0,0,2005
WY,natural resources,818,2682024,16,17201,1096,823,2699225,2005
WY,water transport and terminals,0,0,0,0,0,0,0,2005
WY,electric power,0,0,0,0,0,0,0,2005
WY,gas supply,0,0,0,0,0,0,0,2005
WY,transit,0,0,0,0,0,0,0,2005
WY,education - elementary and secondary instructional,0,0,0,0,0,0,0,2005
WY,education - elementary and secondary other,0,0,0,0,0,0,0,2005
WY,education - higher education instructional,933,4928507,740,636099,22362,1060,5564606,2005
WY,education - higher education other,1799,5344693,1851,829174,51823,2093,6173867,2005
WY,education - other,244,929020,5,4461,434,246,933481,2005
WY,libraries,0,0,0,0,0,0,0,2005
WY,liquor stores,31,95157,0,0,0,31,95157,2005
WY,other and unallocable,772,2483495,68,61839,5805,801,2545334,2005
