state,government_function,full_time_employees,full_time_pay,part_time_employees,part_time_pay,part_time_hours,full_time_equivalent_employees,total_employees,march_pay,year
US,total,3775705,16146025198,1424642,1642719596,92860248,4306623,5200347,17788744794,2007
US,financial administration,166132,672991974,11175,19235729,1150795,172684,177307,692227703,2007
US,other government administration,50032,212684612,11753,23630406,1098370,56382,61785,236315018,2007
US,judicial and legal,167530,801450338,10000,21985157,961839,173021,177530,823435495,2007
US,police protection - officers,66996,366601746,713,1081005,28498,67159,67709,367682751,2007
US,police protection - other,38466,141922533,2472,3047571,171069,39436,40938,144970104,2007
US,corrections,464402,1784314606,10622,24086260,1069692,470464,475024,1808400866,2007
US,highways,231145,937007949,10318,21961801,981971,236758,241463,958969750,2007
US,air transportation,3251,16347927,192,317693,13842,3330,3443,16665620,2007
US,water transport and terminals,4935,22194807,58,99883,5874,4968,4993,22294690,2007
US,public welfare,229002,792175512,10832,20544454,1108032,235305,239834,812719966,2007
US,health,175741,686392745,14213,28088149,1321855,183275,189954,714480894,2007
US,hospitals,381154,1512308208,62994,154171445,6350463,417113,444148,1666479653,2007
US,social insurance administration,75338,298413328,5789,11885552,667074,79165,81127,310298880,2007
US,solid waste management,1841,9443354,134,364759,15107,1928,1975,9808113,2007
US,sewerage,1718,9534628,47,185523,5275,1748,1765,9720151,2007
US,parks and recreation,27394,92855528,12942,16946344,1284429,34768,40336,109801872,2007
US,natural resources,129937,522694279,29121,39303256,2666569,145114,159058,561997535,2007
US,water transport and terminals,680,3561426,41,101190,4175,704,721,3662616,2007
US,electric power,3997,23615971,76,225436,7672,4040,4073,23841407,2007
US,transit,31891,172878291,1865,3434948,210290,33079,33756,176313239,2007
US,education - elementary and secondary instructional,36427,181568379,9195,9739341,456416,39139,45622,191307720,2007
US,education - elementary and secondary other,10346,31692309,7667,6078067,431155,13004,18013,37770376,2007
US,education - higher education instructional,385292,2488981209,382724,574491053,23901590,522198,768016,3063472262,2007
US,education - higher education other,809604,3146262681,797237,610886096,46326151,1074454,1606841,3757148777,2007
US,education - other,84996,347344036,14341,21850031,1130545,91427,99337,369194067,2007
US,libraries,473,1520730,305,269144,22654,601,778,1789874,2007
US,liquor stores,6328,19491269,2838,2811177,260435,7813,9166,22302446,2007
US,other and unallocable,190657,849774823,14978,25898126,1208411,197546,205635,875672949,2007
AL,total,78750,298097163,27744,26771915,1720845,88617,106494,324869078,2007
AL,financial administration,2603,9506200,90,105989,10013,2659,2693,9612189,2007
AL,other government administration,540,2288314,96,127400,6467,577,636,2415714,2007
AL,judicial and legal,3533,14783880,75,156464,3500,3553,3608,14940344,2007
AL,police protection - officers,794,3686732,0,0,0,794,794,3686732,2007
AL,police protection - other,766,2383364,0,0,0,766,766,2383364,2007
AL,corrections,4971,14177297,10,10400,640,4975,4981,14187697,2007
AL,highways,4529,13932014,96,68324,7680,4572,4625,14000338,2007
AL,water transport and terminals,623,2460350,1,1500,60,623,624,2461850,2007
AL,public welfare,4515,13136794,23,39380,2628,4530,4538,13176174,2007
AL,health,5515,18537275,468,517026,57494,5840,5983,19054301,2007
AL,hospitals,10861,38287195,1732,4153758,151499,11717,12593,42440953,2007
AL,social insurance administration,914,3476142,59,70372,7938,959,973,3546514,2007
AL,parks and recreation,496,1235395,242,183764,24922,637,738,1419159,2007
AL,natural resources,2080,7687793,251,268016,26104,2227,2331,7955809,2007
AL,education - higher education instructional,9032,58175551,7997,8908192,457446,11679,17029,67083743,2007
AL,education - higher education other,20945,73643165,16052,11566297,912437,26185,36997,85209462,2007
AL,education - other,3173,11058985,149,145606,7937,3218,3322,11204591,2007
AL,liquor stores,737,1863406,12,18306,1256,744,749,1881712,2007
AL,other and unallocable,2123,7777311,391,431121,42824,2362,2514,8208432,2007
AK,total,23647,107946907,5550,6221186,350628,25653,29197,114168093,2007
AK,financial administration,1033,4862034,41,44883,2456,1045,1074,4906917,2007
AK,other government administration,744,3180929,40,55438,2771,760,784,3236367,2007
AK,judicial and legal,1338,6577712,58,104257,4178,1362,1396,6681969,2007
AK,police protection - officers,263,1656419,0,0,0,263,263,1656419,2007
AK,police protection - other,127,427237,66,31810,2220,140,193,459047,2007
AK,corrections,1767,7950419,46,62687,4211,1791,1813,8013106,2007
AK,highways,3049,14756936,35,41666,2766,3065,3084,14798602,2007
AK,public welfare,1729,6499851,129,159644,14289,1809,1858,6659495,2007
AK,health,656,3058213,30,51542,2575,670,686,3109755,2007
AK,hospitals,206,991409,31,54859,4080,229,237,1046268,2007
AK,social insurance administration,382,1515729,10,9623,631,386,392,1525352,2007
AK,parks and recreation,86,330916,2,2883,143,87,88,333799,2007
AK,natural resources,2337,10182469,131,217758,10127,2394,2468,10400227,2007
AK,education - elementary and secondary instructional,1937,8167825,623,621314,36332,2155,2560,8789139,2007
AK,education - elementary and secondary other,760,2127091,629,569333,38885,994,1389,2696424,2007
AK,education - higher education instructional,1100,7839845,1027,1222662,31288,1277,2127,9062507,2007
AK,education - higher education other,2918,12393449,2542,2867325,187858,3979,5460,15260774,2007
AK,education - other,245,1072962,32,17218,1222,252,277,1090180,2007
AK,other and unallocable,2970,14355462,78,86284,4596,2995,3048,14441746,2007
AZ,total,57580,230538948,27617,28817668,1883199,68224,85197,259356616,2007
AZ,financial administration,3481,11848422,83,148863,7330,3522,3564,11997285,2007
AZ,other government administration,689,2719407,134,223364,9588,745,823,2942771,2007
AZ,judicial and legal,2316,9858524,133,270553,11186,2379,2449,10129077,2007
AZ,police protection - officers,1155,5612317,0,0,0,1155,1155,5612317,2007
AZ,police protection - other,811,3350596,83,127575,6325,847,894,3478171,2007
AZ,corrections,8915,29451932,75,195047,6996,8954,8990,29646979,2007
AZ,highways,2499,9289322,353,596972,41490,2733,2852,9886294,2007
AZ,public welfare,5811,16705947,236,359653,22784,5939,6047,17065600,2007
AZ,health,2432,8484395,130,167219,7446,2474,2562,8651614,2007
AZ,hospitals,685,2366551,64,118283,4111,708,749,2484834,2007
AZ,social insurance administration,402,1077080,70,108072,7096,442,472,1185152,2007
AZ,parks and recreation,369,1116458,114,94412,8736,418,483,1210870,2007
AZ,natural resources,2629,11722728,853,910406,62907,2985,3482,12633134,2007
AZ,electric power,9,60294,0,0,0,9,9,60294,2007
AZ,education - higher education instructional,6446,41427700,8397,11619774,608584,9885,14843,53047474,2007
AZ,education - higher education other,12660,53772775,16155,12853020,1013881,18388,28815,66625795,2007
AZ,education - other,3132,10457903,477,647540,43697,3380,3609,11105443,2007
AZ,other and unallocable,3139,11216597,260,376915,21042,3261,3399,11593512,2007
AR,total,54457,179746996,13224,11291915,871593,59386,67681,191038911,2007
AR,financial administration,1909,5571047,23,28707,2731,1924,1932,5599754,2007
AR,other government administration,661,2579320,185,285450,16224,753,846,2864770,2007
AR,judicial and legal,1417,4273883,126,369805,11444,1482,1543,4643688,2007
AR,police protection - officers,580,2172228,0,0,0,580,580,2172228,2007
AR,police protection - other,613,1655587,0,0,0,613,613,1655587,2007
AR,corrections,5111,13161911,2,4220,248,5112,5113,13166131,2007
AR,highways,3529,11452216,24,14249,1893,3540,3553,11466465,2007
AR,public welfare,3698,10057118,0,0,0,3698,3698,10057118,2007
AR,health,5170,16473783,119,256128,14738,5254,5289,16729911,2007
AR,hospitals,5633,17898149,164,281054,15019,5718,5797,18179203,2007
AR,social insurance administration,934,3050553,7,21401,762,938,941,3071954,2007
AR,parks and recreation,672,1615155,2,1727,266,674,674,1616882,2007
AR,natural resources,1799,5335433,381,275037,25844,1944,2180,5610470,2007
AR,education - higher education instructional,6332,33511343,4600,5927265,360959,8372,10932,39438608,2007
AR,education - higher education other,12545,38420881,7532,3761254,417843,14905,20077,42182135,2007
AR,education - other,1470,4601778,22,20625,944,1476,1492,4622403,2007
AR,other and unallocable,2384,7916611,37,44993,2678,2403,2421,7961604,2007
CA,total,334432,1901011259,145162,217761653,9332931,387168,479594,2118772912,2007
CA,financial administration,20112,89725715,3466,5760570,359565,22142,23578,95486285,2007
CA,other government administration,3754,20402982,327,776190,25455,3904,4081,21179172,2007
CA,judicial and legal,4517,26401385,471,1119212,34136,4710,4988,27520597,2007
CA,police protection - officers,7550,50244320,456,689705,13575,7627,8006,50934025,2007
CA,police protection - other,5451,20694344,788,857170,36125,5656,6239,21551514,2007
CA,corrections,54344,336252292,2146,7114892,241892,55710,56490,343367184,2007
CA,highways,20058,134098600,1127,3872182,134103,20816,21185,137970782,2007
CA,public welfare,3576,15947813,240,761916,29888,3745,3816,16709729,2007
CA,health,11027,60275651,1536,3718152,130176,11761,12563,63993803,2007
CA,hospitals,35337,207326559,8414,24451313,794878,39829,43751,231777872,2007
CA,social insurance administration,17417,75774163,1465,3373115,156214,18299,18882,79147278,2007
CA,solid waste management,360,1978490,61,198209,6499,397,421,2176699,2007
CA,parks and recreation,2311,11033022,1749,2757233,187335,3370,4060,13790255,2007
CA,natural resources,12209,65198644,2616,4597601,320775,14022,14825,69796245,2007
CA,education - higher education instructional,21985,174380369,32119,57593895,2049819,33566,54104,231974264,2007
CA,education - higher education other,84195,429510883,84441,90767302,4495086,109591,168636,520278185,2007
CA,education - other,3905,18410823,618,1120183,51769,4197,4523,19531006,2007
CA,other and unallocable,26324,163355204,3122,8232813,265641,27826,29446,171588017,2007
CO,total,52814,249406846,36547,52343928,2649884,67784,89361,301750774,2007
CO,financial administration,2025,9355537,134,296776,13361,2099,2159,9652313,2007
CO,other government administration,399,1621880,171,360205,20646,516,570,1982085,2007
CO,judicial and legal,3356,15824830,841,2179151,93503,3884,4197,18003981,2007
CO,police protection - officers,798,4346290,0,0,0,798,798,4346290,2007
CO,police protection - other,373,1352678,21,42032,1738,383,394,1394710,2007
CO,corrections,6766,27365842,85,261095,11869,6833,6851,27626937,2007
CO,highways,3013,13328804,195,423955,19610,3124,3208,13752759,2007
CO,public welfare,1786,7961554,576,1195725,57901,2114,2362,9157279,2007
CO,health,1086,5716103,158,455295,16590,1179,1244,6171398,2007
CO,hospitals,4582,17227211,1034,2427140,122482,5273,5616,19654351,2007
CO,social insurance administration,889,4038418,91,159620,12786,961,980,4198038,2007
CO,parks and recreation,257,1152434,98,129521,7188,298,355,1281955,2007
CO,natural resources,1354,6662255,323,500571,19096,1462,1677,7162826,2007
CO,education - higher education instructional,9020,63218736,9677,16216265,784475,13451,18697,79435001,2007
CO,education - higher education other,14714,59596479,22184,25748513,1378241,22502,36898,85344992,2007
CO,education - other,884,3868173,870,1720768,80584,1339,1754,5588941,2007
CO,other and unallocable,1512,6769622,89,227296,9814,1568,1601,6996918,2007
CT,total,53151,275697675,22043,32396223,1435683,61823,75194,308093898,2007
CT,financial administration,2756,13084642,178,491629,20701,2874,2934,13576271,2007
CT,other government administration,1229,5917093,237,809237,29580,1395,1466,6726330,2007
CT,judicial and legal,4720,21857870,305,531318,9792,4776,5025,22389188,2007
CT,police protection - officers,1498,8337827,1,2613,139,1499,1499,8340440,2007
CT,police protection - other,577,2717786,45,105145,4784,603,622,2822931,2007
CT,corrections,7486,36946497,136,392064,12210,7556,7622,37338561,2007
CT,highways,3022,14831759,6,23269,1052,3028,3028,14855028,2007
CT,air transportation,160,1057065,0,0,0,160,160,1057065,2007
CT,public welfare,2340,10527936,277,529784,21263,2460,2617,11057720,2007
CT,health,1862,8833099,106,336072,11955,1929,1968,9169171,2007
CT,hospitals,7664,41926152,2798,8687286,312205,9427,10462,50613438,2007
CT,social insurance administration,643,3510496,46,87993,4889,671,689,3598489,2007
CT,solid waste management,55,351616,7,27662,1098,62,62,379278,2007
CT,parks and recreation,170,840966,3,7463,396,172,173,848429,2007
CT,natural resources,820,4039400,56,175465,7601,863,876,4214865,2007
CT,education - higher education instructional,4384,30411370,8025,12099313,434423,7100,12409,42510683,2007
CT,education - higher education other,7959,39668367,8254,5761808,452594,10815,16213,45430175,2007
CT,education - other,2439,13233231,1136,1533471,73925,2857,3575,14766702,2007
CT,other and unallocable,3367,17604503,427,794631,37076,3576,3794,18399134,2007
DE,total,22810,93904626,8413,11619662,554053,26148,31223,105524288,2007
DE,financial administration,814,2736959,25,23792,1486,822,839,2760751,2007
DE,other government administration,276,1156303,124,317186,12423,351,400,1473489,2007
DE,judicial and legal,1676,7518532,54,105105,5019,1706,1730,7623637,2007
DE,police protection - officers,700,4698177,0,0,0,700,700,4698177,2007
DE,police protection - other,314,1149054,23,12487,1158,321,337,1161541,2007
DE,corrections,2816,11549863,63,89724,6868,2857,2879,11639587,2007
DE,highways,1561,5143046,12,22916,1134,1568,1573,5165962,2007
DE,water transport and terminals,361,1030309,0,0,0,361,361,1030309,2007
DE,public welfare,1578,5481063,110,194038,11516,1648,1688,5675101,2007
DE,health,2099,7801304,184,325146,18341,2209,2283,8126450,2007
DE,hospitals,1858,6190479,93,129531,8669,1910,1951,6320010,2007
DE,social insurance administration,305,1031135,22,38656,2032,317,327,1069791,2007
DE,solid waste management,162,565542,16,23774,1933,174,178,589316,2007
DE,parks and recreation,273,754883,62,56750,4983,303,335,811633,2007
DE,natural resources,474,1754581,123,107594,7825,521,597,1862175,2007
DE,transit,684,2808718,20,44494,2998,701,704,2853212,2007
DE,education - higher education instructional,1524,10450083,3712,5988892,238653,2962,5236,16438975,2007
DE,education - higher education other,3436,13763043,3505,3880808,214691,4730,6941,17643851,2007
DE,education - other,340,1839629,35,70170,3032,358,375,1909799,2007
DE,other and unallocable,1559,6481923,230,188599,11292,1629,1789,6670522,2007
FL,total,171342,639747269,45048,51564712,3080078,188772,216390,691311981,2007
FL,financial administration,6996,25279678,305,310529,23766,7130,7301,25590207,2007
FL,other government administration,2003,8492932,137,142663,10524,2062,2140,8635595,2007
FL,judicial and legal,20161,81602679,1122,1561858,92441,20685,21283,83164537,2007
FL,police protection - officers,2339,9665482,79,81309,4010,2362,2418,9746791,2007
FL,police protection - other,2037,6880957,104,86960,7467,2079,2141,6967917,2007
FL,corrections,28945,87929680,298,494962,24521,29084,29243,88424642,2007
FL,highways,7282,29195996,137,124066,10697,7343,7419,29320062,2007
FL,public welfare,9246,27745380,235,302589,19855,9358,9481,28047969,2007
FL,health,23025,67867011,1591,2457197,154988,23900,24616,70324208,2007
FL,hospitals,3704,11133840,95,216307,10122,3761,3799,11350147,2007
FL,social insurance administration,2242,7368102,61,96054,5412,2273,2303,7464156,2007
FL,parks and recreation,1264,3075284,297,229047,20061,1377,1561,3304331,2007
FL,natural resources,9021,28938659,2470,2241861,151282,9876,11491,31180520,2007
FL,transit,579,2311741,54,74773,5252,609,633,2386514,2007
FL,education - higher education instructional,15156,113160405,13039,17930147,905596,20276,28195,131090552,2007
FL,education - higher education other,27411,95831211,24005,24313845,1566996,36288,51416,120145056,2007
FL,education - other,3244,10817855,462,344164,24424,3381,3706,11162019,2007
FL,other and unallocable,6687,22450377,557,556381,42664,6928,7244,23006758,2007
GA,total,111802,401415182,41432,40259923,2587181,126420,153234,441675105,2007
GA,financial administration,4471,16402434,36,66532,1839,4481,4507,16468966,2007
GA,other government administration,689,2714473,598,1295397,64736,1055,1287,4009870,2007
GA,judicial and legal,3612,16926253,55,74864,2836,3629,3667,17001117,2007
GA,police protection - officers,1040,3841168,0,0,0,1040,1040,3841168,2007
GA,police protection - other,991,3337590,10,11542,960,996,1001,3349132,2007
GA,corrections,19491,50813826,573,1169056,57944,19819,20064,51982882,2007
GA,highways,5914,17656186,30,17640,776,5918,5944,17673826,2007
GA,water transport and terminals,734,3606862,0,0,0,734,734,3606862,2007
GA,public welfare,9126,25240356,92,110615,7592,9169,9218,25350971,2007
GA,health,5139,16486239,225,310468,24424,5277,5364,16796707,2007
GA,hospitals,7038,18361154,153,442092,15391,7124,7191,18803246,2007
GA,social insurance administration,2083,6226161,143,196664,12435,2153,2226,6422825,2007
GA,parks and recreation,1242,3139730,1981,2593747,247788,2642,3223,5733477,2007
GA,natural resources,4043,12676865,886,865910,68724,4432,4929,13542775,2007
GA,education - higher education instructional,12596,75240894,15698,17790807,844381,17367,28294,93031701,2007
GA,education - higher education other,27260,105199735,19931,13963020,1170702,33876,47191,119162755,2007
GA,education - other,2955,11738423,464,1178174,52279,3249,3419,12916597,2007
GA,other and unallocable,3378,11806833,557,173395,14374,3459,3935,11980228,2007
HI,total,51289,204192548,19120,20656643,1047925,57210,70409,224849191,2007
HI,financial administration,731,2696940,1,3884,120,732,732,2700824,2007
HI,other government administration,666,2588690,155,271911,13693,743,821,2860601,2007
HI,judicial and legal,2385,10342714,72,152278,5006,2413,2457,10494992,2007
HI,corrections,2357,10591240,10,41934,946,2362,2367,10633174,2007
HI,highways,842,3639538,6,4978,466,845,848,3644516,2007
HI,air transportation,990,3565934,9,12734,686,994,999,3578668,2007
HI,water transport and terminals,208,806788,0,0,0,208,208,806788,2007
HI,public welfare,920,3402414,31,31338,3730,941,951,3433752,2007
HI,health,2499,9988570,81,190702,6912,2538,2580,10179272,2007
HI,hospitals,3984,15798360,588,1728794,57502,4309,4572,17527154,2007
HI,social insurance administration,238,953806,4,11252,360,240,242,965058,2007
HI,parks and recreation,141,480136,519,83888,6212,176,660,564024,2007
HI,natural resources,1049,4610496,289,250010,16922,1145,1338,4860506,2007
HI,education - elementary and secondary instructional,19140,74734192,6149,6197846,299128,20830,25289,80932038,2007
HI,education - elementary and secondary other,4576,12140146,4295,2868892,208482,5754,8871,15009038,2007
HI,education - higher education instructional,2717,16842386,1680,4500502,138776,3501,4397,21342888,2007
HI,education - higher education other,3897,15847174,4891,3985906,262982,5383,8788,19833080,2007
HI,education - other,133,497032,2,4450,160,134,135,501482,2007
HI,libraries,473,1520730,305,269144,22654,601,778,1789874,2007
HI,other and unallocable,3343,13145262,33,46200,3188,3361,3376,13191462,2007
ID,total,18407,73179071,10006,10002564,669337,22190,28413,83181635,2007
ID,financial administration,1228,4963342,167,181947,19372,1337,1395,5145289,2007
ID,other government administration,149,774162,218,473034,21889,272,367,1247196,2007
ID,judicial and legal,450,3313446,21,66723,1603,459,471,3380169,2007
ID,police protection - officers,275,1121905,0,0,0,275,275,1121905,2007
ID,police protection - other,199,659205,23,21868,2241,212,222,681073,2007
ID,corrections,1862,6736162,38,81610,5287,1892,1900,6817772,2007
ID,highways,1491,5148318,138,216795,17989,1593,1629,5365113,2007
ID,public welfare,1527,5045693,166,272670,23156,1659,1693,5318363,2007
ID,health,1056,4268231,172,323140,15755,1145,1228,4591371,2007
ID,hospitals,752,2213431,134,96384,8196,798,886,2309815,2007
ID,social insurance administration,465,2150374,231,571617,39752,690,696,2721991,2007
ID,parks and recreation,207,649169,71,67917,6460,243,278,717086,2007
ID,natural resources,1643,7001887,671,1077883,76541,2076,2314,8079770,2007
ID,education - higher education instructional,2120,10594281,1912,2395329,103189,2703,4032,12989610,2007
ID,education - higher education other,3643,12891968,5557,3704504,285787,5258,9200,16596472,2007
ID,education - other,379,1779311,156,226721,22909,509,535,2006032,2007
ID,liquor stores,135,454598,138,128448,12215,204,273,583046,2007
ID,other and unallocable,826,3413588,193,95974,6996,865,1019,3509562,2007
IL,total,105471,506505069,46550,49678771,3378479,125015,152021,556183840,2007
IL,financial administration,5197,24280370,316,543195,34170,5404,5513,24823565,2007
IL,other government administration,2441,12108978,43,76369,3091,2460,2484,12185347,2007
IL,judicial and legal,2570,19571461,56,148468,4072,2594,2626,19719929,2007
IL,police protection - officers,2281,14149576,0,0,0,2281,2281,14149576,2007
IL,police protection - other,1671,7756990,1,1964,120,1672,1672,7758954,2007
IL,corrections,12060,56180764,7,30050,662,12064,12067,56210814,2007
IL,highways,5915,33904474,1178,4715507,79181,6392,7093,38619981,2007
IL,water transport and terminals,68,352352,0,0,0,68,68,352352,2007
IL,public welfare,9766,44481684,45,125232,4376,9792,9811,44606916,2007
IL,health,2640,12788509,16,51331,1272,2648,2656,12839840,2007
IL,hospitals,10094,45835941,630,1845843,68836,10486,10724,47681784,2007
IL,social insurance administration,2016,9400400,187,570392,25746,2171,2203,9970792,2007
IL,parks and recreation,554,2168736,35,76186,3852,577,589,2244922,2007
IL,natural resources,2739,12055018,1036,1461386,145211,3562,3775,13516404,2007
IL,education - higher education instructional,11613,70195889,15286,19545471,695209,15697,26899,89741360,2007
IL,education - higher education other,25144,100305031,27484,19984535,2289431,38306,52628,120289566,2007
IL,education - other,2076,10049600,35,56732,2330,2089,2111,10106332,2007
IL,other and unallocable,6626,30919296,195,446110,20920,6752,6821,31365406,2007
IN,total,76796,288119881,36778,28964862,2193245,89558,113574,317084743,2007
IN,financial administration,2869,10427824,37,40096,2784,2887,2906,10467920,2007
IN,other government administration,505,2108709,322,528402,33302,705,827,2637111,2007
IN,judicial and legal,1311,8171816,48,61741,3545,1333,1359,8233557,2007
IN,police protection - officers,1114,4617040,0,0,0,1114,1114,4617040,2007
IN,police protection - other,767,2182887,1,1674,100,768,768,2184561,2007
IN,corrections,7337,21220474,4,4271,432,7340,7341,21224745,2007
IN,highways,4352,13139297,20,23586,2159,4365,4372,13162883,2007
IN,water transport and terminals,28,136509,1,487,24,28,29,136996,2007
IN,public welfare,4523,13082627,119,54723,4529,4550,4642,13137350,2007
IN,health,1871,6885809,13,26369,1056,1877,1884,6912178,2007
IN,hospitals,2526,7422327,55,60548,4663,2554,2581,7482875,2007
IN,social insurance administration,1158,3478302,152,166294,15584,1252,1310,3644596,2007
IN,parks and recreation,130,423075,41,40503,3775,152,171,463578,2007
IN,natural resources,2400,7907186,699,717230,63363,2773,3099,8624416,2007
IN,education - higher education instructional,17345,92100602,11533,14160529,817266,22083,28878,106261131,2007
IN,education - higher education other,25542,84364909,23516,12955784,1231067,32700,49058,97320693,2007
IN,education - other,1159,4085509,132,59698,5867,1195,1291,4145207,2007
IN,other and unallocable,1859,6364979,85,62927,3729,1882,1944,6427906,2007
IA,total,41699,205435521,24045,33867438,2075341,53427,65744,239302959,2007
IA,financial administration,1147,4988744,58,114697,7762,1190,1205,5103441,2007
IA,other government administration,347,1693245,294,653262,37004,556,641,2346507,2007
IA,judicial and legal,2258,10839120,156,342769,18335,2361,2414,11181889,2007
IA,police protection - officers,647,3415660,0,0,0,647,647,3415660,2007
IA,police protection - other,317,1395110,2,770,55,317,319,1395880,2007
IA,corrections,3085,13099252,193,498082,22649,3213,3278,13597334,2007
IA,highways,2423,10454123,0,0,0,2423,2423,10454123,2007
IA,public welfare,3008,12042452,63,151205,7363,3050,3071,12193657,2007
IA,health,401,2003991,67,96942,4931,429,468,2100933,2007
IA,hospitals,5945,32847044,2783,5796979,250177,7359,8728,38644023,2007
IA,social insurance administration,676,2857378,4,6408,566,679,680,2863786,2007
IA,parks and recreation,110,554908,10,13490,1348,118,120,568398,2007
IA,natural resources,1688,7983213,388,445845,41837,1925,2076,8429058,2007
IA,education - higher education instructional,3648,31056296,6961,16448679,821655,8291,10609,47504975,2007
IA,education - higher education other,12306,53242191,12587,8507854,817349,16924,24893,61750045,2007
IA,education - other,1070,4926453,115,171364,8570,1120,1185,5097817,2007
IA,other and unallocable,2623,12036341,364,619092,35740,2825,2987,12655433,2007
KS,total,39439,148001655,16872,15012525,1001851,45098,56311,163014180,2007
KS,financial administration,1946,6448053,77,83911,4991,1974,2023,6531964,2007
KS,other government administration,516,1549691,211,569036,26420,665,727,2118727,2007
KS,judicial and legal,2060,7802047,205,194226,13749,2138,2265,7996273,2007
KS,police protection - officers,635,2964652,0,0,0,635,635,2964652,2007
KS,police protection - other,508,1639779,12,16594,1041,514,520,1656373,2007
KS,corrections,3588,10499707,21,29316,1515,3596,3609,10529023,2007
KS,highways,3391,10791211,118,151346,10918,3452,3509,10942557,2007
KS,public welfare,2415,6961823,87,100420,8500,2464,2502,7062243,2007
KS,health,1168,4362677,33,69673,2498,1182,1201,4432350,2007
KS,hospitals,3100,8848642,425,228002,10609,3162,3525,9076644,2007
KS,social insurance administration,104,324231,2,644,66,104,106,324875,2007
KS,parks and recreation,569,1485184,17,7820,735,573,586,1493004,2007
KS,natural resources,804,2940917,99,78667,7229,846,903,3019584,2007
KS,education - higher education instructional,4534,32111706,3630,5604805,247402,5931,8164,37716511,2007
KS,education - higher education other,10338,35992598,11559,7460100,645764,13987,21897,43452698,2007
KS,education - other,657,2399711,74,97371,3556,677,731,2497082,2007
KS,other and unallocable,3106,10879026,302,320594,16858,3198,3408,11199620,2007
KY,total,72416,261314705,26249,21182754,1339035,80307,98665,282497459,2007
KY,financial administration,2750,10319683,6,10392,506,2753,2756,10330075,2007
KY,other government administration,981,4625096,404,784932,28907,1155,1385,5410028,2007
KY,judicial and legal,4833,16291189,699,1335989,86685,5355,5532,17627178,2007
KY,police protection - officers,1017,3744305,0,0,0,1017,1017,3744305,2007
KY,police protection - other,1373,5159127,0,0,0,1373,1373,5159127,2007
KY,corrections,4114,10960351,165,106033,2387,4128,4279,11066384,2007
KY,highways,4575,14800357,0,0,0,4575,4575,14800357,2007
KY,public welfare,6679,19998831,0,0,0,6679,6679,19998831,2007
KY,health,2170,7488272,126,187533,12688,2242,2296,7675805,2007
KY,hospitals,4658,16797244,316,893723,42265,4897,4974,17690967,2007
KY,social insurance administration,1017,3136166,0,0,0,1017,1017,3136166,2007
KY,parks and recreation,1390,3188410,148,135558,17224,1494,1538,3323968,2007
KY,natural resources,3363,10911473,1033,815228,104426,3965,4396,11726701,2007
KY,education - higher education instructional,9390,58140051,6843,10971829,506683,12377,16233,69111880,2007
KY,education - higher education other,17518,52390681,16293,5701079,525948,20623,33811,58091760,2007
KY,education - other,2681,10425975,146,161216,7507,2726,2827,10587191,2007
KY,other and unallocable,3907,12937494,70,79242,3809,3931,3977,13016736,2007
LA,total,77597,284240410,21699,16688532,1232326,84593,99296,300928942,2007
LA,financial administration,2532,8731775,117,126237,10344,2591,2649,8858012,2007
LA,other government administration,1976,8035366,470,510910,31005,2168,2446,8546276,2007
LA,judicial and legal,1463,5477224,84,45259,3708,1484,1547,5522483,2007
LA,police protection - officers,1173,6161755,0,0,0,1173,1173,6161755,2007
LA,police protection - other,549,1808741,15,11424,952,554,564,1820165,2007
LA,corrections,7089,23718733,182,183211,17714,7189,7271,23901944,2007
LA,highways,4906,11163270,7,7046,637,4910,4913,11170316,2007
LA,water transport and terminals,260,1140362,1,2200,170,261,261,1142562,2007
LA,public welfare,5164,16595032,131,76908,3135,5182,5295,16671940,2007
LA,health,3701,14221633,112,118068,7709,3745,3813,14339701,2007
LA,hospitals,13272,44329562,1448,1187024,106519,13873,14720,45516586,2007
LA,social insurance administration,896,3046302,65,84351,7463,938,961,3130653,2007
LA,parks and recreation,928,2642004,177,140870,17178,1026,1105,2782874,2007
LA,natural resources,4197,15369069,751,616382,57505,4521,4948,15985451,2007
LA,education - elementary and secondary instructional,1013,3306089,12,16370,531,1016,1025,3322459,2007
LA,education - elementary and secondary other,159,602671,3,14345,399,161,162,617016,2007
LA,education - higher education instructional,7255,45022888,4779,6873293,364872,9317,12034,51896181,2007
LA,education - higher education other,14925,49946762,12450,5746449,547621,18036,27375,55693211,2007
LA,education - other,3330,12404997,640,722626,37795,3541,3970,13127623,2007
LA,other and unallocable,2809,10516175,255,205559,17069,2907,3064,10721734,2007
ME,total,20714,79507770,8186,7513798,381259,22870,28900,87021568,2007
ME,financial administration,1372,4721552,86,167059,10001,1429,1458,4888611,2007
ME,other government administration,361,1614766,217,501583,25679,506,578,2116349,2007
ME,judicial and legal,725,3246124,68,135789,6153,760,793,3381913,2007
ME,police protection - officers,337,1878446,18,33091,984,343,355,1911537,2007
ME,police protection - other,190,629469,6,8852,443,193,196,638321,2007
ME,corrections,1267,5114691,56,110337,6104,1302,1323,5225028,2007
ME,highways,2378,8735649,95,149062,9398,2431,2473,8884711,2007
ME,water transport and terminals,71,226656,11,18738,1328,79,82,245394,2007
ME,public welfare,3124,10500094,103,216607,10696,3184,3227,10716701,2007
ME,health,1227,4834344,60,155440,6788,1265,1287,4989784,2007
ME,hospitals,604,2354689,54,125112,5785,637,658,2479801,2007
ME,social insurance administration,348,1220702,19,37194,2013,359,367,1257896,2007
ME,parks and recreation,148,524355,31,42860,2646,163,179,567215,2007
ME,natural resources,1058,4191598,217,327687,14568,1140,1275,4519285,2007
ME,education - elementary and secondary instructional,23,98047,24,17406,1291,30,47,115453,2007
ME,education - elementary and secondary other,9,21673,25,25904,3015,26,34,47577,2007
ME,education - higher education instructional,1731,9138902,647,842085,32177,1913,2378,9980987,2007
ME,education - higher education other,3869,13100850,6334,4328093,228632,5161,10203,17428943,2007
ME,education - other,258,964080,16,31939,1813,268,274,996019,2007
ME,liquor stores,1,3615,0,0,0,1,1,3615,2007
ME,other and unallocable,1613,6387468,99,238960,11745,1680,1712,6626428,2007
MD,total,83256,363909600,12219,27211619,1253281,90333,95475,391121219,2007
MD,financial administration,3478,14225244,126,275684,14815,3561,3604,14500928,2007
MD,other government administration,1422,7292810,282,530284,15908,1511,1704,7823094,2007
MD,judicial and legal,4607,23681524,469,971941,61157,4952,5076,24653465,2007
MD,police protection - officers,1549,8182292,0,0,0,1549,1549,8182292,2007
MD,police protection - other,819,2916839,30,79277,4658,845,849,2996116,2007
MD,corrections,11892,47899381,319,719331,48910,12169,12211,48618712,2007
MD,highways,4702,19391338,0,0,0,4702,4702,19391338,2007
MD,air transportation,524,2405268,0,0,0,524,524,2405268,2007
MD,water transport and terminals,291,1492033,0,0,0,291,291,1492033,2007
MD,public welfare,6737,24946740,112,258641,15983,6828,6849,25205381,2007
MD,health,6381,26345282,788,1430697,85553,6865,7169,27775979,2007
MD,hospitals,4637,17255179,564,900897,52259,4931,5201,18156076,2007
MD,social insurance administration,828,3083407,168,364309,25583,973,996,3447716,2007
MD,parks and recreation,317,1344959,134,213286,20039,430,451,1558245,2007
MD,natural resources,1638,7143694,218,424005,25136,1780,1856,7567699,2007
MD,transit,2099,9905604,248,413626,28930,2262,2347,10319230,2007
MD,education - higher education instructional,7077,46579545,3485,13320705,408706,9386,10562,59900250,2007
MD,education - higher education other,14975,59239511,4358,5394696,346977,16935,19333,64634207,2007
MD,education - other,2060,9418536,299,713207,34273,2253,2359,10131743,2007
MD,other and unallocable,7223,31160414,619,1201033,64394,7586,7842,32361447,2007
MA,total,84603,402542297,31423,47766519,1946569,96109,116026,450308816,2007
MA,financial administration,3801,18544300,313,1015573,21280,3930,4114,19559873,2007
MA,other government administration,1710,5884087,288,1158424,26949,1864,1998,7042511,2007
MA,judicial and legal,9665,46973401,430,1431901,44240,9931,10095,48405302,2007
MA,police protection - officers,5699,30182870,99,208141,5936,5734,5798,30391011,2007
MA,police protection - other,650,2661512,7,23592,620,654,657,2685104,2007
MA,corrections,5947,26823819,72,200491,3686,5968,6019,27024310,2007
MA,highways,3509,18081355,213,656761,25735,3656,3722,18738116,2007
MA,air transportation,1107,7138709,158,276104,11954,1175,1265,7414813,2007
MA,water transport and terminals,159,901572,7,11641,735,163,166,913213,2007
MA,public welfare,6673,30439542,628,1739190,36740,6895,7301,32178732,2007
MA,health,6913,30193474,1228,2833609,105605,7549,8141,33027083,2007
MA,hospitals,7098,27880755,840,2099111,79430,7553,7938,29979866,2007
MA,social insurance administration,1389,6272849,51,182846,6294,1427,1440,6455695,2007
MA,sewerage,853,4996076,37,161047,3725,874,890,5157123,2007
MA,parks and recreation,515,1982367,48,65359,3299,534,563,2047726,2007
MA,natural resources,1315,6682922,160,532040,19342,1431,1475,7214962,2007
MA,water transport and terminals,464,2612763,21,72924,1988,475,485,2685687,2007
MA,education - elementary and secondary instructional,59,275016,0,0,0,59,59,275016,2007
MA,education - elementary and secondary other,36,133359,10,4445,345,38,46,137804,2007
MA,education - higher education instructional,6033,36795424,10423,17105171,532199,9215,16456,53900595,2007
MA,education - higher education other,15234,67805922,15932,16580635,982088,21002,31166,84386557,2007
MA,education - other,1033,5380906,75,249626,8210,1083,1108,5630532,2007
MA,other and unallocable,4741,23899297,383,1157888,26169,4899,5124,25057185,2007
MI,total,118667,554353242,63987,73470298,4623451,144807,182654,627823540,2007
MI,financial administration,4050,19446631,751,2021737,94949,4587,4801,21468368,2007
MI,other government administration,1485,6389706,16,67137,1846,1495,1501,6456843,2007
MI,judicial and legal,1500,9952254,64,205687,7211,1541,1564,10157941,2007
MI,police protection - officers,1944,8362122,0,0,0,1944,1944,8362122,2007
MI,police protection - other,775,2717316,40,64139,2011,786,815,2781455,2007
MI,corrections,16828,76756834,222,934753,33002,17014,17050,77691587,2007
MI,highways,2747,12998693,306,852087,40175,2974,3053,13850780,2007
MI,public welfare,9753,42822736,510,1894797,78384,10196,10263,44717533,2007
MI,health,1913,9026450,279,521080,24469,2051,2192,9547530,2007
MI,hospitals,13171,46795684,5843,18151863,832245,17873,19014,64947547,2007
MI,social insurance administration,974,4184985,41,85409,4669,1000,1015,4270394,2007
MI,parks and recreation,210,861538,101,292921,11451,275,311,1154459,2007
MI,natural resources,4005,18144976,1078,1508984,97075,4553,5083,19653960,2007
MI,education - elementary and secondary instructional,658,2092453,171,215216,14008,739,829,2307669,2007
MI,education - elementary and secondary other,162,416194,81,80033,6172,197,243,496227,2007
MI,education - higher education instructional,17689,116071907,10148,16227666,714557,21743,27837,132299573,2007
MI,education - higher education other,34099,148684797,43770,28874074,2593196,48750,77869,177558871,2007
MI,education - other,1163,5464420,283,992740,44109,1412,1446,6457160,2007
MI,other and unallocable,5541,23163546,283,479975,23922,5677,5824,23643521,2007
MN,total,64793,311542001,29995,41381170,2384525,78266,94788,352923171,2007
MN,financial administration,2427,10964526,97,213992,15462,2515,2524,11178518,2007
MN,other government administration,1002,4272731,233,536909,32086,1185,1235,4809640,2007
MN,judicial and legal,3057,14915082,475,1613352,67822,3440,3532,16528434,2007
MN,police protection - officers,535,2805505,0,0,0,535,535,2805505,2007
MN,police protection - other,416,1424333,40,86324,4504,441,456,1510657,2007
MN,corrections,3990,16044643,152,422861,21668,4112,4142,16467504,2007
MN,highways,4306,19374112,202,388263,20960,4424,4508,19762375,2007
MN,public welfare,1742,7621657,1273,2893457,219065,2980,3015,10515114,2007
MN,health,2168,10481019,262,651689,29155,2332,2430,11132708,2007
MN,hospitals,3689,16658862,1523,3895413,265005,5186,5212,20554275,2007
MN,social insurance administration,1037,4473059,94,242728,11404,1101,1131,4715787,2007
MN,sewerage,629,3543839,10,24476,1550,638,639,3568315,2007
MN,parks and recreation,525,2288074,154,201389,12850,598,679,2489463,2007
MN,natural resources,2649,11982288,711,1077184,72026,3055,3360,13059472,2007
MN,transit,2142,9685652,413,880572,48921,2418,2555,10566224,2007
MN,education - higher education instructional,10773,58846706,10316,14047300,598033,14151,21089,72894006,2007
MN,education - higher education other,17159,85192193,12648,12186527,863940,22039,29807,97378720,2007
MN,education - other,3323,15985424,1188,1574696,76976,3760,4511,17560120,2007
MN,other and unallocable,3224,14982296,204,444038,23098,3356,3428,15426334,2007
MS,total,50449,165622666,13905,11242695,951388,55824,64354,176865361,2007
MS,financial administration,1133,3823766,42,56291,4270,1156,1175,3880057,2007
MS,other government administration,454,1726325,73,89732,3580,474,527,1816057,2007
MS,judicial and legal,661,3568541,40,53049,2930,677,701,3621590,2007
MS,police protection - officers,686,2464229,0,0,0,686,686,2464229,2007
MS,police protection - other,549,1494019,0,0,0,549,549,1494019,2007
MS,corrections,3535,11475470,18,29727,2168,3547,3553,11505197,2007
MS,highways,3222,8651346,12,23508,1928,3233,3234,8674854,2007
MS,water transport and terminals,42,176089,0,0,0,42,42,176089,2007
MS,public welfare,2449,5785958,0,0,0,2449,2449,5785958,2007
MS,health,2805,8938791,79,194097,9220,2857,2884,9132888,2007
MS,hospitals,11922,33798426,403,750089,40508,12151,12325,34548515,2007
MS,social insurance administration,791,2465442,271,546297,38406,1008,1062,3011739,2007
MS,parks and recreation,357,758573,118,82254,9545,412,475,840827,2007
MS,natural resources,2900,8238394,831,658661,57462,3226,3731,8897055,2007
MS,water transport and terminals,41,113170,14,18682,1729,51,55,131852,2007
MS,education - higher education instructional,5499,28573550,1539,2261198,134989,6261,7038,30834748,2007
MS,education - higher education other,9223,30384446,10384,6377263,636318,12819,19607,36761709,2007
MS,education - other,1522,4594223,28,31782,4138,1546,1550,4626005,2007
MS,liquor stores,121,308600,0,0,0,121,121,308600,2007
MS,other and unallocable,2537,8283308,53,70065,4197,2559,2590,8353373,2007
MO,total,79579,255697106,26085,21846673,1757047,89532,105664,277543779,2007
MO,financial administration,3155,10332061,286,265661,24715,3296,3441,10597722,2007
MO,other government administration,790,2584103,308,707932,36786,1009,1098,3292035,2007
MO,judicial and legal,3378,9433606,202,231480,18126,3481,3580,9665086,2007
MO,police protection - officers,1289,5939780,0,0,0,1289,1289,5939780,2007
MO,police protection - other,1002,3026866,114,74000,8404,1049,1116,3100866,2007
MO,corrections,12303,30206078,314,283112,23224,12435,12617,30489190,2007
MO,highways,6368,22263232,338,530908,38046,6583,6706,22794140,2007
MO,public welfare,7694,18958342,513,465260,34332,7888,8207,19423602,2007
MO,health,3049,8594842,249,363226,21874,3173,3298,8958068,2007
MO,hospitals,10926,30749502,1388,1814866,122974,11621,12314,32564368,2007
MO,social insurance administration,565,1609622,7,9632,617,568,572,1619254,2007
MO,parks and recreation,566,1539106,181,86378,11322,630,747,1625484,2007
MO,natural resources,2216,7005051,593,567767,58877,2549,2809,7572818,2007
MO,education - higher education instructional,7912,43348297,7197,7798179,484790,10652,15109,51146476,2007
MO,education - higher education other,13655,45220429,13012,6523436,736999,17830,26667,51743865,2007
MO,education - other,1048,3235728,1173,1940612,121718,1736,2221,5176340,2007
MO,other and unallocable,3663,11650461,210,184224,14243,3743,3873,11834685,2007
MT,total,17013,64606120,9324,7870357,532037,20017,26337,72476477,2007
MT,financial administration,957,3093223,124,129556,11138,1022,1081,3222779,2007
MT,other government administration,498,1686237,147,227818,16708,593,645,1914055,2007
MT,judicial and legal,612,2453004,117,243338,10307,670,729,2696342,2007
MT,police protection - officers,190,672057,0,0,0,190,190,672057,2007
MT,police protection - other,223,794522,18,21939,1316,230,241,816461,2007
MT,corrections,1161,3763187,59,73593,4975,1189,1220,3836780,2007
MT,highways,2114,8323743,121,178807,10629,2174,2235,8502550,2007
MT,public welfare,1508,4928118,185,322291,21680,1630,1693,5250409,2007
MT,health,826,2770890,83,136466,8112,872,909,2907356,2007
MT,hospitals,537,1701762,109,147911,10997,599,646,1849673,2007
MT,social insurance administration,724,2672409,29,46826,2918,740,753,2719235,2007
MT,parks and recreation,65,216751,33,15806,1373,73,98,232557,2007
MT,natural resources,1360,4905835,271,296103,22770,1489,1631,5201938,2007
MT,education - higher education instructional,1646,10492918,2527,2723077,123821,2344,4173,13215995,2007
MT,education - higher education other,3173,10913397,5322,3048510,268487,4689,8495,13961907,2007
MT,education - other,312,1141733,93,133692,9199,364,405,1275425,2007
MT,liquor stores,21,63090,4,5037,410,23,25,68127,2007
MT,other and unallocable,1086,4013244,82,119587,7197,1126,1168,4132831,2007
NE,total,27156,95653882,10839,9811845,939567,32465,37995,105465727,2007
NE,financial administration,761,2468666,14,15808,1226,767,775,2484474,2007
NE,other government administration,275,1068143,100,103537,6996,315,375,1171680,2007
NE,judicial and legal,721,3200176,73,61995,4828,748,794,3262171,2007
NE,police protection - officers,500,2253083,0,0,0,500,500,2253083,2007
NE,police protection - other,259,763089,32,36077,3024,276,291,799166,2007
NE,corrections,2824,8454736,94,112934,9332,2877,2918,8567670,2007
NE,highways,2155,6935397,9,18325,1041,2161,2164,6953722,2007
NE,air transportation,26,94648,0,0,0,26,26,94648,2007
NE,public welfare,2492,6865559,209,273498,18864,2599,2701,7139057,2007
NE,health,660,2364429,71,137516,9130,712,731,2501945,2007
NE,hospitals,3416,11041745,887,1544897,115457,4068,4303,12586642,2007
NE,social insurance administration,313,1071233,5,6883,399,315,318,1078116,2007
NE,parks and recreation,238,682720,145,128764,15948,328,383,811484,2007
NE,natural resources,1583,5001217,774,1273042,104294,2173,2357,6274259,2007
NE,education - higher education instructional,2789,16146234,1103,1689612,94578,3324,3892,17835846,2007
NE,education - higher education other,5979,19118903,7116,4284918,545884,9064,13095,23403821,2007
NE,education - other,535,2076313,62,31401,3047,552,597,2107714,2007
NE,other and unallocable,1630,6047591,145,92638,5519,1660,1775,6140229,2007
NV,total,25336,117986180,10283,10953053,560600,28506,35619,128939233,2007
NV,financial administration,1440,5375228,28,43536,1348,1447,1468,5418764,2007
NV,other government administration,1339,6245512,18,25988,1051,1345,1357,6271500,2007
NV,judicial and legal,639,3947285,28,66874,1308,647,667,4014159,2007
NV,police protection - officers,425,2812041,0,0,0,425,425,2812041,2007
NV,police protection - other,371,1642000,0,0,0,371,371,1642000,2007
NV,corrections,3765,17222387,56,175267,3726,3786,3821,17397654,2007
NV,highways,1746,7626302,6,7173,571,1749,1752,7633475,2007
NV,public welfare,1588,6023776,15,27474,999,1594,1603,6051250,2007
NV,health,1254,5524632,40,98027,2791,1269,1294,5622659,2007
NV,hospitals,1333,6072991,106,300663,9075,1384,1439,6373654,2007
NV,social insurance administration,406,1627128,1,1255,46,406,407,1628383,2007
NV,parks and recreation,191,781491,9,17889,620,195,200,799380,2007
NV,natural resources,964,4352793,100,126057,3734,986,1064,4478850,2007
NV,water transport and terminals,16,99415,1,1242,53,16,17,100657,2007
NV,electric power,16,99415,1,1242,53,16,17,100657,2007
NV,education - higher education instructional,2234,15621290,4138,5809693,249813,3646,6372,21430983,2007
NV,education - higher education other,5337,22407167,5657,4137461,280620,6923,10994,26544628,2007
NV,education - other,132,643016,2,3950,95,133,134,646966,2007
NV,other and unallocable,2140,9862311,77,109262,4697,2168,2217,9971573,2007
NH,total,16090,65140358,9151,9842817,581853,19588,25241,74983175,2007
NH,financial administration,898,3469880,68,87270,6691,937,966,3557150,2007
NH,other government administration,322,1168912,96,113210,8180,370,418,1282122,2007
NH,judicial and legal,939,3563626,7,18427,815,944,946,3582053,2007
NH,police protection - officers,289,1494922,0,0,0,289,289,1494922,2007
NH,police protection - other,150,539760,15,25984,1488,159,165,565744,2007
NH,corrections,1320,5263309,66,99881,6303,1358,1386,5363190,2007
NH,highways,1687,6101509,264,310651,23455,1828,1951,6412160,2007
NH,air transportation,27,126238,18,8163,573,30,45,134401,2007
NH,water transport and terminals,7,32329,6,5508,531,10,13,37837,2007
NH,public welfare,1472,4812491,85,118986,6703,1511,1557,4931477,2007
NH,health,923,3608254,81,96271,6732,963,1004,3704525,2007
NH,hospitals,757,2522745,78,141862,1906,768,835,2664607,2007
NH,social insurance administration,316,994445,38,50968,3113,335,354,1045413,2007
NH,parks and recreation,79,246735,212,152418,16975,181,291,399153,2007
NH,natural resources,359,1443369,109,102494,7793,406,468,1545863,2007
NH,water transport and terminals,25,115558,2,3540,182,26,27,119098,2007
NH,education - higher education instructional,1477,9882435,2081,3807004,143889,2342,3558,13689439,2007
NH,education - higher education other,2612,10871305,5077,3968143,277546,4284,7689,14839448,2007
NH,education - other,308,1131442,21,30579,1948,320,329,1162021,2007
NH,liquor stores,298,960274,442,311273,36208,516,740,1271547,2007
NH,other and unallocable,1825,6790820,385,390185,30822,2011,2210,7181005,2007
NJ,total,143425,770878093,34548,40785190,2015746,155685,177973,811663283,2007
NJ,financial administration,6229,27963098,617,1058934,74282,6649,6846,29022032,2007
NJ,other government administration,1321,7071806,29,40253,2161,1333,1350,7112059,2007
NJ,judicial and legal,14349,75026697,243,338651,20053,14462,14592,75365348,2007
NJ,police protection - officers,2934,22776817,0,0,0,2934,2934,22776817,2007
NJ,police protection - other,1642,6571041,35,71371,2883,1658,1677,6642412,2007
NJ,corrections,10164,55441870,14,27006,1007,10170,10178,55468876,2007
NJ,highways,6741,34003060,920,1197863,86490,7230,7661,35200923,2007
NJ,water transport and terminals,131,610702,6,8818,647,135,137,619520,2007
NJ,public welfare,9168,42317287,267,491422,27509,9323,9435,42808709,2007
NJ,health,4252,22993643,414,1178900,18244,4361,4666,24172543,2007
NJ,hospitals,17089,72821584,2544,4890440,253655,18529,19633,77712024,2007
NJ,social insurance administration,1845,8184438,75,131695,7536,1888,1920,8316133,2007
NJ,solid waste management,600,3711793,1,206,27,600,601,3711999,2007
NJ,parks and recreation,1288,6096023,1631,2541067,152564,2203,2919,8637090,2007
NJ,natural resources,2258,11924330,514,725140,27560,2421,2772,12649470,2007
NJ,water transport and terminals,124,570678,2,2205,115,125,126,572883,2007
NJ,transit,10014,51319490,827,1413147,84161,10489,10841,52732637,2007
NJ,education - elementary and secondary instructional,13155,90703321,2143,2570526,98524,13825,15298,93273847,2007
NJ,education - elementary and secondary other,4555,15969109,2539,2417344,164789,5687,7094,18386453,2007
NJ,education - higher education instructional,7423,72424380,6521,10427792,247470,8949,13944,82852172,2007
NJ,education - higher education other,18132,88538270,14514,10360945,687173,22369,32646,98899215,2007
NJ,education - other,2992,15576761,468,650653,45380,3249,3460,16227414,2007
NJ,other and unallocable,7019,38261895,224,240812,13516,7096,7243,38502707,2007
NM,total,45276,161948679,14566,17161568,1233799,52255,59842,179110247,2007
NM,financial administration,1644,5968463,4,7269,469,1647,1648,5975732,2007
NM,other government administration,217,1052012,481,1475805,68208,602,698,2527817,2007
NM,judicial and legal,2996,11334240,131,224043,12857,3070,3127,11558283,2007
NM,police protection - officers,541,2429978,0,0,0,541,541,2429978,2007
NM,police protection - other,149,1108689,0,0,0,149,149,1108689,2007
NM,corrections,3962,13409421,15,35674,1523,3971,3977,13445095,2007
NM,highways,2571,8291182,0,0,0,2571,2571,8291182,2007
NM,air transportation,10,40273,0,0,0,10,10,40273,2007
NM,public welfare,1936,5506552,3,2061,266,1938,1939,5508613,2007
NM,health,2377,8920882,16,30463,1946,2389,2393,8951345,2007
NM,hospitals,9020,33199987,1596,4143129,245331,10407,10616,37343116,2007
NM,social insurance administration,261,816867,3,6783,355,264,264,823650,2007
NM,parks and recreation,833,2527390,40,73407,4074,856,873,2600797,2007
NM,natural resources,1111,4464207,43,42504,2872,1128,1154,4506711,2007
NM,education - higher education instructional,3344,13446989,3792,4930075,223525,4606,7136,18377064,2007
NM,education - higher education other,10799,36631679,8379,6096544,665590,14559,19178,42728223,2007
NM,education - other,1179,4275979,48,61419,4606,1207,1227,4337398,2007
NM,other and unallocable,2326,8523889,15,32392,2177,2340,2341,8556281,2007
NY,total,236719,1161864825,48343,63716376,2814629,253354,285062,1225581201,2007
NY,financial administration,12419,54570094,174,319959,12746,12493,12593,54890053,2007
NY,other government administration,4467,19030440,541,634789,42274,4706,5008,19665229,2007
NY,judicial and legal,19886,119711032,722,2290992,95368,20425,20608,122002024,2007
NY,police protection - officers,4676,40553685,0,0,0,4676,4676,40553685,2007
NY,police protection - other,1649,6435022,155,265215,17276,1747,1804,6700237,2007
NY,corrections,34095,160286516,464,1223631,48102,34368,34559,161510147,2007
NY,highways,12373,56992239,1004,1186683,74187,12792,13377,58178922,2007
NY,air transportation,150,602356,4,9429,292,152,154,611785,2007
NY,water transport and terminals,746,3734539,18,39841,1731,755,764,3774380,2007
NY,public welfare,6075,26697354,556,1265466,70170,6472,6631,27962820,2007
NY,health,9475,48282544,398,1151492,44170,9728,9873,49434036,2007
NY,hospitals,42164,185097448,5512,13543721,560593,45376,47676,198641169,2007
NY,social insurance administration,7079,31763629,101,269972,13807,7158,7180,32033601,2007
NY,parks and recreation,1818,9703117,1234,2265133,136584,2589,3052,11968250,2007
NY,natural resources,3494,16902712,88,160287,7556,3537,3582,17062999,2007
NY,electric power,1680,12264189,48,150869,5024,1708,1728,12415058,2007
NY,transit,15639,93549573,257,447864,31936,15820,15896,93997437,2007
NY,education - higher education instructional,16456,96830939,15536,17743133,593405,20019,31992,114574072,2007
NY,education - higher education other,24672,94793967,21038,19565824,1010766,30846,45710,114359791,2007
NY,education - other,4539,20542046,191,382722,17998,4641,4730,20924768,2007
NY,other and unallocable,13167,63521384,302,799354,30644,13346,13469,64320738,2007
NC,total,127386,474144534,39205,45970141,2760691,142985,166591,520114675,2007
NC,financial administration,4062,14509121,47,106545,4059,4084,4109,14615666,2007
NC,other government administration,781,3681041,419,769050,42936,1023,1200,4450091,2007
NC,judicial and legal,6583,27968986,50,83384,4660,6609,6633,28052370,2007
NC,police protection - officers,2474,11117132,0,0,0,2474,2474,11117132,2007
NC,police protection - other,1317,4178379,12,26500,1070,1323,1329,4204879,2007
NC,corrections,21070,63047793,628,1462621,65718,21441,21698,64510414,2007
NC,highways,11135,35685595,17,27177,1654,11144,11152,35712772,2007
NC,water transport and terminals,302,1170108,2,1457,100,303,304,1171565,2007
NC,public welfare,2090,8105634,6,6661,314,2092,2096,8112295,2007
NC,health,4931,18778350,158,319343,16526,5025,5089,19097693,2007
NC,hospitals,15209,51001290,2943,9655646,393069,17430,18152,60656936,2007
NC,social insurance administration,2216,8346115,219,375405,24227,2353,2435,8721520,2007
NC,solid waste management,311,1151773,7,9836,1200,318,318,1161609,2007
NC,parks and recreation,1082,3313694,174,136236,13194,1157,1256,3449930,2007
NC,natural resources,4011,13518557,710,776166,45148,4266,4721,14294723,2007
NC,education - higher education instructional,13306,81667800,11515,15033647,657402,17021,24821,96701447,2007
NC,education - higher education other,28593,95860761,22051,16665382,1468793,36891,50644,112526143,2007
NC,education - other,2937,11203084,168,373281,13037,3011,3105,11576365,2007
NC,other and unallocable,4976,19839321,79,141804,7584,5020,5055,19981125,2007
ND,total,14597,49765898,9631,8723504,588818,17918,24228,58489402,2007
ND,financial administration,620,2035733,33,35516,1941,631,653,2071249,2007
ND,other government administration,201,653702,241,804752,23496,333,442,1458454,2007
ND,judicial and legal,521,2059477,45,30023,1772,531,566,2089500,2007
ND,police protection - officers,136,555456,0,0,0,136,136,555456,2007
ND,police protection - other,48,130997,9,13904,986,54,57,144901,2007
ND,corrections,660,1839573,96,141934,7022,700,756,1981507,2007
ND,highways,1092,3636480,3,3945,264,1093,1095,3640425,2007
ND,public welfare,421,1259175,75,113836,9003,472,496,1373011,2007
ND,health,1162,3616467,124,154359,9432,1215,1286,3770826,2007
ND,hospitals,946,2574429,52,79059,3016,963,998,2653488,2007
ND,social insurance administration,378,1178363,35,38158,2925,395,413,1216521,2007
ND,parks and recreation,128,321392,14,21884,1330,136,142,343276,2007
ND,natural resources,1086,4105761,609,607762,103194,1670,1695,4713523,2007
ND,education - higher education instructional,1976,10163708,2357,3852620,203190,3123,4333,14016328,2007
ND,education - higher education other,3662,10090344,5720,2605087,207374,4833,9382,12695431,2007
ND,education - other,273,877506,43,49601,2461,285,316,927107,2007
ND,other and unallocable,1287,4667335,175,171064,11412,1348,1462,4838399,2007
OH,total,119147,531297069,70532,66598438,4252461,143206,189679,597895507,2007
OH,financial administration,7898,37292566,445,884255,52986,8199,8343,38176821,2007
OH,other government administration,875,3892813,134,105157,9619,930,1009,3997970,2007
OH,judicial and legal,2494,12814765,532,1376619,44774,2748,3026,14191384,2007
OH,police protection - officers,1487,7984578,0,0,0,1487,1487,7984578,2007
OH,police protection - other,1217,4689356,10,21657,1313,1224,1227,4711013,2007
OH,corrections,16679,65654465,84,127545,8207,16725,16763,65782010,2007
OH,highways,6924,29845097,603,751097,52570,7221,7527,30596194,2007
OH,public welfare,2794,14390086,238,343903,32909,2980,3032,14733989,2007
OH,health,3570,17895820,264,478818,27044,3723,3834,18374638,2007
OH,hospitals,14035,60058457,2982,5453705,253788,15469,17017,65512162,2007
OH,social insurance administration,2230,8759532,230,194192,11896,2297,2460,8953724,2007
OH,parks and recreation,468,1819443,299,395992,29871,637,767,2215435,2007
OH,natural resources,2842,10508936,279,339107,22439,2968,3121,10848043,2007
OH,education - higher education instructional,15191,105675189,19469,25030283,1105233,21456,34660,130705472,2007
OH,education - higher education other,33447,116410937,44075,29849394,2538761,47800,77522,146260331,2007
OH,education - other,2485,11530635,364,561219,25598,2629,2849,12091854,2007
OH,other and unallocable,4511,22074394,524,685495,35453,4713,5035,22759889,2007
OK,total,62198,223552048,24015,19693718,1371570,69961,86213,243245766,2007
OK,financial administration,1718,6169491,36,49944,2144,1731,1754,6219435,2007
OK,other government administration,770,2844447,145,248746,17899,871,915,3093193,2007
OK,judicial and legal,2733,11616582,117,144315,8521,2780,2850,11760897,2007
OK,police protection - officers,974,4996961,0,0,0,974,974,4996961,2007
OK,police protection - other,887,3021106,43,48202,4440,913,930,3069308,2007
OK,corrections,5663,18301452,212,251720,16873,5758,5875,18553172,2007
OK,highways,2961,9202384,14,15773,1917,2972,2975,9218157,2007
OK,air transportation,10,47196,0,0,0,10,10,47196,2007
OK,public welfare,6506,19016696,247,239919,23022,6636,6753,19256615,2007
OK,health,5786,19653563,301,562683,28216,5945,6087,20216246,2007
OK,hospitals,2760,8172691,69,97021,6886,2797,2829,8269712,2007
OK,social insurance administration,1361,4512533,59,76299,5306,1391,1420,4588832,2007
OK,solid waste management,75,263093,9,5635,613,78,84,268728,2007
OK,parks and recreation,856,2051707,217,145649,18272,958,1073,2197356,2007
OK,natural resources,1684,5511266,841,639840,46360,1946,2525,6151106,2007
OK,electric power,539,2805622,13,24507,1513,548,552,2830129,2007
OK,education - higher education instructional,6425,37325430,6213,7930342,316845,8221,12638,45255772,2007
OK,education - higher education other,16027,52314601,15301,8985000,858359,20890,31328,61299601,2007
OK,education - other,1946,6722156,79,98263,6370,1983,2025,6820419,2007
OK,other and unallocable,2517,9003071,99,129860,8014,2559,2616,9132931,2007
OR,total,52610,213315918,20776,25487569,1241034,59619,73386,238803487,2007
OR,financial administration,3986,14771078,362,580189,38376,4203,4348,15351267,2007
OR,other government administration,1082,4383394,207,361748,18504,1188,1289,4745142,2007
OR,judicial and legal,2934,11560336,268,689475,31239,3110,3202,12249811,2007
OR,police protection - officers,672,3216695,2,3652,190,673,674,3220347,2007
OR,police protection - other,583,2114214,141,125139,5236,612,724,2239353,2007
OR,corrections,4999,18775684,123,330284,16783,5094,5122,19105968,2007
OR,highways,3554,14976314,212,796432,33202,3742,3766,15772746,2007
OR,air transportation,16,56396,0,0,0,16,16,56396,2007
OR,public welfare,6541,22733989,317,548437,25680,6685,6858,23282426,2007
OR,health,1377,5423907,178,356154,14392,1458,1555,5780061,2007
OR,hospitals,4767,18255968,2232,4392255,109579,5386,6999,22648223,2007
OR,social insurance administration,2029,9547174,113,306724,10803,2090,2142,9853898,2007
OR,parks and recreation,487,1623027,19,28119,1793,497,506,1651146,2007
OR,natural resources,2482,9337928,419,587061,37698,2694,2901,9924989,2007
OR,education - higher education instructional,7018,37567494,3818,7821046,281150,8607,10836,45388540,2007
OR,education - higher education other,7712,29715899,12040,8255233,599794,11101,19752,37971132,2007
OR,education - other,721,2817348,94,83367,5421,752,815,2900715,2007
OR,liquor stores,190,724925,15,21162,1274,197,205,746087,2007
OR,other and unallocable,1460,5714148,216,201092,9920,1514,1676,5915240,2007
PA,total,141478,585472079,50070,70613971,3188491,160177,191548,656086050,2007
PA,financial administration,7237,28932686,437,746759,57552,7584,7674,29679445,2007
PA,other government administration,3211,10862830,891,2783045,110814,3876,4102,13645875,2007
PA,judicial and legal,3006,15749423,0,0,0,3006,3006,15749423,2007
PA,police protection - officers,5052,25691232,0,0,0,5052,5052,25691232,2007
PA,police protection - other,1331,6773651,64,142528,5922,1367,1395,6916179,2007
PA,corrections,17161,65677155,449,999920,29121,17336,17610,66677075,2007
PA,highways,12915,44655493,621,1483564,78336,13379,13536,46139057,2007
PA,air transportation,45,181084,0,0,0,45,45,181084,2007
PA,water transport and terminals,172,727104,0,0,0,172,172,727104,2007
PA,public welfare,11872,43068356,288,850105,28657,12045,12160,43918461,2007
PA,health,1771,7729455,36,81823,2438,1786,1807,7811278,2007
PA,hospitals,11524,37026253,882,1662187,54880,11850,12406,38688440,2007
PA,social insurance administration,3729,14547640,655,1567262,86503,4250,4384,16114902,2007
PA,parks and recreation,850,3093108,764,1798058,98919,1446,1614,4891166,2007
PA,natural resources,5506,23481999,1524,3560902,131120,6278,7030,27042901,2007
PA,education - higher education instructional,14001,98961506,9978,26755854,621209,17552,23979,125717360,2007
PA,education - higher education other,28399,104321147,32828,26995790,1827227,39127,61227,131316937,2007
PA,education - other,4362,18194705,367,618577,20126,4477,4729,18813282,2007
PA,liquor stores,3044,9644295,0,0,0,3044,3044,9644295,2007
PA,other and unallocable,6290,26152957,286,567597,35667,6505,6576,26720554,2007
RI,total,18511,88756355,6407,6099042,318981,20435,24918,94855397,2007
RI,financial administration,1281,5977310,12,29076,987,1286,1293,6006386,2007
RI,other government administration,298,1262407,209,214614,5560,334,507,1477021,2007
RI,judicial and legal,1219,6220616,16,43104,1324,1228,1235,6263720,2007
RI,police protection - officers,217,1416147,0,0,0,217,217,1416147,2007
RI,police protection - other,92,470402,2,4804,137,93,94,475206,2007
RI,corrections,1736,8650472,5,9852,228,1737,1741,8660324,2007
RI,highways,767,3382182,16,32756,1426,775,783,3414938,2007
RI,air transportation,183,1022452,3,11263,337,185,186,1033715,2007
RI,public welfare,1586,7707071,52,114484,4085,1612,1638,7821555,2007
RI,health,1190,5871030,64,58613,1677,1200,1254,5929643,2007
RI,hospitals,1108,4517539,0,0,0,1108,1108,4517539,2007
RI,social insurance administration,473,2380716,8,20816,708,478,481,2401532,2007
RI,solid waste management,123,688625,1,1413,133,124,124,690038,2007
RI,sewerage,236,994713,0,0,0,236,236,994713,2007
RI,parks and recreation,69,229043,0,0,0,69,69,229043,2007
RI,natural resources,488,2420642,29,39803,1760,498,517,2460445,2007
RI,transit,727,3273159,46,160472,8092,773,773,3433631,2007
RI,education - elementary and secondary instructional,427,2148141,73,100663,6602,470,500,2248804,2007
RI,education - elementary and secondary other,87,271738,81,93565,8717,143,168,365303,2007
RI,education - higher education instructional,1780,10109270,2575,3281411,117511,2507,4355,13390681,2007
RI,education - higher education other,2228,9051822,3113,1701133,151052,3110,5341,10752955,2007
RI,education - other,452,2009428,56,129536,6156,492,508,2138964,2007
RI,other and unallocable,1744,8681430,46,51664,2489,1760,1790,8733094,2007
SC,total,70344,237490570,17058,14673928,986557,76213,87402,252164498,2007
SC,financial administration,3305,10747150,41,72204,2272,3319,3346,10819354,2007
SC,other government administration,586,2277656,488,501500,33315,787,1074,2779156,2007
SC,judicial and legal,700,3255880,3,5624,160,701,703,3261504,2007
SC,police protection - officers,1375,5087174,0,0,0,1375,1375,5087174,2007
SC,police protection - other,677,2115028,4,12686,244,679,681,2127714,2007
SC,corrections,7808,21426506,3,7716,180,7809,7811,21434222,2007
SC,highways,4777,13821528,7,12902,390,4779,4784,13834430,2007
SC,water transport and terminals,578,2852867,2,4723,128,579,580,2857590,2007
SC,public welfare,4325,11593270,8,16092,396,4327,4333,11609362,2007
SC,health,6183,19650156,157,410998,8972,6237,6340,20061154,2007
SC,hospitals,7359,16825331,220,530650,27313,7515,7579,17355981,2007
SC,social insurance administration,1139,3511594,0,0,0,1139,1139,3511594,2007
SC,parks and recreation,568,1566714,2,5880,278,570,570,1572594,2007
SC,natural resources,1960,6229156,262,258280,25217,2111,2222,6487436,2007
SC,water transport and terminals,10,49842,1,2597,108,11,11,52439,2007
SC,electric power,1753,8386451,14,48818,1082,1759,1767,8435269,2007
SC,education - higher education instructional,8518,48320299,6477,7105822,362685,10683,14995,55426121,2007
SC,education - higher education other,14785,45640340,9352,5647422,522995,17892,24137,51287762,2007
SC,education - other,2654,9276082,2,2150,76,2654,2656,9278232,2007
SC,other and unallocable,1284,4857546,15,27864,746,1287,1299,4885410,2007
SD,total,12150,42990783,4598,3532980,309615,13897,16748,46523763,2007
SD,financial administration,423,1510982,16,19032,1366,431,439,1530014,2007
SD,other government administration,324,1143914,21,26646,1960,335,345,1170560,2007
SD,judicial and legal,547,2127834,96,97272,7258,588,643,2225106,2007
SD,police protection - officers,189,787044,1,628,52,189,190,787672,2007
SD,police protection - other,105,302178,6,5588,644,109,111,307766,2007
SD,corrections,875,2354052,29,31930,2568,890,904,2385982,2007
SD,highways,965,3073030,56,72614,5648,997,1021,3145644,2007
SD,public welfare,1059,2961090,34,46540,3716,1080,1093,3007630,2007
SD,health,575,2001748,125,264248,13590,651,700,2265996,2007
SD,hospitals,874,2433248,141,204948,13982,953,1015,2638196,2007
SD,social insurance administration,271,714876,5,4748,362,273,276,719624,2007
SD,parks and recreation,121,364350,27,20338,2148,133,148,384688,2007
SD,natural resources,761,2571795,296,165607,18014,862,1057,2737402,2007
SD,education - higher education instructional,1425,9058022,1150,1512555,98492,1981,2575,10570577,2007
SD,education - higher education other,2458,7704691,2505,964921,131692,3202,4963,8669612,2007
SD,education - other,386,1225247,36,40899,3515,405,422,1266146,2007
SD,other and unallocable,792,2656682,54,54466,4608,818,846,2711148,2007
TN,total,76594,269219507,25205,21526389,1406367,84875,101799,290745896,2007
TN,financial administration,3510,13497702,48,65615,5212,3542,3558,13563317,2007
TN,other government administration,876,3378050,33,35500,2177,889,909,3413550,2007
TN,judicial and legal,2360,11420572,7,8586,530,2363,2367,11429158,2007
TN,police protection - officers,1121,4385938,0,0,0,1121,1121,4385938,2007
TN,police protection - other,887,2806796,13,10186,1185,893,900,2816982,2007
TN,corrections,7133,19770464,44,81510,4460,7159,7177,19851974,2007
TN,highways,4381,12715982,5,1548,166,4382,4386,12717530,2007
TN,public welfare,8201,25354878,18,26198,1676,8212,8219,25381076,2007
TN,health,3955,14949385,156,307976,15428,4044,4111,15257361,2007
TN,hospitals,7453,23094822,185,555331,27115,7607,7638,23650153,2007
TN,social insurance administration,1426,4242054,139,207746,15496,1519,1565,4449800,2007
TN,parks and recreation,1117,2494278,234,144142,18754,1230,1351,2638420,2007
TN,natural resources,3672,13527749,533,696804,62961,4040,4205,14224553,2007
TN,education - higher education instructional,8090,46085557,8931,10279318,530157,11233,17021,56364875,2007
TN,education - higher education other,17530,54943581,14134,8607741,695929,21607,31664,63551322,2007
TN,education - other,1987,6742653,622,457670,23858,2131,2609,7200323,2007
TN,other and unallocable,2895,9809046,103,40518,1263,2903,2998,9849564,2007
TX,total,259578,1004128892,74800,95352957,5465030,290451,334378,1099481849,2007
TX,financial administration,9369,35342719,167,186224,9863,9423,9536,35528943,2007
TX,other government administration,2584,9460064,539,567568,35401,2784,3123,10027632,2007
TX,judicial and legal,5437,25691560,123,604718,16623,5530,5560,26296278,2007
TX,police protection - officers,2286,10010573,0,0,0,2286,2286,10010573,2007
TX,police protection - other,1896,5735910,62,60698,4960,1924,1958,5796608,2007
TX,corrections,44745,116355804,674,797566,58550,45075,45419,117153370,2007
TX,highways,15832,54110359,706,1031451,33822,16024,16538,55141810,2007
TX,public welfare,23096,65643247,303,537171,31149,23272,23399,66180418,2007
TX,health,12258,43814193,667,1535000,53502,12563,12925,45349193,2007
TX,hospitals,32486,136331549,2740,7898187,267594,33998,35226,144229736,2007
TX,social insurance administration,3805,12817580,34,59096,3216,3823,3839,12876676,2007
TX,parks and recreation,1009,2770118,192,186227,18065,1111,1201,2956345,2007
TX,natural resources,9534,38935062,2040,4022624,164028,10460,11574,42957686,2007
TX,education - elementary and secondary instructional,15,43295,0,0,0,15,15,43295,2007
TX,education - elementary and secondary other,2,10328,4,4206,351,4,6,14534,2007
TX,education - higher education instructional,23846,183472630,23804,36660227,1795330,33989,47650,220132857,2007
TX,education - higher education other,60233,220912484,42056,39776535,2895647,76592,102289,260689019,2007
TX,education - other,4614,17594107,403,878230,43464,4859,5017,18472337,2007
TX,other and unallocable,6531,25077310,286,547229,33465,6719,6817,25624539,2007
UT,total,42112,166886417,23889,26304488,1571153,51001,66001,193190905,2007
UT,financial administration,2482,10104573,194,153257,12582,2554,2676,10257830,2007
UT,other government administration,352,1517790,37,53897,1536,363,389,1571687,2007
UT,judicial and legal,1538,5930031,157,330273,10656,1598,1695,6260304,2007
UT,police protection - officers,464,1814229,0,0,0,464,464,1814229,2007
UT,police protection - other,321,1155952,67,56621,4293,345,388,1212573,2007
UT,corrections,3166,10215130,240,182777,16182,3257,3406,10397907,2007
UT,highways,1630,6082628,14,14843,1098,1636,1644,6097471,2007
UT,public welfare,2931,9325475,298,381404,23245,3062,3229,9706879,2007
UT,health,1869,6842749,313,478636,27036,2022,2182,7321385,2007
UT,hospitals,6452,22574303,1341,1838063,88398,6951,7793,24412366,2007
UT,social insurance administration,707,2318607,54,113102,7165,747,761,2431709,2007
UT,parks and recreation,270,905263,87,61370,5874,303,357,966633,2007
UT,natural resources,1151,4205811,212,258172,22629,1279,1363,4463983,2007
UT,education - higher education instructional,5913,38650906,7773,10695718,399970,8176,13686,49346624,2007
UT,education - higher education other,10249,35909844,12139,10816429,884944,15256,22388,46726273,2007
UT,education - other,944,3495903,472,550483,38951,1164,1416,4046386,2007
UT,liquor stores,250,611263,295,152817,16616,344,545,764080,2007
UT,other and unallocable,1423,5225960,196,166626,9978,1480,1619,5392586,2007
VT,total,13682,57367661,2665,3496380,183628,14759,16347,60864041,2007
VT,financial administration,606,2522237,10,14828,742,611,616,2537065,2007
VT,other government administration,682,2267187,45,73402,4320,707,727,2340589,2007
VT,judicial and legal,598,2655871,61,133808,6436,635,659,2789679,2007
VT,police protection - officers,317,1919974,20,15536,1078,323,337,1935510,2007
VT,police protection - other,292,1223025,54,45243,3751,313,346,1268268,2007
VT,corrections,1197,4639151,8,19840,1014,1203,1205,4658991,2007
VT,highways,1067,4649546,8,28505,1061,1073,1075,4678051,2007
VT,public welfare,1265,5045940,63,180073,9057,1316,1328,5226013,2007
VT,health,558,2337763,334,563401,36602,764,892,2901164,2007
VT,hospitals,212,718135,9,29960,1244,219,221,748095,2007
VT,social insurance administration,205,808269,5,13164,542,208,210,821433,2007
VT,parks and recreation,123,482712,5,14384,615,126,128,497096,2007
VT,natural resources,590,2570123,54,238808,7875,635,644,2808931,2007
VT,education - higher education instructional,1296,8326271,467,912930,30534,1480,1763,9239201,2007
VT,education - higher education other,2867,9536559,1358,902709,63269,3248,4225,10439268,2007
VT,education - other,582,2445808,38,78962,3700,604,620,2524770,2007
VT,liquor stores,55,221737,0,0,0,55,55,221737,2007
VT,other and unallocable,1170,4997353,126,230827,11788,1239,1296,5228180,2007
VA,total,106550,431961023,48895,54597548,3183366,124536,155445,486558571,2007
VA,financial administration,3935,15338830,730,853638,65990,4308,4665,16192468,2007
VA,other government administration,512,2432664,257,564554,27416,668,769,2997218,2007
VA,judicial and legal,3532,15501120,383,532926,19630,3643,3915,16034046,2007
VA,police protection - officers,2261,10535224,37,46330,2534,2275,2298,10581554,2007
VA,police protection - other,776,2714196,198,276452,18722,882,974,2990648,2007
VA,corrections,14224,41844028,492,724860,48882,14500,14716,42568888,2007
VA,highways,8757,35764324,386,638674,37332,8968,9143,36402998,2007
VA,water transport and terminals,150,723678,3,4970,420,152,153,728648,2007
VA,public welfare,2303,8867786,235,494918,25652,2449,2538,9362704,2007
VA,health,5150,19846450,632,866942,62052,5500,5782,20713392,2007
VA,hospitals,14110,49392078,2355,3901127,165836,15046,16465,53293205,2007
VA,social insurance administration,1224,4379332,326,572830,40618,1454,1550,4952162,2007
VA,parks and recreation,696,2247370,741,689790,64354,1061,1437,2937160,2007
VA,natural resources,2633,11385718,543,634052,45421,2890,3176,12019770,2007
VA,education - higher education instructional,13835,92737904,13894,22479883,832217,18538,27729,115217787,2007
VA,education - higher education other,25087,86576929,24992,17923172,1474428,33417,50079,104500101,2007
VA,education - other,2695,11626082,589,974069,50143,2977,3284,12600151,2007
VA,liquor stores,808,2522894,1537,1563752,149882,1655,2345,4086646,2007
VA,other and unallocable,3862,17524416,565,854609,51837,4153,4427,18379025,2007
WA,total,100571,443040735,52166,60690701,3431767,119970,152737,503731436,2007
WA,financial administration,2695,11437780,150,375484,16760,2790,2845,11813264,2007
WA,other government administration,1461,5856457,275,475781,20451,1576,1736,6332238,2007
WA,judicial and legal,1864,9199556,164,364366,15122,1949,2028,9563922,2007
WA,police protection - officers,1097,7380888,0,0,0,1097,1097,7380888,2007
WA,police protection - other,1022,4931204,48,50089,2126,1034,1070,4981293,2007
WA,corrections,8581,32381200,476,813175,48446,8854,9057,33194375,2007
WA,highways,7292,34119338,379,664044,34996,7490,7671,34783382,2007
WA,public welfare,9041,32985270,1200,1480918,66000,9414,10241,34466188,2007
WA,health,4787,18685227,954,1948991,92611,5313,5741,20634218,2007
WA,hospitals,8532,38608366,3166,10042818,234870,9859,11698,48651184,2007
WA,social insurance administration,2822,11590816,314,673988,32644,3006,3136,12264804,2007
WA,solid waste management,146,700182,28,97424,3592,166,174,797606,2007
WA,parks and recreation,580,2383556,157,227551,19761,691,737,2611107,2007
WA,natural resources,4806,20674930,671,1364832,90669,5318,5477,22039762,2007
WA,education - higher education instructional,12065,68202104,13026,23488824,736008,16221,25091,91690928,2007
WA,education - higher education other,26113,111923391,29474,16237028,1892375,36804,55587,128160419,2007
WA,education - other,1788,7518498,914,1056861,50573,2086,2702,8575359,2007
WA,liquor stores,552,1761504,395,610382,42574,793,947,2371886,2007
WA,other and unallocable,5327,22700468,375,718145,32189,5509,5702,23418613,2007
WV,total,34562,110953139,10951,8991150,583714,38060,45513,119944289,2007
WV,financial administration,1840,5064802,26,31066,1998,1852,1866,5095868,2007
WV,other government administration,222,755360,261,617426,20434,354,483,1372786,2007
WV,judicial and legal,1383,5380898,29,43276,3703,1404,1412,5424174,2007
WV,police protection - officers,654,2752046,0,0,0,654,654,2752046,2007
WV,police protection - other,347,809150,17,11062,1084,353,364,820212,2007
WV,corrections,3298,7368121,6,6270,542,3301,3304,7374391,2007
WV,highways,4957,13959925,25,41672,3525,4978,4982,14001597,2007
WV,air transportation,3,10308,0,0,0,3,3,10308,2007
WV,water transport and terminals,4,13598,0,0,0,4,4,13598,2007
WV,public welfare,3251,7750662,11,10104,864,3256,3262,7760766,2007
WV,health,795,2342570,37,34926,2022,806,832,2377496,2007
WV,hospitals,1501,3560748,178,219446,19936,1614,1679,3780194,2007
WV,social insurance administration,559,1607410,21,17852,1840,570,580,1625262,2007
WV,solid waste management,9,32240,4,600,12,9,13,32840,2007
WV,parks and recreation,395,820288,315,199966,29364,561,710,1020254,2007
WV,natural resources,2180,7050550,367,276226,27184,2340,2547,7326776,2007
WV,transit,7,24354,0,0,0,7,7,24354,2007
WV,education - higher education instructional,3324,18696084,3762,4556259,155184,4260,7086,23252343,2007
WV,education - higher education other,6336,21246708,5560,2612258,296846,8124,11896,23858966,2007
WV,education - other,1312,4574230,200,205917,12923,1389,1512,4780147,2007
WV,liquor stores,54,140594,0,0,0,54,54,140594,2007
WV,other and unallocable,2131,6992493,132,106824,6253,2167,2263,7099317,2007
WI,total,54850,253259087,43737,42357097,2454007,68714,98587,295616184,2007
WI,financial administration,2252,9378165,525,960767,58754,2583,2777,10338932,2007
WI,other government administration,845,3720266,368,784489,30750,1019,1213,4504755,2007
WI,judicial and legal,1863,11629616,275,753416,29262,2028,2138,12383032,2007
WI,police protection - officers,584,2756350,0,0,0,584,584,2756350,2007
WI,police protection - other,284,1107556,36,50427,3043,301,320,1157983,2007
WI,corrections,9232,36113892,1074,2872853,111762,9864,10306,38986745,2007
WI,highways,1405,6767928,179,328560,17158,1502,1584,7096488,2007
WI,public welfare,1194,4795282,366,646638,33829,1385,1560,5441920,2007
WI,health,1413,6005800,423,892280,36518,1619,1836,6898080,2007
WI,hospitals,2819,11356735,1043,2255193,96038,3360,3862,13611928,2007
WI,social insurance administration,780,3214133,44,81552,5411,810,824,3295685,2007
WI,parks and recreation,179,677623,50,58279,3423,198,229,735902,2007
WI,natural resources,2035,8025003,936,1359160,77292,2472,2971,9384163,2007
WI,education - higher education instructional,8012,50586066,10443,11923935,626303,11550,18455,62510001,2007
WI,education - higher education other,15746,68652775,26288,16268622,1186082,22447,42034,84921397,2007
WI,education - other,953,4458078,375,556933,21549,1075,1328,5015011,2007
WI,other and unallocable,5254,24013819,1312,2563993,116833,5917,6566,26577812,2007
WY,total,11810,42668933,3089,2332743,183633,12842,14899,45001676,2007
WY,financial administration,549,2162918,6,10372,522,551,555,2173290,2007
WY,other government administration,142,649410,188,168744,9645,195,330,818154,2007
WY,judicial and legal,507,2226058,24,36413,2256,519,531,2262471,2007
WY,police protection - officers,183,950425,0,0,0,183,183,950425,2007
WY,police protection - other,96,367924,0,0,0,96,96,367924,2007
WY,corrections,1018,3131080,4,6635,433,1020,1022,3137715,2007
WY,highways,1764,6065192,95,191656,12240,1833,1859,6256848,2007
WY,public welfare,708,2431031,54,72063,4882,736,762,2503094,2007
WY,health,671,2527871,75,135982,8460,719,746,2663853,2007
WY,hospitals,745,2053657,52,106955,4476,771,797,2160612,2007
WY,social insurance administration,327,1081431,6,7293,520,330,333,1088724,2007
WY,parks and recreation,77,252778,6,10769,522,80,83,263547,2007
WY,natural resources,957,3271821,33,33245,3176,974,990,3305066,2007
WY,education - higher education instructional,991,5295058,704,640040,39542,1214,1695,5935098,2007
WY,education - higher education other,1858,5765730,1772,815768,90090,2367,3630,6581498,2007
WY,education - other,229,933529,7,6898,607,232,236,940427,2007
WY,liquor stores,62,210474,0,0,0,62,62,210474,2007
WY,other and unallocable,926,3292546,63,89910,6262,960,989,3382456,2007
