state,government_function,full_time_employees,full_time_pay,part_time_employees,part_time_pay,part_time_hours,full_time_equivalent_employees,total_employees,march_pay,year
US,total,3818577,16974808716,1451002,1751084555,95039718,4362688,5269579,18725893271,2008
US,financial administration,165576,699297421,11034,19380815,1119642,172014,176610,718678236,2008
US,other government administration,49711,221752586,11126,21182839,942299,55214,60837,242935425,2008
US,judicial and legal,170853,839406773,9944,22961486,948112,176319,180797,862368259,2008
US,police protection - officers,67219,384734573,712,1156761,29566,67388,67931,385891334,2008
US,police protection - other,39587,151748698,2522,3280280,187195,40656,42109,155028978,2008
US,corrections,475587,1896745369,10172,24604830,1020795,481390,485759,1921350199,2008
US,highways,231896,990442790,10040,21251511,887888,236977,241936,1011694301,2008
US,air transportation,3119,15473258,59,121575,6260,3156,3178,15594833,2008
US,water transport and terminals,5201,24738335,64,114663,5911,5235,5265,24852998,2008
US,public welfare,236496,846423970,11014,21903024,1124483,242925,247510,868326994,2008
US,health,178510,722353339,13702,27933071,1253185,185667,192212,750286410,2008
US,hospitals,377749,1594994806,63503,161712790,6426800,414537,441252,1756707596,2008
US,social insurance administration,75456,308193830,5321,11540724,620203,79029,80777,319734554,2008
US,solid waste management,1868,10075043,103,257200,9568,1922,1971,10332243,2008
US,sewerage,1755,9927321,48,204309,4963,1784,1803,10131630,2008
US,parks and recreation,27549,97376388,12871,17801983,1271650,34916,40420,115178371,2008
US,housing and community development,0,0,0,0,0,0,0,0,2008
US,natural resources,131051,547718076,28425,40114471,2592698,145825,159476,587832547,2008
US,water transport and terminals,740,4068296,38,98461,3065,756,778,4166757,2008
US,electric power,4035,26055144,88,260674,9566,4089,4123,26315818,2008
US,gas supply,0,0,0,0,0,0,0,0,2008
US,transit,31160,180206718,1618,3122508,183808,32198,32778,183329226,2008
US,education - elementary and secondary instructional,36460,185868364,9518,10377911,464656,39226,45978,196246275,2008
US,education - elementary and secondary other,10791,33583500,8656,7002775,481473,13742,19447,40586275,2008
US,education - higher education instructional,389610,2632014425,397391,633477957,25313635,534564,787001,3265492382,2008
US,education - higher education other,826390,3336242962,812535,654576662,47715621,1099138,1638925,3990819624,2008
US,education - other,87753,369227589,13402,20791722,1019229,93591,101155,390019311,2008
US,libraries,473,1585514,305,280610,22654,601,778,1866124,2008
US,liquor stores,6385,20326705,3038,3000887,275064,7953,9423,23327592,2008
US,other and unallocable,185597,824226923,13753,22572056,1099729,191876,199350,846798979,2008
AL,total,79593,317591532,28337,27608260,1719794,89456,107930,345199792,2008
AL,financial administration,2642,10521969,92,98971,9381,2694,2734,10620940,2008
AL,other government administration,563,2478646,96,136221,6983,602,659,2614867,2008
AL,judicial and legal,3582,14521518,79,143581,3173,3601,3661,14665099,2008
AL,police protection - officers,686,3250636,0,0,0,686,686,3250636,2008
AL,police protection - other,668,2153989,0,0,0,668,668,2153989,2008
AL,corrections,5136,15292405,24,37448,2016,5147,5160,15329853,2008
AL,highways,4582,15089268,115,74734,9200,4634,4697,15164002,2008
AL,air transportation,0,0,0,0,0,0,0,0,2008
AL,water transport and terminals,657,2699803,1,1500,30,657,658,2701303,2008
AL,public welfare,4420,15068776,41,72956,4670,4446,4461,15141732,2008
AL,health,5767,20261691,526,564587,61163,6113,6293,20826278,2008
AL,hospitals,10951,40919007,1758,4347992,152452,11812,12709,45266999,2008
AL,social insurance administration,844,3268372,45,55618,5224,874,889,3323990,2008
AL,solid waste management,0,0,0,0,0,0,0,0,2008
AL,sewerage,0,0,0,0,0,0,0,0,2008
AL,parks and recreation,496,1290371,244,193300,25062,638,740,1483671,2008
AL,housing and community development,0,0,0,0,0,0,0,0,2008
AL,natural resources,2147,8241929,355,359668,30826,2322,2502,8601597,2008
AL,water transport and terminals,0,0,0,0,0,0,0,0,2008
AL,electric power,0,0,0,0,0,0,0,0,2008
AL,gas supply,0,0,0,0,0,0,0,0,2008
AL,transit,0,0,0,0,0,0,0,0,2008
AL,education - elementary and secondary instructional,0,0,0,0,0,0,0,0,2008
AL,education - elementary and secondary other,0,0,0,0,0,0,0,0,2008
AL,education - higher education instructional,9429,64476259,8628,9835335,467347,12129,18057,74311594,2008
AL,education - higher education other,20888,76567051,15633,10881200,874732,25917,36521,87448251,2008
AL,education - other,3213,11116759,170,235182,12790,3285,3383,11351941,2008
AL,libraries,0,0,0,0,0,0,0,0,2008
AL,liquor stores,737,1899182,10,14938,918,742,747,1914120,2008
AL,other and unallocable,2185,8473901,520,555029,53827,2489,2705,9028930,2008
AK,total,23883,111279888,5265,6350075,347242,25885,29148,117629963,2008
AK,financial administration,1066,5101743,44,44431,2294,1079,1110,5146174,2008
AK,other government administration,738,3184765,52,63639,3035,755,790,3248404,2008
AK,judicial and legal,1342,6668868,72,122624,5127,1371,1414,6791492,2008
AK,police protection - officers,253,1746778,3,4879,232,254,256,1751657,2008
AK,police protection - other,155,536736,50,16333,1128,161,205,553069,2008
AK,corrections,1796,8290016,58,77801,4828,1824,1854,8367817,2008
AK,highways,3005,14930200,43,49323,2998,3022,3048,14979523,2008
AK,air transportation,0,0,0,0,0,0,0,0,2008
AK,water transport and terminals,0,0,0,0,0,0,0,0,2008
AK,public welfare,1725,6714582,135,171338,15895,1814,1860,6885920,2008
AK,health,661,3112982,22,32403,1738,671,683,3145385,2008
AK,hospitals,208,1025455,25,48703,2973,225,233,1074158,2008
AK,social insurance administration,381,1485333,14,14132,819,386,395,1499465,2008
AK,solid waste management,0,0,0,0,0,0,0,0,2008
AK,sewerage,0,0,0,0,0,0,0,0,2008
AK,parks and recreation,92,362007,1,1772,80,92,93,363779,2008
AK,housing and community development,0,0,0,0,0,0,0,0,2008
AK,natural resources,2332,10340211,138,207234,9794,2388,2470,10547445,2008
AK,water transport and terminals,0,0,0,0,0,0,0,0,2008
AK,electric power,0,0,0,0,0,0,0,0,2008
AK,gas supply,0,0,0,0,0,0,0,0,2008
AK,transit,0,0,0,0,0,0,0,0,2008
AK,education - elementary and secondary instructional,2021,8341947,487,607795,35389,2241,2508,8949742,2008
AK,education - elementary and secondary other,809,2375640,511,480470,35060,1028,1320,2856110,2008
AK,education - higher education instructional,1122,8204546,1031,1382654,33936,1314,2153,9587200,2008
AK,education - higher education other,2962,13073345,2465,2899443,185037,4007,5427,15972788,2008
AK,education - other,241,1069645,37,21036,1686,251,278,1090681,2008
AK,libraries,0,0,0,0,0,0,0,0,2008
AK,liquor stores,0,0,0,0,0,0,0,0,2008
AK,other and unallocable,2974,14715089,77,104065,5193,3002,3051,14819154,2008
AZ,total,63084,268568593,26367,28172571,1755146,73004,89451,296741164,2008
AZ,financial administration,3818,14051810,58,146531,5869,3851,3876,14198341,2008
AZ,other government administration,640,2710112,156,282789,11846,708,796,2992901,2008
AZ,judicial and legal,2276,10014999,105,270468,9608,2330,2381,10285467,2008
AZ,police protection - officers,1267,6966293,0,0,0,1267,1267,6966293,2008
AZ,police protection - other,899,3954572,35,69586,2721,915,934,4024158,2008
AZ,corrections,10463,39262810,32,118973,3339,10482,10495,39381783,2008
AZ,highways,2951,11915788,59,128049,5267,2981,3010,12043837,2008
AZ,air transportation,0,0,0,0,0,0,0,0,2008
AZ,water transport and terminals,0,0,0,0,0,0,0,0,2008
AZ,public welfare,5650,18326640,138,368270,13430,5726,5788,18694910,2008
AZ,health,3271,11858771,57,145232,5735,3303,3328,12004003,2008
AZ,hospitals,732,2997245,31,89680,2965,749,763,3086925,2008
AZ,social insurance administration,1751,5016231,70,99251,7521,1793,1821,5115482,2008
AZ,solid waste management,0,0,0,0,0,0,0,0,2008
AZ,sewerage,0,0,0,0,0,0,0,0,2008
AZ,parks and recreation,414,1279563,36,51473,4891,442,450,1331036,2008
AZ,housing and community development,0,0,0,0,0,0,0,0,2008
AZ,natural resources,2532,12311551,853,925916,65113,2901,3385,13237467,2008
AZ,water transport and terminals,0,0,0,0,0,0,0,0,2008
AZ,electric power,8,55794,0,0,0,8,8,55794,2008
AZ,gas supply,0,0,0,0,0,0,0,0,2008
AZ,transit,0,0,0,0,0,0,0,0,2008
AZ,education - elementary and secondary instructional,0,0,0,0,0,0,0,0,2008
AZ,education - elementary and secondary other,0,0,0,0,0,0,0,0,2008
AZ,education - higher education instructional,6693,45636805,8721,12580763,610464,10142,15414,58217568,2008
AZ,education - higher education other,12873,57532304,15468,11975358,960954,18302,28341,69507662,2008
AZ,education - other,3221,10475565,311,512407,27147,3375,3532,10987972,2008
AZ,libraries,0,0,0,0,0,0,0,0,2008
AZ,liquor stores,0,0,0,0,0,0,0,0,2008
AZ,other and unallocable,3625,14201740,237,407825,18276,3729,3862,14609565,2008
AR,total,56075,193972803,14263,12296167,890240,61103,70338,206268970,2008
AR,financial administration,1966,6083999,25,15161,1463,1973,1991,6099160,2008
AR,other government administration,684,2773166,138,175185,9886,739,822,2948351,2008
AR,judicial and legal,1462,4654886,156,116600,3877,1484,1618,4771486,2008
AR,police protection - officers,593,2361176,0,0,0,593,593,2361176,2008
AR,police protection - other,628,1794026,0,0,0,628,628,1794026,2008
AR,corrections,5239,13780142,5,3361,182,5240,5244,13783503,2008
AR,highways,3566,12375804,39,36214,3976,3588,3605,12412018,2008
AR,air transportation,0,0,0,0,0,0,0,0,2008
AR,water transport and terminals,0,0,0,0,0,0,0,0,2008
AR,public welfare,3987,10189601,0,0,0,3987,3987,10189601,2008
AR,health,4880,15217280,89,124532,5701,4912,4969,15341812,2008
AR,hospitals,5794,18217401,166,303546,15664,5882,5960,18520947,2008
AR,social insurance administration,1079,3469551,6,7692,296,1081,1085,3477243,2008
AR,solid waste management,0,0,0,0,0,0,0,0,2008
AR,sewerage,0,0,0,0,0,0,0,0,2008
AR,parks and recreation,699,1742243,4,1220,160,700,703,1743463,2008
AR,housing and community development,0,0,0,0,0,0,0,0,2008
AR,natural resources,1826,5598179,349,261599,20918,1943,2175,5859778,2008
AR,water transport and terminals,0,0,0,0,0,0,0,0,2008
AR,electric power,0,0,0,0,0,0,0,0,2008
AR,gas supply,0,0,0,0,0,0,0,0,2008
AR,transit,0,0,0,0,0,0,0,0,2008
AR,education - elementary and secondary instructional,0,0,0,0,0,0,0,0,2008
AR,education - elementary and secondary other,0,0,0,0,0,0,0,0,2008
AR,education - higher education instructional,6298,40055449,4892,6883255,382126,8458,11190,46938704,2008
AR,education - higher education other,13381,42480324,8317,4309376,443098,15888,21698,46789700,2008
AR,education - other,1525,4876656,46,34545,1464,1532,1571,4911201,2008
AR,libraries,0,0,0,0,0,0,0,0,2008
AR,liquor stores,0,0,0,0,0,0,0,0,2008
AR,other and unallocable,2468,8302920,31,23881,1429,2475,2499,8326801,2008
CA,total,338725,2002723495,150343,233223801,9780752,393989,489068,2235947296,2008
CA,financial administration,20330,93693759,3405,5657897,362137,22375,23735,99351656,2008
CA,other government administration,3818,21730747,340,796451,25509,3970,4158,22527198,2008
CA,judicial and legal,4613,28133653,478,1211190,34449,4806,5091,29344843,2008
CA,police protection - officers,7561,55833851,456,719086,13575,7638,8017,56552937,2008
CA,police protection - other,5323,22138193,783,881881,35594,5525,6106,23020074,2008
CA,corrections,59508,375313938,2011,6577379,203759,60659,61519,381891317,2008
CA,highways,20096,142066858,1143,4059481,133025,20847,21239,146126339,2008
CA,air transportation,0,0,0,0,0,0,0,0,2008
CA,water transport and terminals,0,0,0,0,0,0,0,0,2008
CA,public welfare,3664,17205705,302,837512,31586,3842,3966,18043217,2008
CA,health,11559,66937518,1531,3861088,124900,12264,13090,70798606,2008
CA,hospitals,36627,228752061,8259,25356437,749832,40864,44886,254108498,2008
CA,social insurance administration,16978,77653399,1260,3197577,135657,17744,18238,80850976,2008
CA,solid waste management,384,2199028,47,146696,4503,409,431,2345724,2008
CA,sewerage,0,0,0,0,0,0,0,0,2008
CA,parks and recreation,2341,11520133,1789,2992544,191341,3423,4130,14512677,2008
CA,housing and community development,0,0,0,0,0,0,0,0,2008
CA,natural resources,12749,70318979,2436,4295556,284870,14358,15185,74614535,2008
CA,water transport and terminals,0,0,0,0,0,0,0,0,2008
CA,electric power,0,0,0,0,0,0,0,0,2008
CA,gas supply,0,0,0,0,0,0,0,0,2008
CA,transit,0,0,0,0,0,0,0,0,2008
CA,education - elementary and secondary instructional,0,0,0,0,0,0,0,0,2008
CA,education - elementary and secondary other,0,0,0,0,0,0,0,0,2008
CA,education - higher education instructional,23075,193112986,31881,60303674,2333834,36260,54956,253416660,2008
CA,education - higher education other,86418,467812628,91524,106431628,4897282,114087,177942,574244256,2008
CA,education - other,3878,19116711,575,1009580,45598,4136,4453,20126291,2008
CA,libraries,0,0,0,0,0,0,0,0,2008
CA,liquor stores,0,0,0,0,0,0,0,0,2008
CA,other and unallocable,19803,109183348,2123,4888144,173301,20782,21926,114071492,2008
CO,total,53769,263524912,35865,53832209,2766613,69400,89634,317357121,2008
CO,financial administration,2086,9988527,114,215860,9041,2138,2200,10204387,2008
CO,other government administration,429,1742192,169,436943,24069,565,598,2179135,2008
CO,judicial and legal,3684,18039463,745,2078968,85358,4167,4429,20118431,2008
CO,police protection - officers,798,4531442,0,0,0,798,798,4531442,2008
CO,police protection - other,373,1410302,21,43823,1738,383,394,1454125,2008
CO,corrections,7090,29686155,84,281167,10780,7150,7174,29967322,2008
CO,highways,3057,13942480,175,425124,18861,3164,3232,14367604,2008
CO,air transportation,0,0,0,0,0,0,0,0,2008
CO,water transport and terminals,0,0,0,0,0,0,0,0,2008
CO,public welfare,1868,8513855,553,1258835,59080,2202,2421,9772690,2008
CO,health,1111,6172106,169,500145,17469,1209,1280,6672251,2008
CO,hospitals,4578,17987655,1094,2450455,118374,5247,5672,20438110,2008
CO,social insurance administration,879,4138057,60,138371,9000,930,939,4276428,2008
CO,solid waste management,0,0,0,0,0,0,0,0,2008
CO,sewerage,0,0,0,0,0,0,0,0,2008
CO,parks and recreation,265,1224290,109,105370,5609,297,374,1329660,2008
CO,housing and community development,0,0,0,0,0,0,0,0,2008
CO,natural resources,1396,7125113,284,486416,17742,1497,1680,7611529,2008
CO,water transport and terminals,0,0,0,0,0,0,0,0,2008
CO,electric power,0,0,0,0,0,0,0,0,2008
CO,gas supply,0,0,0,0,0,0,0,0,2008
CO,transit,0,0,0,0,0,0,0,0,2008
CO,education - elementary and secondary instructional,0,0,0,0,0,0,0,0,2008
CO,education - elementary and secondary other,0,0,0,0,0,0,0,0,2008
CO,education - higher education instructional,8761,64332505,11004,22603848,986837,14335,19765,86936353,2008
CO,education - higher education other,14972,63422044,20356,21236832,1333709,22506,35328,84658876,2008
CO,education - other,900,4142282,848,1371935,60664,1242,1748,5514217,2008
CO,libraries,0,0,0,0,0,0,0,0,2008
CO,liquor stores,0,0,0,0,0,0,0,0,2008
CO,other and unallocable,1522,7126444,80,198117,8282,1570,1602,7324561,2008
CT,total,56556,309941254,22597,36739855,1584655,66183,79153,346681109,2008
CT,financial administration,2798,13733260,200,573080,22979,2927,2998,14306340,2008
CT,other government administration,1239,6179734,230,839605,29440,1406,1469,7019339,2008
CT,judicial and legal,4810,22844298,363,624095,11507,4875,5173,23468393,2008
CT,police protection - officers,1473,7740395,2,5610,288,1475,1475,7746005,2008
CT,police protection - other,586,2729111,28,46073,2123,598,614,2775184,2008
CT,corrections,7649,40248928,136,405968,12203,7718,7785,40654896,2008
CT,highways,3105,17350476,9,34672,1502,3113,3114,17385148,2008
CT,air transportation,165,1048462,0,0,0,165,165,1048462,2008
CT,water transport and terminals,0,0,0,0,0,0,0,0,2008
CT,public welfare,5356,28952680,536,1782967,70676,5756,5892,30735647,2008
CT,health,1981,9981042,119,390933,12889,2054,2100,10371975,2008
CT,hospitals,7882,44573292,2929,10009929,345830,9864,10811,54583221,2008
CT,social insurance administration,621,3553800,33,49929,2660,636,654,3603729,2008
CT,solid waste management,52,357714,7,23526,715,56,59,381240,2008
CT,sewerage,0,0,0,0,0,0,0,0,2008
CT,parks and recreation,188,912553,27,31474,1603,197,215,944027,2008
CT,housing and community development,0,0,0,0,0,0,0,0,2008
CT,natural resources,1030,5285363,182,356066,13850,1112,1212,5641429,2008
CT,water transport and terminals,0,0,0,0,0,0,0,0,2008
CT,electric power,0,0,0,0,0,0,0,0,2008
CT,gas supply,0,0,0,0,0,0,0,0,2008
CT,transit,0,0,0,0,0,0,0,0,2008
CT,education - elementary and secondary instructional,0,0,0,0,0,0,0,0,2008
CT,education - elementary and secondary other,0,0,0,0,0,0,0,0,2008
CT,education - higher education instructional,4334,32144856,7899,12505229,452442,7189,12233,44650085,2008
CT,education - higher education other,8084,43258190,8600,7185619,516244,11342,16684,50443809,2008
CT,education - other,2417,13552991,944,1234015,57154,2741,3361,14787006,2008
CT,libraries,0,0,0,0,0,0,0,0,2008
CT,liquor stores,0,0,0,0,0,0,0,0,2008
CT,other and unallocable,2786,15494109,353,641065,30550,2959,3139,16135174,2008
DE,total,23424,97842620,8570,12035914,552615,26756,31994,109878534,2008
DE,financial administration,815,2814904,17,21562,1335,824,832,2836466,2008
DE,other government administration,316,1326231,153,362796,14316,403,469,1689027,2008
DE,judicial and legal,1704,7736243,60,111217,5637,1738,1764,7847460,2008
DE,police protection - officers,708,4898725,0,0,0,708,708,4898725,2008
DE,police protection - other,309,1199702,26,34330,2052,321,335,1234032,2008
DE,corrections,2932,11393382,62,92374,6804,2974,2994,11485756,2008
DE,highways,1592,5475702,6,16824,762,1597,1598,5492526,2008
DE,air transportation,0,0,0,0,0,0,0,0,2008
DE,water transport and terminals,361,1074201,0,0,0,361,361,1074201,2008
DE,public welfare,1752,6103719,130,218878,13709,1834,1882,6322597,2008
DE,health,2149,8009154,196,349865,19344,2265,2345,8359019,2008
DE,hospitals,1801,6152635,85,110058,7415,1846,1886,6262693,2008
DE,social insurance administration,318,1074733,23,41083,2155,331,341,1115816,2008
DE,solid waste management,185,613457,15,15212,1140,192,200,628669,2008
DE,sewerage,0,0,0,0,0,0,0,0,2008
DE,parks and recreation,221,718193,107,109100,9367,278,328,827293,2008
DE,housing and community development,0,0,0,0,0,0,0,0,2008
DE,natural resources,485,1862754,125,124341,6919,527,610,1987095,2008
DE,water transport and terminals,0,0,0,0,0,0,0,0,2008
DE,electric power,0,0,0,0,0,0,0,0,2008
DE,gas supply,0,0,0,0,0,0,0,0,2008
DE,transit,740,3134218,5,6724,392,742,745,3140942,2008
DE,education - elementary and secondary instructional,0,0,0,0,0,0,0,0,2008
DE,education - elementary and secondary other,0,0,0,0,0,0,0,0,2008
DE,education - higher education instructional,1506,10821310,3719,6195931,236631,2932,5225,17017241,2008
DE,education - higher education other,3488,14644376,3587,3991348,211371,4762,7075,18635724,2008
DE,education - other,357,2000923,25,57185,2670,373,382,2058108,2008
DE,libraries,0,0,0,0,0,0,0,0,2008
DE,liquor stores,0,0,0,0,0,0,0,0,2008
DE,other and unallocable,1685,6788058,229,177086,10596,1748,1914,6965144,2008
FL,total,171555,653343837,44572,54588343,3122165,189226,216127,707932180,2008
FL,financial administration,6823,25480455,282,277424,20777,6941,7105,25757879,2008
FL,other government administration,2349,10587855,165,216722,13352,2424,2514,10804577,2008
FL,judicial and legal,20401,83075618,1112,1914943,95332,20942,21513,84990561,2008
FL,police protection - officers,2191,9552674,57,65411,3082,2208,2248,9618085,2008
FL,police protection - other,2179,7537439,115,115747,9715,2234,2294,7653186,2008
FL,corrections,28911,88737005,288,546848,23541,29044,29199,89283853,2008
FL,highways,7387,30350836,126,104436,9091,7439,7513,30455272,2008
FL,air transportation,0,0,0,0,0,0,0,0,2008
FL,water transport and terminals,0,0,0,0,0,0,0,0,2008
FL,public welfare,9321,28440635,226,285746,20158,9435,9547,28726381,2008
FL,health,21977,65246296,1607,2676293,166616,22918,23584,67922589,2008
FL,hospitals,3813,11637478,73,157617,6772,3851,3886,11795095,2008
FL,social insurance administration,2210,7308256,69,101470,5833,2243,2279,7409726,2008
FL,solid waste management,0,0,0,0,0,0,0,0,2008
FL,sewerage,0,0,0,0,0,0,0,0,2008
FL,parks and recreation,1264,3083472,251,219768,17798,1365,1515,3303240,2008
FL,housing and community development,0,0,0,0,0,0,0,0,2008
FL,natural resources,8853,28929685,2325,2467000,158181,9746,11178,31396685,2008
FL,water transport and terminals,0,0,0,0,0,0,0,0,2008
FL,electric power,0,0,0,0,0,0,0,0,2008
FL,gas supply,0,0,0,0,0,0,0,0,2008
FL,transit,677,2843786,46,64962,6440,713,723,2908748,2008
FL,education - elementary and secondary instructional,0,0,0,0,0,0,0,0,2008
FL,education - elementary and secondary other,0,0,0,0,0,0,0,0,2008
FL,education - higher education instructional,15102,116041855,13178,19085770,920899,20309,28280,135127625,2008
FL,education - higher education other,27887,99662483,23905,25380552,1583174,36857,51792,125043035,2008
FL,education - other,3603,12302443,267,327046,21991,3727,3870,12629489,2008
FL,libraries,0,0,0,0,0,0,0,0,2008
FL,liquor stores,0,0,0,0,0,0,0,0,2008
FL,other and unallocable,6607,22525566,480,580588,39413,6830,7087,23106154,2008
GA,total,114668,427054864,41673,42551019,2665575,129749,156341,469605883,2008
GA,financial administration,4263,16497657,45,108461,2814,4280,4308,16606118,2008
GA,other government administration,1001,3717276,252,133125,6494,1038,1253,3850401,2008
GA,judicial and legal,3667,17827753,53,68533,2000,3678,3720,17896286,2008
GA,police protection - officers,1065,4421942,0,0,0,1065,1065,4421942,2008
GA,police protection - other,1015,3483565,18,22382,1720,1025,1033,3505947,2008
GA,corrections,20144,53792583,534,1189012,53384,20446,20678,54981595,2008
GA,highways,5883,18295833,26,6490,412,5885,5909,18302323,2008
GA,air transportation,0,0,0,0,0,0,0,0,2008
GA,water transport and terminals,1022,5416640,0,0,0,1022,1022,5416640,2008
GA,public welfare,8773,24872885,92,121640,7140,8813,8865,24994525,2008
GA,health,5355,17759400,271,345440,26360,5503,5626,18104840,2008
GA,hospitals,7616,20452971,249,709664,27564,7772,7865,21162635,2008
GA,social insurance administration,2159,6510530,139,198510,13608,2236,2298,6709040,2008
GA,solid waste management,0,0,0,0,0,0,0,0,2008
GA,sewerage,0,0,0,0,0,0,0,0,2008
GA,parks and recreation,1243,3138448,1780,2381511,221056,2492,3023,5519959,2008
GA,housing and community development,0,0,0,0,0,0,0,0,2008
GA,natural resources,4226,13426484,840,860752,63272,4584,5066,14287236,2008
GA,water transport and terminals,0,0,0,0,0,0,0,0,2008
GA,electric power,0,0,0,0,0,0,0,0,2008
GA,gas supply,0,0,0,0,0,0,0,0,2008
GA,transit,0,0,0,0,0,0,0,0,2008
GA,education - elementary and secondary instructional,0,0,0,0,0,0,0,0,2008
GA,education - elementary and secondary other,0,0,0,0,0,0,0,0,2008
GA,education - higher education instructional,12865,81897023,14893,19321936,870982,17793,27758,101218959,2008
GA,education - higher education other,28009,110976368,21491,15861369,1308765,35416,49500,126837737,2008
GA,education - other,3012,12508954,398,1028152,42914,3254,3410,13537106,2008
GA,libraries,0,0,0,0,0,0,0,0,2008
GA,liquor stores,0,0,0,0,0,0,0,0,2008
GA,other and unallocable,3350,12058552,592,194042,17090,3447,3942,12252594,2008
HI,total,53683,218194841,21059,22398969,1095082,59868,74742,240593810,2008
HI,financial administration,751,2904924,4,8276,394,754,755,2913200,2008
HI,other government administration,671,2682576,167,298765,11537,735,838,2981341,2008
HI,judicial and legal,2657,11601434,66,137984,4683,2683,2723,11739418,2008
HI,police protection - officers,0,0,0,0,0,0,0,0,2008
HI,police protection - other,0,0,0,0,0,0,0,0,2008
HI,corrections,2416,10436448,8,31590,732,2420,2424,10468038,2008
HI,highways,855,3843356,9,6258,702,859,864,3849614,2008
HI,air transportation,973,3654058,11,14910,838,978,984,3668968,2008
HI,water transport and terminals,212,875620,0,0,0,212,212,875620,2008
HI,public welfare,928,3566500,37,29544,3516,948,965,3596044,2008
HI,health,2319,10235784,74,219580,6624,2356,2393,10455364,2008
HI,hospitals,4052,17135934,583,1575336,50710,4339,4635,18711270,2008
HI,social insurance administration,247,991120,3,8796,278,249,250,999916,2008
HI,solid waste management,0,0,0,0,0,0,0,0,2008
HI,sewerage,0,0,0,0,0,0,0,0,2008
HI,parks and recreation,146,530366,511,91048,5974,180,657,621414,2008
HI,housing and community development,0,0,0,0,0,0,0,0,2008
HI,natural resources,1126,5044220,281,263288,16576,1220,1407,5307508,2008
HI,water transport and terminals,0,0,0,0,0,0,0,0,2008
HI,electric power,0,0,0,0,0,0,0,0,2008
HI,gas supply,0,0,0,0,0,0,0,0,2008
HI,transit,0,0,0,0,0,0,0,0,2008
HI,education - elementary and secondary instructional,19905,77917868,6922,6826056,315986,21690,26827,84743924,2008
HI,education - elementary and secondary other,5162,13489330,5468,3810038,265562,6662,10630,17299368,2008
HI,education - higher education instructional,2755,18471966,1700,4998284,147828,3590,4455,23470250,2008
HI,education - higher education other,4120,17918116,4868,3737762,236534,5456,8988,21655878,2008
HI,education - other,139,534732,3,6062,240,140,142,540794,2008
HI,libraries,473,1585514,305,280610,22654,601,778,1866124,2008
HI,liquor stores,0,0,0,0,0,0,0,0,2008
HI,other and unallocable,3776,14774975,39,54782,3714,3796,3815,14829757,2008
ID,total,18964,77874381,9639,10034230,664880,22721,28603,87908611,2008
ID,financial administration,1215,5096591,169,189368,19266,1324,1384,5285959,2008
ID,other government administration,152,765340,196,459600,20322,267,348,1224940,2008
ID,judicial and legal,472,3092561,26,75059,1627,481,498,3167620,2008
ID,police protection - officers,275,1169698,0,0,0,275,275,1169698,2008
ID,police protection - other,199,687288,23,22800,2241,212,222,710088,2008
ID,corrections,1960,7517805,41,92849,5770,1993,2001,7610654,2008
ID,highways,1494,5345482,139,221194,17635,1594,1633,5566676,2008
ID,air transportation,0,0,0,0,0,0,0,0,2008
ID,water transport and terminals,0,0,0,0,0,0,0,0,2008
ID,public welfare,1673,5943403,177,303894,24496,1811,1850,6247297,2008
ID,health,1144,4909642,186,372083,17030,1241,1330,5281725,2008
ID,hospitals,747,2273005,128,103524,8402,794,875,2376529,2008
ID,social insurance administration,419,2001600,222,560500,37387,630,641,2562100,2008
ID,solid waste management,0,0,0,0,0,0,0,0,2008
ID,sewerage,0,0,0,0,0,0,0,0,2008
ID,parks and recreation,210,676618,72,70788,6458,246,282,747406,2008
ID,housing and community development,0,0,0,0,0,0,0,0,2008
ID,natural resources,1669,7044724,734,977905,72672,2080,2403,8022629,2008
ID,water transport and terminals,0,0,0,0,0,0,0,0,2008
ID,electric power,0,0,0,0,0,0,0,0,2008
ID,gas supply,0,0,0,0,0,0,0,0,2008
ID,transit,0,0,0,0,0,0,0,0,2008
ID,education - elementary and secondary instructional,0,0,0,0,0,0,0,0,2008
ID,education - elementary and secondary other,0,0,0,0,0,0,0,0,2008
ID,education - higher education instructional,2239,12112214,1983,2818351,122921,2933,4222,14930565,2008
ID,education - higher education other,3672,13233340,5256,3423056,276343,5234,8928,16656396,2008
ID,education - other,433,1913319,101,161166,16323,525,534,2074485,2008
ID,libraries,0,0,0,0,0,0,0,0,2008
ID,liquor stores,153,509151,156,143864,13122,227,309,653015,2008
ID,other and unallocable,838,3582600,30,38229,2865,854,868,3620829,2008
IL,total,109118,536204731,53365,51871562,3368213,128605,162483,588076293,2008
IL,financial administration,5231,26399427,315,570433,33357,5432,5546,26969860,2008
IL,other government administration,2377,12682586,45,82701,2450,2391,2422,12765287,2008
IL,judicial and legal,2587,20620440,55,151542,3936,2610,2642,20771982,2008
IL,police protection - officers,2281,14752348,0,0,0,2281,2281,14752348,2008
IL,police protection - other,1639,7951218,4,5830,272,1641,1643,7957048,2008
IL,corrections,12058,58568542,7,31330,662,12062,12065,58599872,2008
IL,highways,6204,30496958,1443,4499708,72321,6640,7647,34996666,2008
IL,air transportation,0,0,0,0,0,0,0,0,2008
IL,water transport and terminals,79,401184,0,0,0,79,79,401184,2008
IL,public welfare,9988,48168004,57,171292,5066,10019,10045,48339296,2008
IL,health,2562,13192644,10,27088,801,2567,2572,13219732,2008
IL,hospitals,10546,48813214,780,1693582,60154,10888,11326,50506796,2008
IL,social insurance administration,1966,9977830,162,473500,20934,2092,2128,10451330,2008
IL,solid waste management,0,0,0,0,0,0,0,0,2008
IL,sewerage,0,0,0,0,0,0,0,0,2008
IL,parks and recreation,535,2283816,33,89977,4062,559,568,2373793,2008
IL,housing and community development,0,0,0,0,0,0,0,0,2008
IL,natural resources,2915,13202670,1355,1691319,160325,3824,4270,14893989,2008
IL,water transport and terminals,0,0,0,0,0,0,0,0,2008
IL,electric power,0,0,0,0,0,0,0,0,2008
IL,gas supply,0,0,0,0,0,0,0,0,2008
IL,transit,0,0,0,0,0,0,0,0,2008
IL,education - elementary and secondary instructional,0,0,0,0,0,0,0,0,2008
IL,education - elementary and secondary other,0,0,0,0,0,0,0,0,2008
IL,education - higher education instructional,12610,78175188,18139,21195762,732389,16927,30749,99370950,2008
IL,education - higher education other,26812,108850074,30748,20753101,2249712,39733,57560,129603175,2008
IL,education - other,2107,9930866,2,5026,230,2108,2109,9935892,2008
IL,libraries,0,0,0,0,0,0,0,0,2008
IL,liquor stores,0,0,0,0,0,0,0,0,2008
IL,other and unallocable,6621,31737722,210,429371,21542,6752,6831,32167093,2008
IN,total,78091,318029605,37940,32284276,2294495,91166,116031,350313881,2008
IN,financial administration,2414,10198627,29,41943,2505,2429,2443,10240570,2008
IN,other government administration,493,2215998,207,392017,17607,599,700,2608015,2008
IN,judicial and legal,1364,9030065,41,67301,3013,1382,1405,9097366,2008
IN,police protection - officers,1291,5501617,0,0,0,1291,1291,5501617,2008
IN,police protection - other,806,2621916,1,1131,100,807,807,2623047,2008
IN,corrections,7476,25360343,4,3996,383,7478,7480,25364339,2008
IN,highways,4590,15831971,32,39006,3385,4610,4622,15870977,2008
IN,air transportation,0,0,0,0,0,0,0,0,2008
IN,water transport and terminals,26,134323,0,0,0,26,26,134323,2008
IN,public welfare,4904,16642803,112,51541,4677,4931,5016,16694344,2008
IN,health,1901,7893406,9,23579,755,1906,1910,7916985,2008
IN,hospitals,2559,8490415,55,72397,5142,2590,2614,8562812,2008
IN,social insurance administration,1170,3952751,154,177948,16162,1267,1324,4130699,2008
IN,solid waste management,0,0,0,0,0,0,0,0,2008
IN,sewerage,0,0,0,0,0,0,0,0,2008
IN,parks and recreation,132,447771,40,39557,3494,153,172,487328,2008
IN,housing and community development,0,0,0,0,0,0,0,0,2008
IN,natural resources,2276,8580141,588,553487,48031,2562,2864,9133628,2008
IN,water transport and terminals,0,0,0,0,0,0,0,0,2008
IN,electric power,0,0,0,0,0,0,0,0,2008
IN,gas supply,0,0,0,0,0,0,0,0,2008
IN,transit,0,0,0,0,0,0,0,0,2008
IN,education - elementary and secondary instructional,0,0,0,0,0,0,0,0,2008
IN,education - elementary and secondary other,0,0,0,0,0,0,0,0,2008
IN,education - higher education instructional,17485,98322387,11930,16172891,883950,22491,29415,114495278,2008
IN,education - higher education other,25896,90300763,24494,14496900,1293228,33262,50390,104797663,2008
IN,education - other,1147,4435498,149,69318,6630,1187,1296,4504816,2008
IN,libraries,0,0,0,0,0,0,0,0,2008
IN,liquor stores,0,0,0,0,0,0,0,0,2008
IN,other and unallocable,2161,8068810,95,81264,5433,2195,2256,8150074,2008
IA,total,42551,219777563,24956,35342651,2122980,54547,67507,255120214,2008
IA,financial administration,1166,5198149,67,166689,9004,1216,1233,5364838,2008
IA,other government administration,355,1823065,294,713320,38724,573,649,2536385,2008
IA,judicial and legal,2267,11329985,161,356095,18221,2370,2428,11686080,2008
IA,police protection - officers,645,3884879,0,0,0,645,645,3884879,2008
IA,police protection - other,328,1485878,31,28459,1999,339,359,1514337,2008
IA,corrections,3312,14322789,215,560156,23766,3446,3527,14882945,2008
IA,highways,2410,10721822,0,0,0,2410,2410,10721822,2008
IA,air transportation,0,0,0,0,0,0,0,0,2008
IA,water transport and terminals,0,0,0,0,0,0,0,0,2008
IA,public welfare,3094,12823949,83,169332,7731,3138,3177,12993281,2008
IA,health,424,2198170,51,83368,3629,445,475,2281538,2008
IA,hospitals,6600,35962647,3344,5983830,300332,8295,9944,41946477,2008
IA,social insurance administration,676,2979102,4,6680,566,679,680,2985782,2008
IA,solid waste management,0,0,0,0,0,0,0,0,2008
IA,sewerage,0,0,0,0,0,0,0,0,2008
IA,parks and recreation,121,601577,17,13844,1683,131,138,615421,2008
IA,housing and community development,0,0,0,0,0,0,0,0,2008
IA,natural resources,1599,8473654,227,291892,22016,1724,1826,8765546,2008
IA,water transport and terminals,0,0,0,0,0,0,0,0,2008
IA,electric power,0,0,0,0,0,0,0,0,2008
IA,gas supply,0,0,0,0,0,0,0,0,2008
IA,transit,0,0,0,0,0,0,0,0,2008
IA,education - elementary and secondary instructional,0,0,0,0,0,0,0,0,2008
IA,education - elementary and secondary other,0,0,0,0,0,0,0,0,2008
IA,education - higher education instructional,3626,32534226,7047,16927113,819802,8258,10673,49461339,2008
IA,education - higher education other,12106,57238998,12911,9155358,827284,16780,25017,66394356,2008
IA,education - other,1090,5184405,131,227232,10739,1152,1221,5411637,2008
IA,libraries,0,0,0,0,0,0,0,0,2008
IA,liquor stores,0,0,0,0,0,0,0,0,2008
IA,other and unallocable,2732,13014268,373,659283,37484,2946,3105,13673551,2008
KS,total,40185,156507926,16982,15954837,1027551,45989,57167,172462763,2008
KS,financial administration,1928,6684637,90,93273,5508,1959,2018,6777910,2008
KS,other government administration,524,1606046,210,575065,25820,671,734,2181111,2008
KS,judicial and legal,2097,8163613,214,213655,13520,2173,2311,8377268,2008
KS,police protection - officers,396,1924415,19,33593,1897,407,415,1958008,2008
KS,police protection - other,718,2823275,44,49726,3155,736,762,2873001,2008
KS,corrections,3811,11374454,26,36126,1902,3822,3837,11410580,2008
KS,highways,3351,10973795,135,155958,11017,3413,3486,11129753,2008
KS,air transportation,0,0,0,0,0,0,0,0,2008
KS,water transport and terminals,0,0,0,0,0,0,0,0,2008
KS,public welfare,2426,7513899,91,106406,9269,2478,2517,7620305,2008
KS,health,1243,4758215,40,69351,2815,1259,1283,4827566,2008
KS,hospitals,3087,8982589,430,226190,10434,3146,3517,9208779,2008
KS,social insurance administration,100,318435,4,4778,283,102,104,323213,2008
KS,solid waste management,0,0,0,0,0,0,0,0,2008
KS,sewerage,0,0,0,0,0,0,0,0,2008
KS,parks and recreation,623,1640237,11,3498,168,624,634,1643735,2008
KS,housing and community development,0,0,0,0,0,0,0,0,2008
KS,natural resources,809,3067903,97,76772,6808,847,906,3144675,2008
KS,water transport and terminals,0,0,0,0,0,0,0,0,2008
KS,electric power,0,0,0,0,0,0,0,0,2008
KS,gas supply,0,0,0,0,0,0,0,0,2008
KS,transit,0,0,0,0,0,0,0,0,2008
KS,education - elementary and secondary instructional,0,0,0,0,0,0,0,0,2008
KS,education - elementary and secondary other,0,0,0,0,0,0,0,0,2008
KS,education - higher education instructional,5005,35136238,3642,5496403,230895,6309,8647,40632641,2008
KS,education - higher education other,10427,38103707,11525,8280092,681245,14275,21952,46383799,2008
KS,education - other,566,2185036,78,86231,2964,583,644,2271267,2008
KS,libraries,0,0,0,0,0,0,0,0,2008
KS,liquor stores,0,0,0,0,0,0,0,0,2008
KS,other and unallocable,3074,11251432,326,447720,19851,3185,3400,11699152,2008
KY,total,71950,279029531,24249,28682217,1573274,81190,96199,307711748,2008
KY,financial administration,2642,10101463,6,11776,540,2645,2648,10113239,2008
KY,other government administration,957,4710017,370,872082,31427,1146,1327,5582099,2008
KY,judicial and legal,4815,17045613,644,1345919,87879,5345,5459,18391532,2008
KY,police protection - officers,989,4000749,0,0,0,989,989,4000749,2008
KY,police protection - other,1300,5243959,0,0,0,1300,1300,5243959,2008
KY,corrections,4108,11382575,0,0,0,4108,4108,11382575,2008
KY,highways,4590,16113916,0,0,0,4590,4590,16113916,2008
KY,air transportation,0,0,0,0,0,0,0,0,2008
KY,water transport and terminals,0,0,0,0,0,0,0,0,2008
KY,public welfare,6496,20365139,0,0,0,6496,6496,20365139,2008
KY,health,2113,7633988,132,179086,10740,2174,2245,7813074,2008
KY,hospitals,5047,19173468,360,1024933,54049,5352,5407,20198401,2008
KY,social insurance administration,986,3193900,0,0,0,986,986,3193900,2008
KY,solid waste management,0,0,0,0,0,0,0,0,2008
KY,sewerage,0,0,0,0,0,0,0,0,2008
KY,parks and recreation,1225,3172257,114,125125,15249,1317,1339,3297382,2008
KY,housing and community development,0,0,0,0,0,0,0,0,2008
KY,natural resources,3102,10540848,506,512918,51066,3403,3608,11053766,2008
KY,water transport and terminals,0,0,0,0,0,0,0,0,2008
KY,electric power,0,0,0,0,0,0,0,0,2008
KY,gas supply,0,0,0,0,0,0,0,0,2008
KY,transit,0,0,0,0,0,0,0,0,2008
KY,education - elementary and secondary instructional,0,0,0,0,0,0,0,0,2008
KY,education - elementary and secondary other,0,0,0,0,0,0,0,0,2008
KY,education - higher education instructional,9123,60153880,7324,12003078,513487,12158,16447,72156958,2008
KY,education - higher education other,18026,62463614,14630,12443443,801250,22705,32656,74907057,2008
KY,education - other,2640,10618623,153,151935,7063,2683,2793,10770558,2008
KY,libraries,0,0,0,0,0,0,0,0,2008
KY,liquor stores,0,0,0,0,0,0,0,0,2008
KY,other and unallocable,3791,13115522,10,11922,524,3793,3801,13127444,2008
LA,total,83984,336546420,22763,21057205,1392898,91854,106747,357603625,2008
LA,financial administration,2440,9240198,126,139335,10671,2501,2566,9379533,2008
LA,other government administration,2118,8793555,483,607187,36465,2322,2601,9400742,2008
LA,judicial and legal,1500,6119491,60,41917,2844,1516,1560,6161408,2008
LA,police protection - officers,1202,6793553,0,0,0,1202,1202,6793553,2008
LA,police protection - other,538,1926256,22,15111,1203,545,560,1941367,2008
LA,corrections,7537,27703840,196,220036,22136,7662,7733,27923876,2008
LA,highways,4825,17908716,7,13492,1212,4832,4832,17922208,2008
LA,air transportation,0,0,0,0,0,0,0,0,2008
LA,water transport and terminals,271,1340194,2,4234,204,272,273,1344428,2008
LA,public welfare,6000,20670810,35,38708,2307,6013,6035,20709518,2008
LA,health,3987,17701124,64,94838,5132,4016,4051,17795962,2008
LA,hospitals,13946,50976536,1590,3020027,137300,14721,15536,53996563,2008
LA,social insurance administration,822,3025564,56,65340,5021,850,878,3090904,2008
LA,solid waste management,0,0,0,0,0,0,0,0,2008
LA,sewerage,0,0,0,0,0,0,0,0,2008
LA,parks and recreation,969,2551725,156,130367,12976,1042,1125,2682092,2008
LA,housing and community development,0,0,0,0,0,0,0,0,2008
LA,natural resources,4369,17249284,794,669135,58957,4702,5163,17918419,2008
LA,water transport and terminals,0,0,0,0,0,0,0,0,2008
LA,electric power,0,0,0,0,0,0,0,0,2008
LA,gas supply,0,0,0,0,0,0,0,0,2008
LA,transit,0,0,0,0,0,0,0,0,2008
LA,education - elementary and secondary instructional,1013,3446928,12,17068,531,1016,1025,3463996,2008
LA,education - elementary and secondary other,159,628344,3,14956,399,161,162,643300,2008
LA,education - higher education instructional,8049,51364766,5182,7501971,363971,10106,13231,58866737,2008
LA,education - higher education other,15829,55620704,12802,7152101,667813,19603,28631,62772805,2008
LA,education - other,5564,22262643,936,1108503,47673,5836,6500,23371146,2008
LA,libraries,0,0,0,0,0,0,0,0,2008
LA,liquor stores,0,0,0,0,0,0,0,0,2008
LA,other and unallocable,2846,11222189,237,202879,16083,2936,3083,11425068,2008
ME,total,20507,81348018,8409,7801837,453269,23075,28916,89149855,2008
ME,financial administration,1394,4894367,85,157962,9799,1450,1479,5052329,2008
ME,other government administration,339,1617882,220,567177,25959,485,559,2185059,2008
ME,judicial and legal,729,3328357,68,123353,5741,761,797,3451710,2008
ME,police protection - officers,343,1993337,22,40127,1145,349,365,2033464,2008
ME,police protection - other,186,642467,8,9514,456,189,194,651981,2008
ME,corrections,1285,5374268,53,114707,5999,1319,1338,5488975,2008
ME,highways,2374,9102387,96,134926,7945,2419,2470,9237313,2008
ME,air transportation,0,0,0,0,0,0,0,0,2008
ME,water transport and terminals,74,273070,11,11136,970,79,85,284206,2008
ME,public welfare,3089,10616536,95,197214,8460,3137,3184,10813750,2008
ME,health,1108,4475153,49,146438,6046,1142,1157,4621591,2008
ME,hospitals,565,2297287,64,123085,5982,598,629,2420372,2008
ME,social insurance administration,320,1161196,18,41327,1979,332,338,1202523,2008
ME,solid waste management,0,0,0,0,0,0,0,0,2008
ME,sewerage,0,0,0,0,0,0,0,0,2008
ME,parks and recreation,153,544571,30,48464,2767,168,183,593035,2008
ME,housing and community development,0,0,0,0,0,0,0,0,2008
ME,natural resources,1070,4290704,244,313589,13608,1147,1314,4604293,2008
ME,water transport and terminals,0,0,0,0,0,0,0,0,2008
ME,electric power,0,0,0,0,0,0,0,0,2008
ME,gas supply,0,0,0,0,0,0,0,0,2008
ME,transit,0,0,0,0,0,0,0,0,2008
ME,education - elementary and secondary instructional,15,45848,35,18217,1393,23,50,64065,2008
ME,education - elementary and secondary other,7,18637,29,29595,3303,26,36,48232,2008
ME,education - higher education instructional,1726,9609072,2312,2978974,122906,2424,4038,12588046,2008
ME,education - higher education other,3855,13531341,4868,2501115,216847,5085,8723,16032456,2008
ME,education - other,251,956435,15,27662,1667,261,266,984097,2008
ME,libraries,0,0,0,0,0,0,0,0,2008
ME,liquor stores,1,3786,0,0,0,1,1,3786,2008
ME,other and unallocable,1623,6571317,87,217255,10297,1680,1710,6788572,2008
MD,total,81044,364067309,13529,34699529,1435018,89153,94573,398766838,2008
MD,financial administration,3447,15343173,107,239418,12850,3520,3554,15582591,2008
MD,other government administration,1442,7564815,308,597563,16899,1537,1750,8162378,2008
MD,judicial and legal,4698,24987895,442,1014900,60544,5040,5140,26002795,2008
MD,police protection - officers,1550,8806973,0,0,0,1550,1550,8806973,2008
MD,police protection - other,814,3104393,32,82308,4851,841,846,3186701,2008
MD,corrections,11944,50952201,410,966655,60294,12285,12354,51918856,2008
MD,highways,4752,20655161,68,115985,5670,4784,4820,20771146,2008
MD,air transportation,489,2358375,14,31924,1328,497,503,2390299,2008
MD,water transport and terminals,281,1511117,8,20426,642,285,289,1531543,2008
MD,public welfare,6647,25570646,111,259432,16074,6738,6758,25830078,2008
MD,health,6367,27071306,764,1489823,86903,6857,7131,28561129,2008
MD,hospitals,4548,17829925,577,883376,50169,4831,5125,18713301,2008
MD,social insurance administration,826,3110074,151,326496,19401,936,977,3436570,2008
MD,solid waste management,0,0,0,0,0,0,0,0,2008
MD,sewerage,0,0,0,0,0,0,0,0,2008
MD,parks and recreation,313,1374965,183,294595,20515,429,496,1669560,2008
MD,housing and community development,0,0,0,0,0,0,0,0,2008
MD,natural resources,1909,9060971,317,679783,38101,2125,2226,9740754,2008
MD,water transport and terminals,0,0,0,0,0,0,0,0,2008
MD,electric power,0,0,0,0,0,0,0,0,2008
MD,gas supply,0,0,0,0,0,0,0,0,2008
MD,transit,749,3800548,24,40897,2247,762,773,3841445,2008
MD,education - elementary and secondary instructional,0,0,0,0,0,0,0,0,2008
MD,education - elementary and secondary other,0,0,0,0,0,0,0,0,2008
MD,education - higher education instructional,6860,46271770,4606,20380069,600160,10250,11466,66651839,2008
MD,education - higher education other,14797,56630229,4410,5292737,334386,16686,19207,61922966,2008
MD,education - other,2083,9858499,323,709582,32873,2268,2406,10568081,2008
MD,libraries,0,0,0,0,0,0,0,0,2008
MD,liquor stores,0,0,0,0,0,0,0,0,2008
MD,other and unallocable,6528,28204273,674,1273560,71111,6932,7202,29477833,2008
MA,total,86048,414972236,32154,47182744,1948606,97601,118202,462154980,2008
MA,financial administration,3982,19886771,297,1003838,20208,4105,4279,20890609,2008
MA,other government administration,1697,6160075,290,1154900,25633,1844,1987,7314975,2008
MA,judicial and legal,9831,48268696,486,1693808,51419,10141,10317,49962504,2008
MA,police protection - officers,5964,34875355,103,218856,5382,5997,6067,35094211,2008
MA,police protection - other,668,2885603,5,16104,290,669,673,2901707,2008
MA,corrections,6082,28620256,58,175765,3077,6100,6140,28796021,2008
MA,highways,3461,18740427,192,618634,23404,3594,3653,19359061,2008
MA,air transportation,1013,6109409,0,0,0,1013,1013,6109409,2008
MA,water transport and terminals,160,960318,0,0,0,160,160,960318,2008
MA,public welfare,6856,32472339,623,1864767,37767,7084,7479,34337106,2008
MA,health,7178,28577484,1105,2950726,103914,7805,8283,31528210,2008
MA,hospitals,7264,29129789,965,2397434,90916,7784,8229,31527223,2008
MA,social insurance administration,1321,6155790,55,212878,7029,1363,1376,6368668,2008
MA,solid waste management,0,0,0,0,0,0,0,0,2008
MA,sewerage,863,5267684,38,174821,3880,885,901,5442505,2008
MA,parks and recreation,594,2345456,68,71759,3368,613,662,2417215,2008
MA,housing and community development,0,0,0,0,0,0,0,0,2008
MA,natural resources,1156,6284338,157,558717,19527,1275,1313,6843055,2008
MA,water transport and terminals,522,3077648,21,76137,1670,531,543,3153785,2008
MA,electric power,0,0,0,0,0,0,0,0,2008
MA,gas supply,0,0,0,0,0,0,0,0,2008
MA,transit,0,0,0,0,0,0,0,0,2008
MA,education - elementary and secondary instructional,60,290352,2,3650,160,61,62,294002,2008
MA,education - elementary and secondary other,34,142316,13,6110,454,37,47,148426,2008
MA,education - higher education instructional,5918,36425495,10634,16178941,548223,9214,16552,52604436,2008
MA,education - higher education other,15130,65050285,16626,16446240,971293,20844,31756,81496525,2008
MA,education - other,1189,6269714,77,261090,8262,1239,1266,6530804,2008
MA,libraries,0,0,0,0,0,0,0,0,2008
MA,liquor stores,0,0,0,0,0,0,0,0,2008
MA,other and unallocable,5105,26976636,339,1097569,22730,5243,5444,28074205,2008
MI,total,114825,544989043,63525,73962631,4557457,140585,178350,618951674,2008
MI,financial administration,3950,18225909,705,1949630,88803,4452,4655,20175539,2008
MI,other government administration,1447,5721558,0,0,0,1447,1447,5721558,2008
MI,judicial and legal,1457,9265690,35,149714,4056,1480,1492,9415404,2008
MI,police protection - officers,1735,8276914,0,0,0,1735,1735,8276914,2008
MI,police protection - other,934,2791998,41,77986,2936,951,975,2869984,2008
MI,corrections,15880,71044582,175,772140,24057,16016,16055,71816722,2008
MI,highways,2731,12150826,298,687258,29652,2899,3029,12838084,2008
MI,air transportation,0,0,0,0,0,0,0,0,2008
MI,water transport and terminals,0,0,0,0,0,0,0,0,2008
MI,public welfare,9314,37055538,377,1323198,52778,9612,9691,38378736,2008
MI,health,1838,8307670,247,470942,19963,1951,2085,8778612,2008
MI,hospitals,13381,60096060,6203,20345566,935396,18666,19584,80441626,2008
MI,social insurance administration,974,4363265,41,89047,4669,1000,1015,4452312,2008
MI,solid waste management,0,0,0,0,0,0,0,0,2008
MI,sewerage,0,0,0,0,0,0,0,0,2008
MI,parks and recreation,207,895118,101,305399,11451,272,308,1200517,2008
MI,housing and community development,0,0,0,0,0,0,0,0,2008
MI,natural resources,3520,15317691,1023,1422847,85537,4003,4543,16740538,2008
MI,water transport and terminals,0,0,0,0,0,0,0,0,2008
MI,electric power,0,0,0,0,0,0,0,0,2008
MI,gas supply,0,0,0,0,0,0,0,0,2008
MI,transit,0,0,0,0,0,0,0,0,2008
MI,education - elementary and secondary instructional,42,136222,17,29876,2101,54,59,166098,2008
MI,education - elementary and secondary other,9,27967,3,4663,343,11,12,32630,2008
MI,education - higher education instructional,18065,125695670,8887,14411292,582544,21368,26952,140106962,2008
MI,education - higher education other,33174,137690418,44946,30971764,2671286,48264,78120,168662182,2008
MI,education - other,376,2023268,122,445864,18817,482,498,2469132,2008
MI,libraries,0,0,0,0,0,0,0,0,2008
MI,liquor stores,0,0,0,0,0,0,0,0,2008
MI,other and unallocable,5791,25902679,304,505445,23068,5922,6095,26408124,2008
MN,total,65046,329797906,28925,45177513,2491568,79128,93971,374975419,2008
MN,financial administration,2508,11983148,117,269068,17954,2610,2625,12252216,2008
MN,other government administration,976,4673815,228,558384,30375,1148,1204,5232199,2008
MN,judicial and legal,3141,15935954,468,1627293,66225,3516,3609,17563247,2008
MN,police protection - officers,538,2909209,0,0,0,538,538,2909209,2008
MN,police protection - other,417,1512789,47,89111,4618,443,464,1601900,2008
MN,corrections,4002,16903013,158,451065,20840,4120,4160,17354078,2008
MN,highways,4266,20170879,215,367143,20530,4382,4481,20538022,2008
MN,air transportation,0,0,0,0,0,0,0,0,2008
MN,water transport and terminals,0,0,0,0,0,0,0,0,2008
MN,public welfare,1793,8153813,1279,3001252,216941,3019,3072,11155065,2008
MN,health,2272,11273960,256,637221,27641,2428,2528,11911181,2008
MN,hospitals,3838,17979659,1580,4252952,277507,5406,5418,22232611,2008
MN,social insurance administration,1072,4796684,113,264245,12666,1144,1185,5060929,2008
MN,solid waste management,0,0,0,0,0,0,0,0,2008
MN,sewerage,648,3589144,9,26670,1003,654,657,3615814,2008
MN,parks and recreation,538,2403504,164,206578,11934,606,702,2610082,2008
MN,housing and community development,0,0,0,0,0,0,0,0,2008
MN,natural resources,2683,12644274,639,1100308,70406,3081,3322,13744582,2008
MN,water transport and terminals,0,0,0,0,0,0,0,0,2008
MN,electric power,0,0,0,0,0,0,0,0,2008
MN,gas supply,0,0,0,0,0,0,0,0,2008
MN,transit,2253,10360163,400,902008,50112,2536,2653,11262171,2008
MN,education - elementary and secondary instructional,0,0,0,0,0,0,0,0,2008
MN,education - elementary and secondary other,0,0,0,0,0,0,0,0,2008
MN,education - higher education instructional,10852,65820613,10478,15945362,646499,14504,21330,81765975,2008
MN,education - higher education other,16549,85937435,11381,13235870,913625,21711,27930,99173305,2008
MN,education - other,3361,16594533,1187,1772960,80216,3815,4548,18367493,2008
MN,libraries,0,0,0,0,0,0,0,0,2008
MN,liquor stores,0,0,0,0,0,0,0,0,2008
MN,other and unallocable,3339,16155317,206,470023,22476,3467,3545,16625340,2008
MS,total,51879,174555945,12354,11906647,928600,57337,64233,186462592,2008
MS,financial administration,1364,4844997,57,81709,5895,1397,1421,4926706,2008
MS,other government administration,462,1703929,66,78129,3032,479,528,1782058,2008
MS,judicial and legal,695,3905132,9,11824,418,697,704,3916956,2008
MS,police protection - officers,711,2531687,0,0,0,711,711,2531687,2008
MS,police protection - other,569,1541508,0,0,0,569,569,1541508,2008
MS,corrections,3603,9465816,21,35934,2603,3618,3624,9501750,2008
MS,highways,3302,9464268,13,23626,1816,3312,3315,9487894,2008
MS,air transportation,0,0,0,0,0,0,0,0,2008
MS,water transport and terminals,42,172552,0,0,0,42,42,172552,2008
MS,public welfare,2534,6405292,0,0,0,2534,2534,6405292,2008
MS,health,2810,9515545,81,200336,8899,2860,2891,9715881,2008
MS,hospitals,11872,34096303,408,788935,41158,12105,12280,34885238,2008
MS,social insurance administration,776,2533382,232,477170,36023,980,1008,3010552,2008
MS,solid waste management,0,0,0,0,0,0,0,0,2008
MS,sewerage,0,0,0,0,0,0,0,0,2008
MS,parks and recreation,347,803037,81,60371,7162,387,428,863408,2008
MS,housing and community development,0,0,0,0,0,0,0,0,2008
MS,natural resources,3020,9332932,772,795370,61718,3369,3792,10128302,2008
MS,water transport and terminals,45,128873,13,16487,1169,51,58,145360,2008
MS,electric power,0,0,0,0,0,0,0,0,2008
MS,gas supply,0,0,0,0,0,0,0,0,2008
MS,transit,0,0,0,0,0,0,0,0,2008
MS,education - elementary and secondary instructional,0,0,0,0,0,0,0,0,2008
MS,education - elementary and secondary other,0,0,0,0,0,0,0,0,2008
MS,education - higher education instructional,5658,30404596,1495,2456777,122317,6371,7153,32861373,2008
MS,education - higher education other,9429,32867733,8975,6715961,626689,13161,18404,39583694,2008
MS,education - other,1584,5077108,34,50764,3149,1602,1618,5127872,2008
MS,libraries,0,0,0,0,0,0,0,0,2008
MS,liquor stores,122,329347,0,0,0,122,122,329347,2008
MS,other and unallocable,2934,9431908,97,113254,6552,2970,3031,9545162,2008
MO,total,79565,261861210,26259,22469292,1723198,89349,105824,284330502,2008
MO,financial administration,3100,10573356,314,286646,26292,3249,3414,10860002,2008
MO,other government administration,762,2495216,226,546372,26613,953,988,3041588,2008
MO,judicial and legal,3286,9683970,302,423582,32482,3470,3588,10107552,2008
MO,police protection - officers,1198,5100010,1,440,22,1198,1199,5100450,2008
MO,police protection - other,1124,3391768,115,184000,17400,1222,1239,3575768,2008
MO,corrections,12150,30405312,336,291474,23642,12284,12486,30696786,2008
MO,highways,6345,23252116,367,321422,21520,6467,6712,23573538,2008
MO,air transportation,0,0,0,0,0,0,0,0,2008
MO,water transport and terminals,0,0,0,0,0,0,0,0,2008
MO,public welfare,7871,19858270,619,587732,43714,8117,8490,20446002,2008
MO,health,2707,7443446,245,333798,18444,2810,2952,7777244,2008
MO,hospitals,10955,32003204,1322,1865236,119394,11630,12277,33868440,2008
MO,social insurance administration,471,1411304,9,11172,600,474,480,1422476,2008
MO,solid waste management,0,0,0,0,0,0,0,0,2008
MO,sewerage,0,0,0,0,0,0,0,0,2008
MO,parks and recreation,578,1624090,184,117790,12158,647,762,1741880,2008
MO,housing and community development,0,0,0,0,0,0,0,0,2008
MO,natural resources,2459,7866847,600,522748,54861,2769,3059,8389595,2008
MO,water transport and terminals,0,0,0,0,0,0,0,0,2008
MO,electric power,0,0,0,0,0,0,0,0,2008
MO,gas supply,0,0,0,0,0,0,0,0,2008
MO,transit,0,0,0,0,0,0,0,0,2008
MO,education - elementary and secondary instructional,0,0,0,0,0,0,0,0,2008
MO,education - elementary and secondary other,0,0,0,0,0,0,0,0,2008
MO,education - higher education instructional,7931,44021693,7552,8394471,495884,10734,15483,52416164,2008
MO,education - higher education other,13551,46378238,12640,6413273,695498,17488,26191,52791511,2008
MO,education - other,1049,3330402,1150,1925006,117930,1715,2199,5255408,2008
MO,libraries,0,0,0,0,0,0,0,0,2008
MO,liquor stores,0,0,0,0,0,0,0,0,2008
MO,other and unallocable,4028,13021968,277,244130,16744,4122,4305,13266098,2008
MT,total,16834,64335996,8577,7936525,539270,19881,25411,72272521,2008
MT,financial administration,975,3410848,97,138900,9459,1029,1072,3549748,2008
MT,other government administration,353,1466570,86,100735,6220,389,439,1567305,2008
MT,judicial and legal,629,2638606,128,276725,11249,693,757,2915331,2008
MT,police protection - officers,218,601498,0,0,0,218,218,601498,2008
MT,police protection - other,226,810263,12,20655,1138,233,238,830918,2008
MT,corrections,1220,4115755,41,76463,4295,1244,1261,4192218,2008
MT,highways,2113,8750899,130,192764,10654,2173,2243,8943663,2008
MT,air transportation,0,0,0,0,0,0,0,0,2008
MT,water transport and terminals,0,0,0,0,0,0,0,0,2008
MT,public welfare,1540,5262370,198,352466,23136,1670,1738,5614836,2008
MT,health,829,2967309,89,175880,9128,880,918,3143189,2008
MT,hospitals,529,1783547,94,175218,10067,586,623,1958765,2008
MT,social insurance administration,721,2804958,28,48238,2845,737,749,2853196,2008
MT,solid waste management,0,0,0,0,0,0,0,0,2008
MT,sewerage,0,0,0,0,0,0,0,0,2008
MT,parks and recreation,71,243936,29,20619,1601,80,100,264555,2008
MT,housing and community development,0,0,0,0,0,0,0,0,2008
MT,natural resources,1381,5206195,253,300405,21281,1502,1634,5506600,2008
MT,water transport and terminals,0,0,0,0,0,0,0,0,2008
MT,electric power,0,0,0,0,0,0,0,0,2008
MT,gas supply,0,0,0,0,0,0,0,0,2008
MT,transit,0,0,0,0,0,0,0,0,2008
MT,education - elementary and secondary instructional,0,0,0,0,0,0,0,0,2008
MT,education - elementary and secondary other,0,0,0,0,0,0,0,0,2008
MT,education - higher education instructional,1374,7800415,1455,2181865,97974,1926,2829,9982280,2008
MT,education - higher education other,3221,10787878,5751,3588188,312407,4986,8972,14376066,2008
MT,education - other,327,1258415,96,142272,9536,381,423,1400687,2008
MT,libraries,0,0,0,0,0,0,0,0,2008
MT,liquor stores,26,84522,4,5154,421,28,30,89676,2008
MT,other and unallocable,1081,4342012,86,139978,7859,1126,1167,4481990,2008
NE,total,26967,99654393,10609,10244148,936017,32251,37576,109898541,2008
NE,financial administration,768,2581604,12,14981,1089,774,780,2596585,2008
NE,other government administration,274,1126925,98,98213,6440,310,372,1225138,2008
NE,judicial and legal,707,3238428,54,41667,3294,725,761,3280095,2008
NE,police protection - officers,495,2167840,0,0,0,495,495,2167840,2008
NE,police protection - other,245,757043,2,2965,221,246,247,760008,2008
NE,corrections,2836,8772313,88,116025,9453,2890,2924,8888338,2008
NE,highways,2100,7194526,11,21197,1134,2106,2111,7215723,2008
NE,air transportation,24,94051,0,0,0,24,24,94051,2008
NE,water transport and terminals,0,0,0,0,0,0,0,0,2008
NE,public welfare,2440,6907793,233,304721,19782,2552,2673,7212514,2008
NE,health,684,2557326,66,133920,8652,732,750,2691246,2008
NE,hospitals,3260,11324332,882,1628913,117662,3925,4142,12953245,2008
NE,social insurance administration,315,1098675,5,7094,372,317,320,1105769,2008
NE,solid waste management,0,0,0,0,0,0,0,0,2008
NE,sewerage,0,0,0,0,0,0,0,0,2008
NE,parks and recreation,241,716057,143,119783,15270,327,384,835840,2008
NE,housing and community development,0,0,0,0,0,0,0,0,2008
NE,natural resources,1594,5298866,769,1334539,105077,2188,2363,6633405,2008
NE,water transport and terminals,0,0,0,0,0,0,0,0,2008
NE,electric power,0,0,0,0,0,0,0,0,2008
NE,gas supply,0,0,0,0,0,0,0,0,2008
NE,transit,0,0,0,0,0,0,0,0,2008
NE,education - elementary and secondary instructional,0,0,0,0,0,0,0,0,2008
NE,education - elementary and secondary other,0,0,0,0,0,0,0,0,2008
NE,education - higher education instructional,2791,17087537,1095,1798586,91068,3306,3886,18886123,2008
NE,education - higher education other,5980,20201764,6867,4470185,546992,9070,12847,24671949,2008
NE,education - other,575,2172417,17,20621,1080,581,592,2193038,2008
NE,libraries,0,0,0,0,0,0,0,0,2008
NE,liquor stores,0,0,0,0,0,0,0,0,2008
NE,other and unallocable,1638,6356896,267,130738,8431,1683,1905,6487634,2008
NV,total,25232,119912689,10209,11054519,566944,28437,35441,130967208,2008
NV,financial administration,1451,5595407,24,41344,1234,1459,1475,5636751,2008
NV,other government administration,968,4539961,65,76444,3302,987,1033,4616405,2008
NV,judicial and legal,656,4220520,26,58084,1057,662,682,4278604,2008
NV,police protection - officers,425,2646981,0,0,0,425,425,2646981,2008
NV,police protection - other,396,1879229,0,0,0,396,396,1879229,2008
NV,corrections,3749,17535595,61,198890,3748,3771,3810,17734485,2008
NV,highways,1762,8075662,4,4911,403,1764,1766,8080573,2008
NV,air transportation,0,0,0,0,0,0,0,0,2008
NV,water transport and terminals,0,0,0,0,0,0,0,0,2008
NV,public welfare,1576,6187128,14,26185,932,1581,1590,6213313,2008
NV,health,1269,5870547,40,100903,2708,1285,1309,5971450,2008
NV,hospitals,1369,6923003,152,605060,20758,1486,1521,7528063,2008
NV,social insurance administration,437,1713069,2,2309,89,438,439,1715378,2008
NV,solid waste management,0,0,0,0,0,0,0,0,2008
NV,sewerage,0,0,0,0,0,0,0,0,2008
NV,parks and recreation,194,788844,8,15620,540,197,202,804464,2008
NV,housing and community development,0,0,0,0,0,0,0,0,2008
NV,natural resources,902,4110757,91,88811,4047,925,993,4199568,2008
NV,water transport and terminals,16,103684,0,0,0,16,16,103684,2008
NV,electric power,16,103684,0,0,0,16,16,103684,2008
NV,gas supply,0,0,0,0,0,0,0,0,2008
NV,transit,0,0,0,0,0,0,0,0,2008
NV,education - elementary and secondary instructional,0,0,0,0,0,0,0,0,2008
NV,education - elementary and secondary other,0,0,0,0,0,0,0,0,2008
NV,education - higher education instructional,2285,15163545,4152,5788620,237871,3629,6437,20952165,2008
NV,education - higher education other,5446,23396327,5503,3945790,286561,7065,10949,27342117,2008
NV,education - other,145,697420,2,4083,95,146,147,701503,2008
NV,libraries,0,0,0,0,0,0,0,0,2008
NV,liquor stores,0,0,0,0,0,0,0,0,2008
NV,other and unallocable,2170,10361326,65,97465,3599,2189,2235,10458791,2008
NH,total,16316,71258895,9408,10419358,571686,19753,25724,81678253,2008
NH,financial administration,887,3812957,48,69549,4546,912,935,3882506,2008
NH,other government administration,330,1374761,108,125341,9269,385,438,1500102,2008
NH,judicial and legal,996,3986262,6,16133,667,1000,1002,4002395,2008
NH,police protection - officers,326,1865537,0,0,0,326,326,1865537,2008
NH,police protection - other,176,621845,21,28636,2318,190,197,650481,2008
NH,corrections,1295,5900666,64,108845,6614,1335,1359,6009511,2008
NH,highways,1633,6590664,272,357322,23924,1777,1905,6947986,2008
NH,air transportation,48,220587,26,51329,3370,67,74,271916,2008
NH,water transport and terminals,6,22229,5,5174,441,9,11,27403,2008
NH,public welfare,1568,5659478,126,204446,10324,1630,1694,5863924,2008
NH,health,925,4004298,79,95630,6890,966,1004,4099928,2008
NH,hospitals,761,2763099,79,136283,1791,772,840,2899382,2008
NH,social insurance administration,315,1087880,31,46166,2539,330,346,1134046,2008
NH,solid waste management,0,0,0,0,0,0,0,0,2008
NH,sewerage,0,0,0,0,0,0,0,0,2008
NH,parks and recreation,84,289573,259,183397,19525,201,343,472970,2008
NH,housing and community development,0,0,0,0,0,0,0,0,2008
NH,natural resources,364,1655287,118,108295,8124,413,482,1763582,2008
NH,water transport and terminals,27,123047,2,4915,182,28,29,127962,2008
NH,electric power,0,0,0,0,0,0,0,0,2008
NH,gas supply,0,0,0,0,0,0,0,0,2008
NH,transit,0,0,0,0,0,0,0,0,2008
NH,education - elementary and secondary instructional,0,0,0,0,0,0,0,0,2008
NH,education - elementary and secondary other,0,0,0,0,0,0,0,0,2008
NH,education - higher education instructional,1453,10089643,2166,4136913,136828,2276,3619,14226556,2008
NH,education - higher education other,2670,11539220,5160,3991526,266746,4277,7830,15530746,2008
NH,education - other,306,1219916,14,21870,1328,314,320,1241786,2008
NH,libraries,0,0,0,0,0,0,0,0,2008
NH,liquor stores,305,1090309,457,323142,37437,531,762,1413451,2008
NH,other and unallocable,1841,7341637,367,404446,28823,2014,2208,7746083,2008
NJ,total,143058,798286086,37116,45058140,2123780,156373,180174,843344226,2008
NJ,financial administration,6122,28432931,575,1079995,73283,6595,6697,29512926,2008
NJ,other government administration,1328,7364123,29,52907,2531,1345,1357,7417030,2008
NJ,judicial and legal,14282,78504007,255,349193,20815,14416,14537,78853200,2008
NJ,police protection - officers,2935,23436135,0,0,0,2935,2935,23436135,2008
NJ,police protection - other,1642,6761253,36,77229,3044,1662,1678,6838482,2008
NJ,corrections,10262,55492460,14,24164,934,10268,10276,55516624,2008
NJ,highways,6544,34246702,926,1243284,86606,7034,7470,35489986,2008
NJ,air transportation,0,0,0,0,0,0,0,0,2008
NJ,water transport and terminals,97,523260,3,6178,465,100,100,529438,2008
NJ,public welfare,8976,42936113,188,343359,17849,9091,9164,43279472,2008
NJ,health,4082,23395763,409,1196249,18053,4193,4491,24592012,2008
NJ,hospitals,17286,74742203,2564,4867960,252359,18906,19850,79610163,2008
NJ,social insurance administration,1778,8171642,70,132579,7295,1825,1848,8304221,2008
NJ,solid waste management,604,3818335,0,0,0,604,604,3818335,2008
NJ,sewerage,0,0,0,0,0,0,0,0,2008
NJ,parks and recreation,1270,6148348,1633,2667258,153628,2198,2903,8815606,2008
NJ,housing and community development,0,0,0,0,0,0,0,0,2008
NJ,natural resources,2255,12615038,528,836009,27044,2420,2783,13451047,2008
NJ,water transport and terminals,120,578405,2,922,44,120,122,579327,2008
NJ,electric power,0,0,0,0,0,0,0,0,2008
NJ,gas supply,0,0,0,0,0,0,0,0,2008
NJ,transit,10014,53505700,827,1473348,84161,10489,10841,54979048,2008
NJ,education - elementary and secondary instructional,12977,93449547,1970,2770298,102494,13671,14947,96219845,2008
NJ,education - elementary and secondary other,4524,16617952,2548,2559392,167635,5674,7072,19177344,2008
NJ,education - higher education instructional,7638,76986683,7787,13291339,309812,9563,15425,90278022,2008
NJ,education - higher education other,18560,95911590,16038,11244252,737038,23122,34598,107155842,2008
NJ,education - other,2833,15420540,466,588322,44065,3119,3299,16008862,2008
NJ,libraries,0,0,0,0,0,0,0,0,2008
NJ,liquor stores,0,0,0,0,0,0,0,0,2008
NJ,other and unallocable,6929,39227356,248,253903,14625,7023,7177,39481259,2008
NM,total,42860,161466629,13916,14016141,998397,48532,56776,175482770,2008
NM,financial administration,1484,6052175,8,11964,673,1488,1492,6064139,2008
NM,other government administration,231,1190803,12,34073,1551,240,243,1224876,2008
NM,judicial and legal,3257,12277432,150,228534,13817,3336,3407,12505966,2008
NM,police protection - officers,575,2694828,0,0,0,575,575,2694828,2008
NM,police protection - other,159,1229527,0,0,0,159,159,1229527,2008
NM,corrections,4094,14737613,34,83195,3697,4115,4128,14820808,2008
NM,highways,2571,8644386,0,0,0,2571,2571,8644386,2008
NM,air transportation,10,41989,0,0,0,10,10,41989,2008
NM,water transport and terminals,0,0,0,0,0,0,0,0,2008
NM,public welfare,1882,6173586,1,1346,166,1883,1883,6174932,2008
NM,health,2397,9791103,22,59615,3184,2416,2419,9850718,2008
NM,hospitals,6433,24688059,835,1798868,72858,6871,7268,26486927,2008
NM,social insurance administration,235,794308,4,6219,363,237,239,800527,2008
NM,solid waste management,0,0,0,0,0,0,0,0,2008
NM,sewerage,0,0,0,0,0,0,0,0,2008
NM,parks and recreation,744,2611862,42,84048,4649,770,786,2695910,2008
NM,housing and community development,0,0,0,0,0,0,0,0,2008
NM,natural resources,1133,4929933,47,45339,3880,1155,1180,4975272,2008
NM,water transport and terminals,0,0,0,0,0,0,0,0,2008
NM,electric power,0,0,0,0,0,0,0,0,2008
NM,gas supply,0,0,0,0,0,0,0,0,2008
NM,transit,0,0,0,0,0,0,0,0,2008
NM,education - elementary and secondary instructional,0,0,0,0,0,0,0,0,2008
NM,education - elementary and secondary other,0,0,0,0,0,0,0,0,2008
NM,education - higher education instructional,3405,14441930,3886,5239948,226370,4684,7291,19681878,2008
NM,education - higher education other,10803,38328788,8802,6321409,659527,14528,19605,44650197,2008
NM,education - other,1190,4326809,56,70224,5724,1224,1246,4397033,2008
NM,libraries,0,0,0,0,0,0,0,0,2008
NM,liquor stores,0,0,0,0,0,0,0,0,2008
NM,other and unallocable,2257,8511498,17,31359,1938,2270,2274,8542857,2008
NY,total,238844,1206532187,49773,65697269,2690935,254883,288617,1272229456,2008
NY,financial administration,12445,56342410,173,363749,13924,12528,12618,56706159,2008
NY,other government administration,4455,19739926,563,685043,44124,4720,5018,20424969,2008
NY,judicial and legal,20304,124083464,708,2249296,88241,20835,21012,126332760,2008
NY,police protection - officers,4862,39502711,0,0,0,4862,4862,39502711,2008
NY,police protection - other,1744,6945245,152,273818,17160,1842,1896,7219063,2008
NY,corrections,33921,164859681,492,1341124,50141,34224,34413,166200805,2008
NY,highways,12291,58453966,1042,1237370,80484,12748,13333,59691336,2008
NY,air transportation,150,637701,4,9980,297,152,154,647681,2008
NY,water transport and terminals,747,3832292,23,48517,2050,759,770,3880809,2008
NY,public welfare,6170,27481208,509,1150343,61962,6540,6679,28631551,2008
NY,health,9755,50588954,419,1200831,44017,10019,10174,51789785,2008
NY,hospitals,42756,194414230,5139,12689952,516558,45870,47895,207104182,2008
NY,social insurance administration,6949,32121465,83,234790,11333,7017,7032,32356255,2008
NY,solid waste management,0,0,0,0,0,0,0,0,2008
NY,sewerage,0,0,0,0,0,0,0,0,2008
NY,parks and recreation,1864,10226930,1201,2334898,134925,2677,3065,12561828,2008
NY,housing and community development,0,0,0,0,0,0,0,0,2008
NY,natural resources,3483,16867127,88,141681,6064,3519,3571,17008808,2008
NY,water transport and terminals,0,0,0,0,0,0,0,0,2008
NY,electric power,1653,12690057,62,201974,6972,1692,1715,12892031,2008
NY,gas supply,0,0,0,0,0,0,0,0,2008
NY,transit,15972,103076711,270,502168,33077,16159,16242,103578879,2008
NY,education - elementary and secondary instructional,0,0,0,0,0,0,0,0,2008
NY,education - elementary and secondary other,0,0,0,0,0,0,0,0,2008
NY,education - higher education instructional,15527,93660708,16711,19416781,566404,18883,32238,113077489,2008
NY,education - higher education other,25812,103066271,21668,20494373,966667,31572,47480,123560644,2008
NY,education - other,4680,21468609,179,377164,17359,4785,4859,21845773,2008
NY,libraries,0,0,0,0,0,0,0,0,2008
NY,liquor stores,0,0,0,0,0,0,0,0,2008
NY,other and unallocable,13304,66472521,287,743417,29176,13480,13591,67215938,2008
NC,total,128682,505860243,41648,51269882,3044929,145881,170330,557130125,2008
NC,financial administration,4228,15403764,34,74898,3811,4249,4262,15478662,2008
NC,other government administration,735,3838880,420,781116,42036,973,1155,4619996,2008
NC,judicial and legal,6709,30235476,50,86936,4660,6735,6759,30322412,2008
NC,police protection - officers,2580,11928383,0,0,0,2580,2580,11928383,2008
NC,police protection - other,1373,4560976,12,28049,1086,1379,1385,4589025,2008
NC,corrections,21300,67534313,593,1485954,62720,21654,21893,69020267,2008
NC,highways,11135,37205801,17,28335,1654,11144,11152,37234136,2008
NC,air transportation,0,0,0,0,0,0,0,0,2008
NC,water transport and terminals,276,1113055,4,3082,199,277,280,1116137,2008
NC,public welfare,2135,8698868,9,19881,714,2139,2144,8718749,2008
NC,health,4928,20167181,135,284226,14942,5013,5063,20451407,2008
NC,hospitals,15245,54496587,3042,10901135,424294,17643,18287,65397722,2008
NC,social insurance administration,2103,8186869,203,366054,24608,2242,2306,8552923,2008
NC,solid waste management,289,1115892,0,0,0,289,289,1115892,2008
NC,sewerage,0,0,0,0,0,0,0,0,2008
NC,parks and recreation,1047,3553385,189,141920,10588,1106,1236,3695305,2008
NC,housing and community development,0,0,0,0,0,0,0,0,2008
NC,natural resources,3956,14667354,478,636978,40303,4184,4434,15304332,2008
NC,water transport and terminals,0,0,0,0,0,0,0,0,2008
NC,electric power,0,0,0,0,0,0,0,0,2008
NC,gas supply,0,0,0,0,0,0,0,0,2008
NC,transit,0,0,0,0,0,0,0,0,2008
NC,education - elementary and secondary instructional,0,0,0,0,0,0,0,0,2008
NC,education - elementary and secondary other,0,0,0,0,0,0,0,0,2008
NC,education - higher education instructional,13846,89286968,12149,16495602,684860,17714,25995,105782570,2008
NC,education - higher education other,28689,100975041,23851,19159623,1692355,38249,52540,120134664,2008
NC,education - other,3080,12395379,166,417189,16053,3170,3246,12812568,2008
NC,libraries,0,0,0,0,0,0,0,0,2008
NC,liquor stores,0,0,0,0,0,0,0,0,2008
NC,other and unallocable,5028,20496071,296,358904,20046,5141,5324,20854975,2008
ND,total,14811,53904020,8296,7061198,562445,17983,23107,60965218,2008
ND,financial administration,620,2130836,52,55224,2834,635,672,2186060,2008
ND,other government administration,198,685847,152,76353,2381,211,350,762200,2008
ND,judicial and legal,530,2190560,53,38304,2003,541,583,2228864,2008
ND,police protection - officers,133,527117,0,0,0,133,133,527117,2008
ND,police protection - other,50,137304,2,2244,180,51,52,139548,2008
ND,corrections,696,2124739,73,134968,5042,724,769,2259707,2008
ND,highways,1100,3855913,6,7367,428,1102,1106,3863280,2008
ND,air transportation,0,0,0,0,0,0,0,0,2008
ND,water transport and terminals,0,0,0,0,0,0,0,0,2008
ND,public welfare,439,1344841,60,92147,6634,477,499,1436988,2008
ND,health,1216,4073652,123,157494,9254,1268,1339,4231146,2008
ND,hospitals,857,2317928,52,82427,3016,874,909,2400355,2008
ND,social insurance administration,344,1145625,31,35790,2569,359,375,1181415,2008
ND,solid waste management,0,0,0,0,0,0,0,0,2008
ND,sewerage,0,0,0,0,0,0,0,0,2008
ND,parks and recreation,145,373295,13,15831,1190,151,158,389126,2008
ND,housing and community development,0,0,0,0,0,0,0,0,2008
ND,natural resources,1082,4328049,607,632146,103278,1666,1689,4960195,2008
ND,water transport and terminals,0,0,0,0,0,0,0,0,2008
ND,electric power,0,0,0,0,0,0,0,0,2008
ND,gas supply,0,0,0,0,0,0,0,0,2008
ND,transit,0,0,0,0,0,0,0,0,2008
ND,education - elementary and secondary instructional,0,0,0,0,0,0,0,0,2008
ND,education - elementary and secondary other,0,0,0,0,0,0,0,0,2008
ND,education - higher education instructional,1897,11453312,2131,2777326,175108,2886,4028,14230638,2008
ND,education - higher education other,3694,10693174,4731,2740837,235130,5022,8425,13434011,2008
ND,education - other,279,922402,37,42044,1963,289,316,964446,2008
ND,libraries,0,0,0,0,0,0,0,0,2008
ND,liquor stores,0,0,0,0,0,0,0,0,2008
ND,other and unallocable,1531,5599426,173,170696,11435,1594,1704,5770122,2008
OH,total,119491,553812460,69137,65742026,4106863,142727,188628,619554486,2008
OH,financial administration,7659,38036000,533,905564,53284,7959,8192,38941564,2008
OH,other government administration,903,4069293,118,85739,7780,947,1021,4155032,2008
OH,judicial and legal,2722,14240026,510,1594114,50169,3005,3232,15834140,2008
OH,police protection - officers,1482,8398696,0,0,0,1482,1482,8398696,2008
OH,police protection - other,1212,4932566,6,16578,976,1218,1218,4949144,2008
OH,corrections,16503,68604833,73,172338,10025,16559,16576,68777171,2008
OH,highways,6846,30848809,444,689046,42046,7084,7290,31537855,2008
OH,air transportation,0,0,0,0,0,0,0,0,2008
OH,water transport and terminals,0,0,0,0,0,0,0,0,2008
OH,public welfare,2697,14775803,239,401777,36846,2906,2936,15177580,2008
OH,health,3501,18462711,218,476696,25558,3645,3719,18939407,2008
OH,hospitals,13992,62684083,2753,5426476,251174,15411,16745,68110559,2008
OH,social insurance administration,2169,9001259,231,385306,22605,2297,2400,9386565,2008
OH,solid waste management,0,0,0,0,0,0,0,0,2008
OH,sewerage,0,0,0,0,0,0,0,0,2008
OH,parks and recreation,473,1955150,202,320623,23240,604,675,2275773,2008
OH,housing and community development,0,0,0,0,0,0,0,0,2008
OH,natural resources,2753,11051818,217,295946,18863,2859,2970,11347764,2008
OH,water transport and terminals,0,0,0,0,0,0,0,0,2008
OH,electric power,0,0,0,0,0,0,0,0,2008
OH,gas supply,0,0,0,0,0,0,0,0,2008
OH,transit,0,0,0,0,0,0,0,0,2008
OH,education - elementary and secondary instructional,0,0,0,0,0,0,0,0,2008
OH,education - elementary and secondary other,0,0,0,0,0,0,0,0,2008
OH,education - higher education instructional,15885,109581474,19867,24356346,1083887,22031,35752,133937820,2008
OH,education - higher education other,33741,122538752,43005,29408035,2421591,47433,76746,151946787,2008
OH,education - other,2453,12064511,315,582717,26551,2604,2768,12647228,2008
OH,libraries,0,0,0,0,0,0,0,0,2008
OH,liquor stores,0,0,0,0,0,0,0,0,2008
OH,other and unallocable,4500,22566676,406,624725,32268,4683,4906,23191401,2008
OK,total,63310,234176932,25880,23609030,1530303,71971,89190,257785962,2008
OK,financial administration,1685,6103477,22,23624,1348,1694,1707,6127101,2008
OK,other government administration,784,2915481,136,231324,16665,879,920,3146805,2008
OK,judicial and legal,2792,11904731,135,162850,9338,2845,2927,12067581,2008
OK,police protection - officers,1035,5148774,1,940,94,1036,1036,5149714,2008
OK,police protection - other,917,3195999,56,50314,4605,943,973,3246313,2008
OK,corrections,5637,18457877,87,180532,12013,5705,5724,18638409,2008
OK,highways,2978,9036293,11,16089,1721,2988,2989,9052382,2008
OK,air transportation,12,51613,0,0,0,12,12,51613,2008
OK,water transport and terminals,0,0,0,0,0,0,0,0,2008
OK,public welfare,6930,19883621,250,278207,23507,7062,7180,20161828,2008
OK,health,5851,20480285,331,663610,32111,6032,6182,21143895,2008
OK,hospitals,2859,8440794,85,140490,9764,2914,2944,8581284,2008
OK,social insurance administration,1338,4483839,56,59450,4340,1362,1394,4543289,2008
OK,solid waste management,77,487544,12,14068,1180,84,89,501612,2008
OK,sewerage,0,0,0,0,0,0,0,0,2008
OK,parks and recreation,721,1877985,335,240375,29716,889,1056,2118360,2008
OK,housing and community development,0,0,0,0,0,0,0,0,2008
OK,natural resources,1691,5715392,818,653651,45151,1945,2509,6369043,2008
OK,water transport and terminals,0,0,0,0,0,0,0,0,2008
OK,electric power,536,2746866,9,10800,604,540,545,2757666,2008
OK,gas supply,0,0,0,0,0,0,0,0,2008
OK,transit,0,0,0,0,0,0,0,0,2008
OK,education - elementary and secondary instructional,0,0,0,0,0,0,0,0,2008
OK,education - elementary and secondary other,0,0,0,0,0,0,0,0,2008
OK,education - higher education instructional,6553,40446977,6316,8374628,324397,8388,12869,48821605,2008
OK,education - higher education other,16438,56242824,17049,12277745,1000223,22103,33487,68520569,2008
OK,education - other,1952,7025320,76,87562,5321,1981,2028,7112882,2008
OK,libraries,0,0,0,0,0,0,0,0,2008
OK,liquor stores,0,0,0,0,0,0,0,0,2008
OK,other and unallocable,2524,9531240,95,142771,8205,2569,2619,9674011,2008
OR,total,53373,238182997,20959,27050396,1242124,60387,74332,265233393,2008
OR,financial administration,4061,16258114,317,511246,31065,4236,4378,16769360,2008
OR,other government administration,922,4125480,228,462119,21199,1042,1150,4587599,2008
OR,judicial and legal,3066,13086516,271,698244,28800,3229,3337,13784760,2008
OR,police protection - officers,660,3637299,0,0,0,660,660,3637299,2008
OR,police protection - other,632,2122208,148,122092,5920,666,780,2244300,2008
OR,corrections,5403,20853882,115,297420,12854,5475,5518,21151302,2008
OR,highways,3240,14158187,190,739714,29578,3407,3430,14897901,2008
OR,air transportation,15,62904,1,3770,128,16,16,66674,2008
OR,water transport and terminals,0,0,0,0,0,0,0,0,2008
OR,public welfare,6777,25060613,337,623403,27240,6931,7114,25684016,2008
OR,health,1418,5791884,189,404979,15886,1508,1607,6196863,2008
OR,hospitals,4258,21950603,2713,5447528,129607,4990,6971,27398131,2008
OR,social insurance administration,2023,10100063,131,355805,11735,2089,2154,10455868,2008
OR,solid waste management,0,0,0,0,0,0,0,0,2008
OR,sewerage,0,0,0,0,0,0,0,0,2008
OR,parks and recreation,471,1699241,19,29945,1718,481,490,1729186,2008
OR,housing and community development,0,0,0,0,0,0,0,0,2008
OR,natural resources,2493,9771244,416,581254,36268,2698,2909,10352498,2008
OR,water transport and terminals,0,0,0,0,0,0,0,0,2008
OR,electric power,0,0,0,0,0,0,0,0,2008
OR,gas supply,0,0,0,0,0,0,0,0,2008
OR,transit,0,0,0,0,0,0,0,0,2008
OR,education - elementary and secondary instructional,0,0,0,0,0,0,0,0,2008
OR,education - elementary and secondary other,0,0,0,0,0,0,0,0,2008
OR,education - higher education instructional,5169,35599040,2685,6294085,243049,6542,7854,41893125,2008
OR,education - higher education other,10304,43791384,12898,10165173,630923,13869,23202,53956557,2008
OR,education - other,728,3042448,84,82833,5436,759,812,3125281,2008
OR,libraries,0,0,0,0,0,0,0,0,2008
OR,liquor stores,172,587771,10,13759,843,177,182,601530,2008
OR,other and unallocable,1561,6484116,207,217027,9875,1612,1768,6701143,2008
PA,total,142098,595061414,51190,74262703,3316738,161528,193288,669324117,2008
PA,financial administration,7211,28495213,439,795718,59435,7570,7650,29290931,2008
PA,other government administration,2871,11423632,892,2887591,111273,3540,3763,14311223,2008
PA,judicial and legal,3055,15521605,0,0,0,3055,3055,15521605,2008
PA,police protection - officers,5062,26728143,0,0,0,5062,5062,26728143,2008
PA,police protection - other,1333,7050122,64,148345,5911,1369,1397,7198467,2008
PA,corrections,17348,68368532,452,1042305,29114,17523,17800,69410837,2008
PA,highways,12946,45306586,621,1570518,79539,13417,13567,46877104,2008
PA,air transportation,39,166101,0,0,0,39,39,166101,2008
PA,water transport and terminals,172,756971,0,0,0,172,172,756971,2008
PA,public welfare,11809,42028071,280,896093,27619,11976,12089,42924164,2008
PA,health,1791,7800890,36,82770,2365,1806,1827,7883660,2008
PA,hospitals,11444,36341053,893,1794166,63854,11821,12337,38135219,2008
PA,social insurance administration,3730,14247812,660,1659114,87832,4259,4390,15906926,2008
PA,solid waste management,0,0,0,0,0,0,0,0,2008
PA,sewerage,0,0,0,0,0,0,0,0,2008
PA,parks and recreation,1001,3629893,907,2208720,116392,1702,1908,5838613,2008
PA,housing and community development,0,0,0,0,0,0,0,0,2008
PA,natural resources,5525,23747982,1526,3726992,179345,6570,7051,27474974,2008
PA,water transport and terminals,0,0,0,0,0,0,0,0,2008
PA,electric power,0,0,0,0,0,0,0,0,2008
PA,gas supply,0,0,0,0,0,0,0,0,2008
PA,transit,0,0,0,0,0,0,0,0,2008
PA,education - elementary and secondary instructional,0,0,0,0,0,0,0,0,2008
PA,education - elementary and secondary other,0,0,0,0,0,0,0,0,2008
PA,education - higher education instructional,14274,103968266,10116,27723224,605061,17725,24390,131691490,2008
PA,education - higher education other,28848,106262740,33720,28605390,1896133,39969,62568,134868130,2008
PA,education - other,4354,17508071,301,526102,17002,4451,4655,18034173,2008
PA,libraries,0,0,0,0,0,0,0,0,2008
PA,liquor stores,3054,9672849,0,0,0,3054,3054,9672849,2008
PA,other and unallocable,6231,26036882,283,595655,35863,6448,6514,26632537,2008
RI,total,18414,89356514,6677,6245816,313088,20426,25091,95602330,2008
RI,financial administration,826,3849204,15,23271,910,832,841,3872475,2008
RI,other government administration,536,2551337,391,212575,5779,573,927,2763912,2008
RI,judicial and legal,1226,6237968,18,52401,1834,1239,1244,6290369,2008
RI,police protection - officers,215,1478458,0,0,0,215,215,1478458,2008
RI,police protection - other,90,455956,3,2568,204,91,93,458524,2008
RI,corrections,1711,8610150,1,3753,77,1711,1712,8613903,2008
RI,highways,764,3586680,30,40711,2048,776,794,3627391,2008
RI,air transportation,178,1016870,3,9662,299,180,181,1026532,2008
RI,water transport and terminals,0,0,0,0,0,0,0,0,2008
RI,public welfare,1544,6884359,56,136754,6839,1588,1600,7021113,2008
RI,health,1191,5812914,79,46604,2701,1209,1270,5859518,2008
RI,hospitals,1045,4689044,9,30447,1025,1052,1054,4719491,2008
RI,social insurance administration,444,1978678,18,40202,1658,455,462,2018880,2008
RI,solid waste management,119,686539,0,0,0,119,119,686539,2008
RI,sewerage,244,1070493,1,2818,80,245,245,1073311,2008
RI,parks and recreation,69,229043,0,0,0,69,69,229043,2008
RI,housing and community development,0,0,0,0,0,0,0,0,2008
RI,natural resources,486,2359925,30,43100,1844,497,516,2403025,2008
RI,water transport and terminals,0,0,0,0,0,0,0,0,2008
RI,electric power,0,0,0,0,0,0,0,0,2008
RI,gas supply,0,0,0,0,0,0,0,0,2008
RI,transit,747,3457176,46,132401,7379,789,793,3589577,2008
RI,education - elementary and secondary instructional,427,2239652,73,104951,6602,470,500,2344603,2008
RI,education - elementary and secondary other,87,283314,81,97551,8717,143,168,380865,2008
RI,education - higher education instructional,1826,10151535,2619,3475295,119450,2597,4445,13626830,2008
RI,education - higher education other,2312,9367606,3133,1675663,140321,3217,5445,11043269,2008
RI,education - other,535,2913121,23,40339,1809,546,558,2953460,2008
RI,libraries,0,0,0,0,0,0,0,0,2008
RI,liquor stores,0,0,0,0,0,0,0,0,2008
RI,other and unallocable,1792,9446492,48,74750,3512,1813,1840,9521242,2008
SC,total,71715,253139765,17801,16443366,1047247,77957,89516,269583131,2008
SC,financial administration,3385,11359536,38,73628,2478,3400,3423,11433164,2008
SC,other government administration,590,2340740,467,505786,31726,781,1057,2846526,2008
SC,judicial and legal,726,3466340,9,19672,464,729,735,3486012,2008
SC,police protection - officers,1453,5401838,0,0,0,1453,1453,5401838,2008
SC,police protection - other,603,1914144,2,6806,150,604,605,1920950,2008
SC,corrections,8057,22772690,1,1728,60,8057,8058,22774418,2008
SC,highways,4944,14675682,6,12386,330,4946,4950,14688068,2008
SC,air transportation,0,0,0,0,0,0,0,0,2008
SC,water transport and terminals,564,2818466,3,8212,396,566,567,2826678,2008
SC,public welfare,4518,12436108,7,16954,366,4519,4525,12453062,2008
SC,health,6208,20411146,143,382158,8160,6257,6351,20793304,2008
SC,hospitals,7224,17077652,216,520259,27063,7378,7440,17597911,2008
SC,social insurance administration,1162,3648556,0,0,0,1162,1162,3648556,2008
SC,solid waste management,0,0,0,0,0,0,0,0,2008
SC,sewerage,0,0,0,0,0,0,0,0,2008
SC,parks and recreation,574,1630602,14,23182,792,579,588,1653784,2008
SC,housing and community development,0,0,0,0,0,0,0,0,2008
SC,natural resources,2027,6675486,250,259048,22611,2163,2277,6934534,2008
SC,water transport and terminals,10,56639,0,0,0,10,10,56639,2008
SC,electric power,1822,10458743,17,47900,1990,1833,1839,10506643,2008
SC,gas supply,0,0,0,0,0,0,0,0,2008
SC,transit,0,0,0,0,0,0,0,0,2008
SC,education - elementary and secondary instructional,0,0,0,0,0,0,0,0,2008
SC,education - elementary and secondary other,0,0,0,0,0,0,0,0,2008
SC,education - higher education instructional,8514,50281506,6759,7835979,380089,10791,15273,58117485,2008
SC,education - higher education other,15243,50461861,9851,6698948,569704,18633,25094,57160809,2008
SC,education - other,2772,10125068,4,7052,202,2774,2776,10132120,2008
SC,libraries,0,0,0,0,0,0,0,0,2008
SC,liquor stores,0,0,0,0,0,0,0,0,2008
SC,other and unallocable,1319,5126962,14,23668,666,1322,1333,5150630,2008
SD,total,11834,42493867,6281,4972236,279251,13410,18115,47466103,2008
SD,financial administration,415,1491076,14,18772,1348,423,429,1509848,2008
SD,other government administration,328,1108424,61,35212,2692,343,389,1143636,2008
SD,judicial and legal,550,2076642,94,94632,6696,588,644,2171274,2008
SD,police protection - officers,190,755792,0,0,0,190,190,755792,2008
SD,police protection - other,109,294878,9,12372,772,113,118,307250,2008
SD,corrections,880,2421862,37,46518,3604,900,917,2468380,2008
SD,highways,963,2994412,119,123138,5648,995,1082,3117550,2008
SD,air transportation,0,0,0,0,0,0,0,0,2008
SD,water transport and terminals,0,0,0,0,0,0,0,0,2008
SD,public welfare,1052,2825230,33,46902,3498,1071,1085,2872132,2008
SD,health,574,1979786,128,278708,13706,651,702,2258494,2008
SD,hospitals,870,2509870,137,199166,12784,943,1007,2709036,2008
SD,social insurance administration,267,659258,7,5848,478,270,274,665106,2008
SD,solid waste management,0,0,0,0,0,0,0,0,2008
SD,sewerage,0,0,0,0,0,0,0,0,2008
SD,parks and recreation,131,357844,29,26136,2646,146,160,383980,2008
SD,housing and community development,0,0,0,0,0,0,0,0,2008
SD,natural resources,770,2586907,308,173609,17646,870,1078,2760516,2008
SD,water transport and terminals,0,0,0,0,0,0,0,0,2008
SD,electric power,0,0,0,0,0,0,0,0,2008
SD,gas supply,0,0,0,0,0,0,0,0,2008
SD,transit,0,0,0,0,0,0,0,0,2008
SD,education - elementary and secondary instructional,0,0,0,0,0,0,0,0,2008
SD,education - elementary and secondary other,0,0,0,0,0,0,0,0,2008
SD,education - higher education instructional,1531,9759408,1111,1623095,71980,1937,2642,11382503,2008
SD,education - higher education other,2047,6754824,4113,2211891,129460,2779,6160,8966715,2008
SD,education - other,378,1208442,28,27505,2179,389,406,1235947,2008
SD,libraries,0,0,0,0,0,0,0,0,2008
SD,liquor stores,0,0,0,0,0,0,0,0,2008
SD,other and unallocable,779,2709212,53,48732,4114,802,832,2757944,2008
TN,total,78064,296174529,25036,21418869,1364963,86099,103100,317593398,2008
TN,financial administration,3594,14474513,70,81460,6364,3633,3664,14555973,2008
TN,other government administration,847,3429856,29,36932,2090,859,876,3466788,2008
TN,judicial and legal,2477,12409499,9,11326,675,2480,2486,12420825,2008
TN,police protection - officers,1148,5004376,0,0,0,1148,1148,5004376,2008
TN,police protection - other,1065,2832383,39,55838,6453,1102,1104,2888221,2008
TN,corrections,7344,21420274,36,56340,2936,7361,7380,21476614,2008
TN,highways,4297,14991402,0,0,0,4297,4297,14991402,2008
TN,air transportation,0,0,0,0,0,0,0,0,2008
TN,water transport and terminals,0,0,0,0,0,0,0,0,2008
TN,public welfare,8190,26707196,7,15774,598,8194,8197,26722970,2008
TN,health,5065,21181001,138,291462,13832,5143,5203,21472463,2008
TN,hospitals,6410,28201567,144,503542,23919,6546,6554,28705109,2008
TN,social insurance administration,1397,4452002,145,205678,14976,1487,1542,4657680,2008
TN,solid waste management,0,0,0,0,0,0,0,0,2008
TN,sewerage,0,0,0,0,0,0,0,0,2008
TN,parks and recreation,1106,2629236,223,166384,19060,1221,1329,2795620,2008
TN,housing and community development,0,0,0,0,0,0,0,0,2008
TN,natural resources,3719,14211288,544,695708,59430,4067,4263,14906996,2008
TN,water transport and terminals,0,0,0,0,0,0,0,0,2008
TN,electric power,0,0,0,0,0,0,0,0,2008
TN,gas supply,0,0,0,0,0,0,0,0,2008
TN,transit,0,0,0,0,0,0,0,0,2008
TN,education - elementary and secondary instructional,0,0,0,0,0,0,0,0,2008
TN,education - elementary and secondary other,0,0,0,0,0,0,0,0,2008
TN,education - higher education instructional,8386,49186843,9151,10477553,537993,11582,17537,59664396,2008
TN,education - higher education other,17901,56909643,13827,8222715,648793,21693,31728,65132358,2008
TN,education - other,2171,7628829,578,498716,23820,2314,2749,8127545,2008
TN,libraries,0,0,0,0,0,0,0,0,2008
TN,liquor stores,0,0,0,0,0,0,0,0,2008
TN,other and unallocable,2947,10504621,96,99441,4024,2972,3043,10604062,2008
TX,total,257830,1045887624,78625,103794133,5698073,290022,336455,1149681757,2008
TX,financial administration,9207,36798139,153,169808,8661,9255,9360,36967947,2008
TX,other government administration,2209,8345725,484,529020,29426,2375,2693,8874745,2008
TX,judicial and legal,5460,26558651,90,367090,10470,5519,5550,26925741,2008
TX,police protection - officers,2287,10494555,0,0,0,2287,2287,10494555,2008
TX,police protection - other,1985,6430448,67,70108,5360,2015,2052,6500556,2008
TX,corrections,44311,118539633,635,773192,55037,44622,44946,119312825,2008
TX,highways,15397,57665852,565,1058917,28162,15557,15962,58724769,2008
TX,air transportation,0,0,0,0,0,0,0,0,2008
TX,water transport and terminals,0,0,0,0,0,0,0,0,2008
TX,public welfare,24180,71559459,308,563104,30818,24354,24488,72122563,2008
TX,health,12977,48511328,635,1518850,51674,13268,13612,50030178,2008
TX,hospitals,27348,127984174,2578,7677515,293775,29008,29926,135661689,2008
TX,social insurance administration,4268,14913470,26,45033,2396,4282,4294,14958503,2008
TX,solid waste management,0,0,0,0,0,0,0,0,2008
TX,sewerage,0,0,0,0,0,0,0,0,2008
TX,parks and recreation,1086,3063259,151,169392,17173,1183,1237,3232651,2008
TX,housing and community development,0,0,0,0,0,0,0,0,2008
TX,natural resources,9711,40727375,2171,4258901,170174,10672,11882,44986276,2008
TX,water transport and terminals,0,0,0,0,0,0,0,0,2008
TX,electric power,0,0,0,0,0,0,0,0,2008
TX,gas supply,0,0,0,0,0,0,0,0,2008
TX,transit,0,0,0,0,0,0,0,0,2008
TX,education - elementary and secondary instructional,0,0,0,0,0,0,0,0,2008
TX,education - elementary and secondary other,0,0,0,0,0,0,0,0,2008
TX,education - higher education instructional,23801,191041823,27564,44262910,1992772,35058,51365,235304733,2008
TX,education - higher education other,62575,238109159,42678,41121144,2947714,79231,105253,279230303,2008
TX,education - other,4561,19219186,351,864400,37473,4773,4912,20083586,2008
TX,libraries,0,0,0,0,0,0,0,0,2008
TX,liquor stores,0,0,0,0,0,0,0,0,2008
TX,other and unallocable,6467,25925388,169,344749,16988,6563,6636,26270137,2008
UT,total,42728,177404847,22904,25595574,1441125,50879,65632,203000421,2008
UT,financial administration,2488,10816545,174,147490,12997,2562,2662,10964035,2008
UT,other government administration,360,1728626,34,70936,2392,374,394,1799562,2008
UT,judicial and legal,1593,6650760,143,582851,9779,1648,1736,7233611,2008
UT,police protection - officers,416,1754982,0,0,0,416,416,1754982,2008
UT,police protection - other,402,1487216,94,105336,7819,446,496,1592552,2008
UT,corrections,3165,10669131,237,179617,15217,3251,3402,10848748,2008
UT,highways,1657,6697463,15,16609,1043,1663,1672,6714072,2008
UT,air transportation,0,0,0,0,0,0,0,0,2008
UT,water transport and terminals,0,0,0,0,0,0,0,0,2008
UT,public welfare,3088,10324402,314,411240,24201,3225,3402,10735642,2008
UT,health,1713,6613333,211,297360,15971,1804,1924,6910693,2008
UT,hospitals,6462,23635649,1343,1923695,88911,6964,7805,25559344,2008
UT,social insurance administration,820,2829105,63,138005,8384,867,883,2967110,2008
UT,solid waste management,0,0,0,0,0,0,0,0,2008
UT,sewerage,0,0,0,0,0,0,0,0,2008
UT,parks and recreation,275,956087,88,64737,5942,309,363,1020824,2008
UT,housing and community development,0,0,0,0,0,0,0,0,2008
UT,natural resources,1297,4754340,171,178223,14435,1379,1468,4932563,2008
UT,water transport and terminals,0,0,0,0,0,0,0,0,2008
UT,electric power,0,0,0,0,0,0,0,0,2008
UT,gas supply,0,0,0,0,0,0,0,0,2008
UT,transit,0,0,0,0,0,0,0,0,2008
UT,education - elementary and secondary instructional,0,0,0,0,0,0,0,0,2008
UT,education - elementary and secondary other,0,0,0,0,0,0,0,0,2008
UT,education - higher education instructional,5942,40643343,7420,10935548,407323,8245,13362,51578891,2008
UT,education - higher education other,10289,37832031,11712,9727545,766101,14623,22001,47559576,2008
UT,education - other,958,3746506,474,591355,39963,1183,1432,4337861,2008
UT,libraries,0,0,0,0,0,0,0,0,2008
UT,liquor stores,260,662110,306,165527,17263,358,566,827637,2008
UT,other and unallocable,1543,5603218,105,59500,3384,1562,1648,5662718,2008
VT,total,14009,60701473,3222,3965536,190340,15103,17231,64667009,2008
VT,financial administration,612,2624068,8,6902,374,613,620,2630970,2008
VT,other government administration,687,2405107,24,20796,1160,694,711,2425903,2008
VT,judicial and legal,613,2796795,24,45356,2449,626,637,2842151,2008
VT,police protection - officers,300,1888039,22,25565,1499,308,322,1913604,2008
VT,police protection - other,291,1253038,50,43188,3434,310,341,1296226,2008
VT,corrections,1185,4793797,5,13127,644,1189,1190,4806924,2008
VT,highways,1043,4666204,9,6100,339,1045,1052,4672304,2008
VT,air transportation,0,0,0,0,0,0,0,0,2008
VT,water transport and terminals,0,0,0,0,0,0,0,0,2008
VT,public welfare,1351,5427193,34,28532,1259,1358,1385,5455725,2008
VT,health,574,2307741,221,249199,20526,690,795,2556940,2008
VT,hospitals,298,1227982,14,15086,529,301,312,1243068,2008
VT,social insurance administration,213,835553,4,3607,108,214,217,839160,2008
VT,solid waste management,0,0,0,0,0,0,0,0,2008
VT,sewerage,0,0,0,0,0,0,0,0,2008
VT,parks and recreation,121,506092,8,3620,266,123,129,509712,2008
VT,housing and community development,0,0,0,0,0,0,0,0,2008
VT,natural resources,604,2732777,33,158575,4253,629,637,2891352,2008
VT,water transport and terminals,0,0,0,0,0,0,0,0,2008
VT,electric power,0,0,0,0,0,0,0,0,2008
VT,gas supply,0,0,0,0,0,0,0,0,2008
VT,transit,0,0,0,0,0,0,0,0,2008
VT,education - elementary and secondary instructional,0,0,0,0,0,0,0,0,2008
VT,education - elementary and secondary other,0,0,0,0,0,0,0,0,2008
VT,education - higher education instructional,1308,8685713,1152,2012698,66082,1689,2460,10698411,2008
VT,education - higher education other,2914,10563585,1506,1196968,80620,3380,4420,11760553,2008
VT,education - other,587,2485494,29,56257,2589,603,616,2541751,2008
VT,libraries,0,0,0,0,0,0,0,0,2008
VT,liquor stores,55,234786,1,489,40,55,56,235275,2008
VT,other and unallocable,1253,5267509,78,79471,4169,1276,1331,5346980,2008
VA,total,108243,450583509,50921,59555455,3432229,127645,159164,510138964,2008
VA,financial administration,3957,16224876,655,827508,62642,4310,4612,17052384,2008
VA,other government administration,503,2472180,454,784838,39050,731,957,3257018,2008
VA,judicial and legal,3601,16791958,378,547192,18668,3707,3979,17339150,2008
VA,police protection - officers,2282,11048664,26,42254,2350,2295,2308,11090918,2008
VA,police protection - other,777,2825994,213,314404,19740,889,990,3140398,2008
VA,corrections,14848,45809970,391,552638,34602,15043,15239,46362608,2008
VA,highways,8535,35906222,384,726300,38544,8753,8919,36632522,2008
VA,air transportation,0,0,0,0,0,0,0,0,2008
VA,water transport and terminals,150,798862,4,6204,514,153,154,805066,2008
VA,public welfare,2516,10014506,268,513740,25188,2660,2784,10528246,2008
VA,health,5137,20413594,596,769360,52348,5432,5733,21182954,2008
VA,hospitals,14237,51224462,2405,4168128,170476,15201,16642,55392590,2008
VA,social insurance administration,1150,4257182,263,474507,32140,1331,1413,4731689,2008
VA,solid waste management,0,0,0,0,0,0,0,0,2008
VA,sewerage,0,0,0,0,0,0,0,0,2008
VA,parks and recreation,696,2343974,703,656784,58884,1029,1399,3000758,2008
VA,housing and community development,0,0,0,0,0,0,0,0,2008
VA,natural resources,2544,11653542,704,934697,63856,2905,3248,12588239,2008
VA,water transport and terminals,0,0,0,0,0,0,0,0,2008
VA,electric power,0,0,0,0,0,0,0,0,2008
VA,gas supply,0,0,0,0,0,0,0,0,2008
VA,transit,0,0,0,0,0,0,0,0,2008
VA,education - elementary and secondary instructional,0,0,0,0,0,0,0,0,2008
VA,education - elementary and secondary other,0,0,0,0,0,0,0,0,2008
VA,education - higher education instructional,14662,96649788,14123,25563309,884391,19660,28785,122213097,2008
VA,education - higher education other,25243,89330587,26722,19585659,1702209,34862,51965,108916246,2008
VA,education - other,2728,12002282,586,866966,47516,2996,3314,12869248,2008
VA,libraries,0,0,0,0,0,0,0,0,2008
VA,liquor stores,838,2717230,1509,1421956,131238,1579,2347,4139186,2008
VA,other and unallocable,3839,18097636,537,799011,47873,4109,4376,18896647,2008
WA,total,102788,470921499,51832,70752719,3495596,122541,154620,541674218,2008
WA,financial administration,2854,12942806,162,392796,16812,2949,3016,13335602,2008
WA,other government administration,1577,6677969,305,548961,22979,1707,1882,7226930,2008
WA,judicial and legal,1892,9927947,169,397798,13261,1967,2061,10325745,2008
WA,police protection - officers,1013,7215600,0,0,0,1013,1013,7215600,2008
WA,police protection - other,1021,5215524,49,56428,2298,1034,1070,5271952,2008
WA,corrections,9224,38571139,482,997132,48348,9497,9706,39568271,2008
WA,highways,7625,39939978,307,654076,31144,7801,7932,40594054,2008
WA,air transportation,0,0,0,0,0,0,0,0,2008
WA,water transport and terminals,0,0,0,0,0,0,0,0,2008
WA,public welfare,9658,31644740,1313,1507314,65302,10027,10971,33152054,2008
WA,health,4900,17835343,972,1612090,72994,5312,5872,19447433,2008
WA,hospitals,8457,40090390,3154,10502631,242056,9825,11611,50593021,2008
WA,social insurance administration,2292,10195570,229,514964,26138,2439,2521,10710534,2008
WA,solid waste management,149,762920,18,57072,2018,160,167,819992,2008
WA,sewerage,0,0,0,0,0,0,0,0,2008
WA,parks and recreation,589,2552330,157,232100,19724,700,746,2784430,2008
WA,housing and community development,0,0,0,0,0,0,0,0,2008
WA,natural resources,4938,21732513,596,1140617,67775,5320,5534,22873130,2008
WA,water transport and terminals,0,0,0,0,0,0,0,0,2008
WA,electric power,0,0,0,0,0,0,0,0,2008
WA,gas supply,0,0,0,0,0,0,0,0,2008
WA,transit,0,0,0,0,0,0,0,0,2008
WA,education - elementary and secondary instructional,0,0,0,0,0,0,0,0,2008
WA,education - elementary and secondary other,0,0,0,0,0,0,0,0,2008
WA,education - higher education instructional,11993,71261016,13033,32576989,918667,17184,25026,103838005,2008
WA,education - higher education other,26921,120008770,29147,17112029,1805787,37122,56068,137120799,2008
WA,education - other,1858,8231414,873,1021677,43454,2112,2731,9253091,2008
WA,libraries,0,0,0,0,0,0,0,0,2008
WA,liquor stores,537,2152140,580,904330,73138,950,1117,3056470,2008
WA,other and unallocable,5290,23963390,286,523715,23701,5422,5576,24487105,2008
WV,total,35076,117395094,10825,9419197,664380,39065,45901,126814291,2008
WV,financial administration,1889,5357074,38,49860,2780,1905,1927,5406934,2008
WV,other government administration,216,754142,331,632707,25537,380,547,1386849,2008
WV,judicial and legal,1397,5768290,21,35694,2570,1412,1418,5803984,2008
WV,police protection - officers,631,2833230,0,0,0,631,631,2833230,2008
WV,police protection - other,353,811242,20,13794,1116,359,373,825036,2008
WV,corrections,3376,7914888,5,6120,522,3379,3381,7921008,2008
WV,highways,5168,16110388,30,54712,3830,5190,5198,16165100,2008
WV,air transportation,3,11138,0,0,0,3,3,11138,2008
WV,water transport and terminals,4,14178,0,0,0,4,4,14178,2008
WV,public welfare,3297,8180172,18,14328,1374,3305,3315,8194500,2008
WV,health,760,2304766,32,21664,965,765,792,2326430,2008
WV,hospitals,1584,3735762,106,115320,9708,1638,1690,3851082,2008
WV,social insurance administration,551,1622954,33,33858,2808,568,584,1656812,2008
WV,solid waste management,9,33614,4,626,12,9,13,34240,2008
WV,sewerage,0,0,0,0,0,0,0,0,2008
WV,parks and recreation,390,806392,343,234106,33558,580,733,1040498,2008
WV,housing and community development,0,0,0,0,0,0,0,0,2008
WV,natural resources,2156,7100844,351,279334,26332,2312,2507,7380178,2008
WV,water transport and terminals,0,0,0,0,0,0,0,0,2008
WV,electric power,0,0,0,0,0,0,0,0,2008
WV,gas supply,0,0,0,0,0,0,0,0,2008
WV,transit,8,28416,0,0,0,8,8,28416,2008
WV,education - elementary and secondary instructional,0,0,0,0,0,0,0,0,2008
WV,education - elementary and secondary other,0,0,0,0,0,0,0,0,2008
WV,education - higher education instructional,3428,19751156,3885,4954292,245652,4908,7313,24705448,2008
WV,education - higher education other,6466,22660100,5350,2688751,292765,8230,11816,25348851,2008
WV,education - other,1213,4546850,144,182136,9462,1269,1357,4728986,2008
WV,libraries,0,0,0,0,0,0,0,0,2008
WV,liquor stores,57,155288,5,7728,644,61,62,163016,2008
WV,other and unallocable,2120,6894210,109,94167,4745,2149,2229,6988377,2008
WI,total,55206,263901174,43112,44976444,2444372,69019,98318,308877618,2008
WI,financial administration,2014,8682666,598,1126808,46720,2278,2612,9809474,2008
WI,other government administration,809,3751335,394,987941,37394,1021,1203,4739276,2008
WI,judicial and legal,1957,12276203,304,851704,31036,2132,2261,13127907,2008
WI,police protection - officers,593,2847941,0,0,0,593,593,2847941,2008
WI,police protection - other,313,1278698,16,16278,978,319,329,1294976,2008
WI,corrections,9759,39489233,1208,3591587,131878,10503,10967,43080820,2008
WI,highways,1687,7841237,44,113284,4634,1713,1731,7954521,2008
WI,air transportation,0,0,0,0,0,0,0,0,2008
WI,water transport and terminals,0,0,0,0,0,0,0,0,2008
WI,public welfare,1296,5162409,321,658095,35373,1496,1617,5820504,2008
WI,health,1386,6642941,428,1053341,40733,1617,1814,7696282,2008
WI,hospitals,2834,11523835,1032,2379080,103671,3420,3866,13902915,2008
WI,social insurance administration,769,3359375,50,110162,6386,805,819,3469537,2008
WI,solid waste management,0,0,0,0,0,0,0,0,2008
WI,sewerage,0,0,0,0,0,0,0,0,2008
WI,parks and recreation,172,678381,56,74915,3715,193,228,753296,2008
WI,housing and community development,0,0,0,0,0,0,0,0,2008
WI,natural resources,2002,8401412,1060,1797593,91012,2516,3062,10199005,2008
WI,water transport and terminals,0,0,0,0,0,0,0,0,2008
WI,electric power,0,0,0,0,0,0,0,0,2008
WI,gas supply,0,0,0,0,0,0,0,0,2008
WI,transit,0,0,0,0,0,0,0,0,2008
WI,education - elementary and secondary instructional,0,0,0,0,0,0,0,0,2008
WI,education - elementary and secondary other,0,0,0,0,0,0,0,0,2008
WI,education - higher education instructional,8035,52221664,10642,12664484,638021,11640,18677,64886148,2008
WI,education - higher education other,16007,72921909,25152,15887855,1110993,22284,41159,88809764,2008
WI,education - other,941,4391327,417,828498,30047,1111,1358,5219825,2008
WI,libraries,0,0,0,0,0,0,0,0,2008
WI,liquor stores,0,0,0,0,0,0,0,0,2008
WI,other and unallocable,4632,22430608,1390,2834819,131781,5378,6022,25265427,2008
WY,total,12022,44803417,3088,2299521,176737,13016,15110,47102938,2008
WY,financial administration,600,2477362,5,7014,435,601,605,2484376,2008
WY,other government administration,148,678266,184,173399,9510,201,332,851665,2008
WY,judicial and legal,519,2421892,39,59525,3424,538,558,2481417,2008
WY,police protection - officers,190,902500,0,0,0,190,190,902500,2008
WY,police protection - other,98,397646,0,0,0,98,98,397646,2008
WY,corrections,971,3144735,5,6701,521,973,976,3151436,2008
WY,highways,1783,6433551,102,197404,12092,1851,1885,6630955,2008
WY,air transportation,0,0,0,0,0,0,0,0,2008
WY,water transport and terminals,0,0,0,0,0,0,0,0,2008
WY,public welfare,738,2642684,42,73459,3816,760,780,2716143,2008
WY,health,695,2643766,63,90697,5576,727,758,2734463,2008
WY,hospitals,922,2269663,24,42961,2235,935,946,2312624,2008
WY,social insurance administration,300,1034404,5,6436,435,302,305,1040840,2008
WY,solid waste management,0,0,0,0,0,0,0,0,2008
WY,sewerage,0,0,0,0,0,0,0,0,2008
WY,parks and recreation,100,342268,6,10898,522,103,106,353166,2008
WY,housing and community development,0,0,0,0,0,0,0,0,2008
WY,natural resources,927,3375176,30,38394,2911,942,957,3413570,2008
WY,water transport and terminals,0,0,0,0,0,0,0,0,2008
WY,electric power,0,0,0,0,0,0,0,0,2008
WY,gas supply,0,0,0,0,0,0,0,0,2008
WY,transit,0,0,0,0,0,0,0,0,2008
WY,education - elementary and secondary instructional,0,0,0,0,0,0,0,0,2008
WY,education - elementary and secondary other,0,0,0,0,0,0,0,0,2008
WY,education - higher education instructional,1000,5570764,659,662408,39252,1222,1659,6233172,2008
WY,education - higher education other,1931,6343026,1875,863470,91462,2448,3806,7206496,2008
WY,education - other,203,868803,4,4334,348,205,207,873137,2008
WY,libraries,0,0,0,0,0,0,0,0,2008
WY,liquor stores,68,228234,0,0,0,68,68,228234,2008
WY,other and unallocable,829,3028677,45,62421,4198,852,874,3091098,2008
