state,government_function,full_time_employees,full_time_pay,part_time_employees,part_time_pay,part_time_hours,full_time_equivalent_employees,total_employees,march_pay,year
US,total,3803914,17574856249,1521697,2004363709,100245300,4377812,5325611,19579219958,2010
US,financial administration,158241,687501071,10596,19415636,1057049,164344,168837,706916707,2010
US,other government administration,48696,223856494,10726,21430460,877635,53782,59422,245286954,2010
US,judicial and legal,171364,878412788,9774,22826192,896665,176496,181138,901238980,2010
US,police protection - officers,68083,407966693,1004,1645736,42482,68326,69087,409612429,2010
US,police protection - other,37525,147533711,2128,3499673,176797,38538,39653,151033384,2010
US,corrections,467000,1889413105,9596,25211224,930908,472306,476596,1914624329,2010
US,highways,223711,957280157,11691,26092176,1142281,230370,235402,983372333,2010
US,air transportation,3110,16048270,86,159831,6773,3149,3196,16208101,2010
US,water transport and terminals,4713,24373822,112,124758,6717,4752,4825,24498580,2010
US,public welfare,228898,849139493,12184,26217075,1229377,235934,241082,875356568,2010
US,health,185267,766841932,14513,34213310,1432171,193456,199780,801055242,2010
US,hospitals,366566,1617285403,71593,220180261,7487558,409195,438159,1837465664,2010
US,social insurance administration,82597,341113215,9023,20244996,1012993,88456,91620,361358211,2010
US,solid waste management,2134,10975333,99,212051,9640,2189,2233,11187384,2010
US,sewerage,1708,10050094,49,223881,3811,1730,1757,10273975,2010
US,parks and recreation,28225,99244524,13716,16039846,1052963,34271,41941,115284370,2010
US,housing and community development,0,0,0,0,0,0,0,0,2010
US,natural resources,125432,532208608,29259,43763829,2599709,140242,154691,575972437,2010
US,water transport and terminals,698,3906202,25,103598,2499,714,723,4009800,2010
US,electric power,4080,26851776,79,211666,8208,4126,4159,27063442,2010
US,gas supply,0,0,0,0,0,0,0,0,2010
US,transit,31276,193463338,1547,3152488,166190,32213,32823,196615826,2010
US,education - elementary and secondary instructional,33078,170677048,11530,11604057,522331,36203,44608,182281105,2010
US,education - elementary and secondary other,13435,39117574,6369,5362300,330483,15542,19804,44479874,2010
US,education - higher education instructional,403654,2872842781,414999,690718905,25381350,549071,818653,3563561686,2010
US,education - higher education other,845213,3596549529,846664,755313044,51025700,1136849,1691877,4351862573,2010
US,education - other,80394,352009061,13849,22285774,1042270,86377,94243,374294835,2010
US,libraries,488,1475844,210,127948,11938,555,698,1603792,2010
US,liquor stores,6486,21834131,5310,8133657,570307,9822,11796,29967788,2010
US,other and unallocable,181842,836884252,14966,25849337,1218495,188804,196808,862733589,2010
AL,total,80086,328241691,27571,28845680,1666665,89632,107657,357087371,2010
AL,financial administration,2490,11109820,57,54490,3914,2512,2547,11164310,2010
AL,other government administration,518,2409256,125,208400,10323,577,643,2617656,2010
AL,judicial and legal,3496,14845154,71,158748,6740,3534,3567,15003902,2010
AL,police protection - officers,866,3834116,0,0,0,866,866,3834116,2010
AL,police protection - other,775,2442940,0,0,0,775,775,2442940,2010
AL,corrections,5454,17624142,49,92218,5880,5487,5503,17716360,2010
AL,highways,4597,13594902,114,125254,9120,4649,4711,13720156,2010
AL,air transportation,0,0,0,0,0,0,0,0,2010
AL,water transport and terminals,564,2497584,1,1651,40,564,565,2499235,2010
AL,public welfare,4293,14994464,87,173334,8726,4342,4380,15167798,2010
AL,health,5678,21580553,494,605763,63795,6038,6172,22186316,2010
AL,hospitals,11309,44914507,1442,3858016,134725,12070,12751,48772523,2010
AL,social insurance administration,922,3591024,159,228186,22632,1050,1081,3819210,2010
AL,solid waste management,0,0,0,0,0,0,0,0,2010
AL,sewerage,0,0,0,0,0,0,0,0,2010
AL,parks and recreation,429,1191030,188,155660,17914,530,617,1346690,2010
AL,housing and community development,0,0,0,0,0,0,0,0,2010
AL,natural resources,2158,8468317,125,147022,10891,2220,2283,8615339,2010
AL,water transport and terminals,0,0,0,0,0,0,0,0,2010
AL,electric power,0,0,0,0,0,0,0,0,2010
AL,gas supply,0,0,0,0,0,0,0,0,2010
AL,transit,0,0,0,0,0,0,0,0,2010
AL,education - elementary and secondary instructional,0,0,0,0,0,0,0,0,2010
AL,education - elementary and secondary other,0,0,0,0,0,0,0,0,2010
AL,education - higher education instructional,9255,65640150,9020,10763434,466719,11950,18275,76403584,2010
AL,education - higher education other,21549,77950582,15082,11641960,851594,26435,36631,89592542,2010
AL,education - other,2934,11030692,140,129926,6416,2969,3074,11160618,2010
AL,libraries,0,0,0,0,0,0,0,0,2010
AL,liquor stores,728,1940452,9,15330,876,733,737,1955782,2010
AL,other and unallocable,2071,8582006,408,486288,46360,2331,2479,9068294,2010
AK,total,24558,127123285,5385,7081828,368364,26689,29943,134205113,2010
AK,financial administration,1084,5843406,32,61126,2964,1102,1116,5904532,2010
AK,other government administration,792,4005912,49,91172,3890,815,841,4097084,2010
AK,judicial and legal,1416,8055996,53,109486,4250,1441,1469,8165482,2010
AK,police protection - officers,295,2223662,0,0,0,295,295,2223662,2010
AK,police protection - other,373,1683184,34,20764,1350,381,407,1703948,2010
AK,corrections,1897,9066770,68,133784,7548,1942,1965,9200554,2010
AK,highways,3065,16772964,42,69238,4038,3089,3107,16842202,2010
AK,air transportation,0,0,0,0,0,0,0,0,2010
AK,water transport and terminals,0,0,0,0,0,0,0,0,2010
AK,public welfare,1796,7680706,125,205292,16701,1897,1921,7885998,2010
AK,health,730,3919678,21,36912,1778,741,751,3956590,2010
AK,hospitals,226,1227344,29,83098,3498,247,255,1310442,2010
AK,social insurance administration,433,1858788,9,11718,517,436,442,1870506,2010
AK,solid waste management,0,0,0,0,0,0,0,0,2010
AK,sewerage,0,0,0,0,0,0,0,0,2010
AK,parks and recreation,101,459440,2,5710,230,102,103,465150,2010
AK,housing and community development,0,0,0,0,0,0,0,0,2010
AK,natural resources,2334,11888449,123,246549,9162,2387,2457,12134998,2010
AK,water transport and terminals,0,0,0,0,0,0,0,0,2010
AK,electric power,0,0,0,0,0,0,0,0,2010
AK,gas supply,0,0,0,0,0,0,0,0,2010
AK,transit,0,0,0,0,0,0,0,0,2010
AK,education - elementary and secondary instructional,2034,8830118,466,632263,33161,2236,2500,9462381,2010
AK,education - elementary and secondary other,667,2603958,702,583206,39460,905,1369,3187164,2010
AK,education - higher education instructional,1209,9791107,1061,1505752,77827,1649,2270,11296859,2010
AK,education - higher education other,2938,14061670,2451,3168287,155711,3818,5389,17229957,2010
AK,education - other,267,1332308,50,20969,1735,277,317,1353277,2010
AK,libraries,0,0,0,0,0,0,0,0,2010
AK,liquor stores,0,0,0,0,0,0,0,0,2010
AK,other and unallocable,2901,15817825,68,96502,4544,2929,2969,15914327,2010
AZ,total,57260,249945573,25630,27593041,1689314,66807,82890,277538614,2010
AZ,financial administration,2982,11672444,40,90086,3486,3000,3022,11762530,2010
AZ,other government administration,697,2793314,109,200615,6312,733,806,2993929,2010
AZ,judicial and legal,1926,8923712,56,162874,5571,1958,1982,9086586,2010
AZ,police protection - officers,1181,6640521,0,0,0,1181,1181,6640521,2010
AZ,police protection - other,848,3831119,33,85735,3319,867,881,3916854,2010
AZ,corrections,9681,36135249,39,140769,3643,9702,9720,36276018,2010
AZ,highways,2653,11032087,39,88378,3505,2673,2692,11120465,2010
AZ,air transportation,0,0,0,0,0,0,0,0,2010
AZ,water transport and terminals,0,0,0,0,0,0,0,0,2010
AZ,public welfare,4561,14399720,117,305264,11396,4625,4678,14704984,2010
AZ,health,2671,10516718,51,142176,5707,2703,2722,10658894,2010
AZ,hospitals,657,2596608,16,67655,1718,667,673,2664263,2010
AZ,social insurance administration,1558,4441636,52,65880,5400,1589,1610,4507516,2010
AZ,solid waste management,0,0,0,0,0,0,0,0,2010
AZ,sewerage,0,0,0,0,0,0,0,0,2010
AZ,parks and recreation,339,985318,4,7202,487,342,343,992520,2010
AZ,housing and community development,0,0,0,0,0,0,0,0,2010
AZ,natural resources,1783,7265204,660,807734,49806,2063,2443,8072938,2010
AZ,water transport and terminals,0,0,0,0,0,0,0,0,2010
AZ,electric power,8,60988,0,0,0,8,8,60988,2010
AZ,gas supply,0,0,0,0,0,0,0,0,2010
AZ,transit,0,0,0,0,0,0,0,0,2010
AZ,education - elementary and secondary instructional,0,0,0,0,0,0,0,0,2010
AZ,education - elementary and secondary other,0,0,0,0,0,0,0,0,2010
AZ,education - higher education instructional,6760,47103523,8266,10746488,573501,10000,15026,57850011,2010
AZ,education - higher education other,13056,59763023,15684,14019171,980879,18597,28740,73782194,2010
AZ,education - other,2897,9518115,264,384330,22260,3024,3161,9902445,2010
AZ,libraries,0,0,0,0,0,0,0,0,2010
AZ,liquor stores,0,0,0,0,0,0,0,0,2010
AZ,other and unallocable,3002,12266274,200,278684,12324,3075,3202,12544958,2010
AR,total,57389,217816575,15012,14900726,1079946,63484,72401,232717301,2010
AR,financial administration,1969,6949359,12,8171,565,1971,1981,6957530,2010
AR,other government administration,743,3136783,144,185213,10394,801,887,3321996,2010
AR,judicial and legal,1558,5306092,162,234067,7126,1598,1720,5540159,2010
AR,police protection - officers,552,2371453,0,0,0,552,552,2371453,2010
AR,police protection - other,657,2085263,5,4596,400,659,662,2089859,2010
AR,corrections,5191,15741379,0,0,0,5191,5191,15741379,2010
AR,highways,3416,12431203,0,0,0,3416,3416,12431203,2010
AR,air transportation,0,0,0,0,0,0,0,0,2010
AR,water transport and terminals,0,0,0,0,0,0,0,0,2010
AR,public welfare,4091,12795548,58,71524,5101,4120,4149,12867072,2010
AR,health,4380,14456078,129,174750,9615,4434,4509,14630828,2010
AR,hospitals,6410,23234740,492,947776,62366,6762,6902,24182516,2010
AR,social insurance administration,1296,4449400,8,11987,516,1299,1304,4461387,2010
AR,solid waste management,0,0,0,0,0,0,0,0,2010
AR,sewerage,0,0,0,0,0,0,0,0,2010
AR,parks and recreation,734,2025522,240,141179,18952,841,974,2166701,2010
AR,housing and community development,0,0,0,0,0,0,0,0,2010
AR,natural resources,1873,6539991,430,353362,28298,2032,2303,6893353,2010
AR,water transport and terminals,0,0,0,0,0,0,0,0,2010
AR,electric power,0,0,0,0,0,0,0,0,2010
AR,gas supply,0,0,0,0,0,0,0,0,2010
AR,transit,0,0,0,0,0,0,0,0,2010
AR,education - elementary and secondary instructional,0,0,0,0,0,0,0,0,2010
AR,education - elementary and secondary other,0,0,0,0,0,0,0,0,2010
AR,education - higher education instructional,6552,43871721,4870,7480256,446089,9072,11422,51351977,2010
AR,education - higher education other,14006,47935067,8278,5106028,478822,16711,22284,53041095,2010
AR,education - other,1448,5163361,26,24940,1305,1455,1474,5188301,2010
AR,libraries,0,0,0,0,0,0,0,0,2010
AR,liquor stores,0,0,0,0,0,0,0,0,2010
AR,other and unallocable,2513,9323615,158,156877,10397,2570,2671,9480492,2010
CA,total,339430,1948329221,151361,299485128,12603879,410653,490791,2247814349,2010
CA,financial administration,22253,94931749,2779,4570854,301938,23959,25032,99502603,2010
CA,other government administration,3755,20388727,325,912756,32300,3948,4080,21301483,2010
CA,judicial and legal,6380,40121634,822,1727543,52360,6677,7202,41849177,2010
CA,police protection - officers,8214,64653348,436,670528,11665,8280,8650,65323876,2010
CA,police protection - other,3608,12949820,69,114490,6354,3644,3677,13064310,2010
CA,corrections,60421,355250469,1953,6884480,228141,61710,62374,362134949,2010
CA,highways,20301,127043620,941,3506379,134578,21061,21242,130549999,2010
CA,air transportation,0,0,0,0,0,0,0,0,2010
CA,water transport and terminals,0,0,0,0,0,0,0,0,2010
CA,public welfare,3881,14789210,427,684677,25345,4025,4308,15473887,2010
CA,health,12457,65989809,1458,4158016,135933,13225,13915,70147825,2010
CA,hospitals,29099,192769877,16854,81338717,2221998,41653,45953,274108594,2010
CA,social insurance administration,17954,78047540,2022,4632323,241430,19318,19976,82679863,2010
CA,solid waste management,630,3029679,36,93152,3472,650,666,3122831,2010
CA,sewerage,0,0,0,0,0,0,0,0,2010
CA,parks and recreation,2389,10192960,1788,2939665,212162,3587,4177,13132625,2010
CA,housing and community development,0,0,0,0,0,0,0,0,2010
CA,natural resources,13007,66485706,2986,4882353,376513,15134,15993,71368059,2010
CA,water transport and terminals,0,0,0,0,0,0,0,0,2010
CA,electric power,0,0,0,0,0,0,0,0,2010
CA,gas supply,0,0,0,0,0,0,0,0,2010
CA,transit,0,0,0,0,0,0,0,0,2010
CA,education - elementary and secondary instructional,0,0,0,0,0,0,0,0,2010
CA,education - elementary and secondary other,0,0,0,0,0,0,0,0,2010
CA,education - higher education instructional,23860,188703032,27681,49135702,1908693,34644,51541,237838734,2010
CA,education - higher education other,86820,489172109,87970,127210088,6477974,123420,174790,616382197,2010
CA,education - other,4047,18754700,636,1075949,55490,4360,4683,19830649,2010
CA,libraries,0,0,0,0,0,0,0,0,2010
CA,liquor stores,0,0,0,0,0,0,0,0,2010
CA,other and unallocable,20354,105055232,2178,4947456,177533,21358,22532,110002688,2010
CO,total,53739,270484395,43136,77174346,3065924,71064,96875,347658741,2010
CO,financial administration,1896,9177065,82,222751,7813,1941,1978,9399816,2010
CO,other government administration,444,1899991,172,449634,22261,571,616,2349625,2010
CO,judicial and legal,3766,19379689,609,1794857,66226,4140,4375,21174546,2010
CO,police protection - officers,1050,6211679,0,0,0,1050,1050,6211679,2010
CO,police protection - other,448,1720682,54,158550,1670,457,502,1879232,2010
CO,corrections,7297,31100508,77,239285,8455,7345,7374,31339793,2010
CO,highways,3020,14229855,120,323825,12842,3093,3140,14553680,2010
CO,air transportation,0,0,0,0,0,0,0,0,2010
CO,water transport and terminals,0,0,0,0,0,0,0,0,2010
CO,public welfare,1982,9210747,488,1212763,50542,2268,2470,10423510,2010
CO,health,1209,6844752,151,479038,14866,1293,1360,7323790,2010
CO,hospitals,4427,17111916,1052,4227420,143883,5241,5479,21339336,2010
CO,social insurance administration,1045,5009503,293,767142,37719,1258,1338,5776645,2010
CO,solid waste management,0,0,0,0,0,0,0,0,2010
CO,sewerage,0,0,0,0,0,0,0,0,2010
CO,parks and recreation,258,1225566,100,95129,4526,284,358,1320695,2010
CO,housing and community development,0,0,0,0,0,0,0,0,2010
CO,natural resources,1606,8377298,383,798849,19812,1718,1989,9176147,2010
CO,water transport and terminals,0,0,0,0,0,0,0,0,2010
CO,electric power,0,0,0,0,0,0,0,0,2010
CO,gas supply,0,0,0,0,0,0,0,0,2010
CO,transit,0,0,0,0,0,0,0,0,2010
CO,education - elementary and secondary instructional,0,0,0,0,0,0,0,0,2010
CO,education - elementary and secondary other,0,0,0,0,0,0,0,0,2010
CO,education - higher education instructional,8475,63621460,12017,31102477,1096378,14667,20492,94723937,2010
CO,education - higher education other,14171,62044329,26536,33727529,1517180,22742,40707,95771858,2010
CO,education - other,984,4885188,940,1410651,55381,1297,1924,6295839,2010
CO,libraries,0,0,0,0,0,0,0,0,2010
CO,liquor stores,0,0,0,0,0,0,0,0,2010
CO,other and unallocable,1661,8434167,62,164446,6370,1699,1723,8598613,2010
CT,total,53451,301012831,25112,40524475,1616176,63199,78563,341537306,2010
CT,financial administration,2539,13614359,163,449617,18361,2643,2702,14063976,2010
CT,other government administration,1127,5730580,256,890977,28979,1290,1383,6621557,2010
CT,judicial and legal,4763,22951834,281,674526,10026,4820,5044,23626360,2010
CT,police protection - officers,1209,7211746,1,2608,120,1210,1210,7214354,2010
CT,police protection - other,648,3481821,50,48343,1718,658,698,3530164,2010
CT,corrections,7153,35851008,141,440709,11761,7220,7294,36291717,2010
CT,highways,2949,16741661,2,7973,261,2950,2951,16749634,2010
CT,air transportation,139,828691,0,0,0,139,139,828691,2010
CT,water transport and terminals,0,0,0,0,0,0,0,0,2010
CT,public welfare,5460,29880050,393,1617440,58220,5789,5853,31497490,2010
CT,health,3906,21722053,765,2625028,65618,4284,4671,24347081,2010
CT,hospitals,5375,32047858,2146,8001133,243548,6756,7521,40048991,2010
CT,social insurance administration,656,3916504,7,24139,1187,663,663,3940643,2010
CT,solid waste management,49,322609,6,15668,713,53,55,338277,2010
CT,sewerage,0,0,0,0,0,0,0,0,2010
CT,parks and recreation,164,785268,24,30343,1382,172,188,815611,2010
CT,housing and community development,0,0,0,0,0,0,0,0,2010
CT,natural resources,695,3597762,88,205134,7846,740,783,3802896,2010
CT,water transport and terminals,0,0,0,0,0,0,0,0,2010
CT,electric power,0,0,0,0,0,0,0,0,2010
CT,gas supply,0,0,0,0,0,0,0,0,2010
CT,transit,0,0,0,0,0,0,0,0,2010
CT,education - elementary and secondary instructional,0,0,0,0,0,0,0,0,2010
CT,education - elementary and secondary other,0,0,0,0,0,0,0,0,2010
CT,education - higher education instructional,4099,32065569,9152,14876523,516355,7263,13251,46942092,2010
CT,education - higher education other,7820,43426659,10396,8853713,576663,11433,18216,52280372,2010
CT,education - other,2151,12410162,906,1067809,43486,2397,3057,13477971,2010
CT,libraries,0,0,0,0,0,0,0,0,2010
CT,liquor stores,0,0,0,0,0,0,0,0,2010
CT,other and unallocable,2549,14426637,335,692792,29932,2719,2884,15119429,2010
DE,total,22951,94392330,8243,10854264,509570,26022,31194,105246594,2010
DE,financial administration,771,2582970,25,28674,1465,780,796,2611644,2010
DE,other government administration,377,1550095,93,295558,10109,438,470,1845653,2010
DE,judicial and legal,1689,7429896,44,84254,4286,1715,1733,7514150,2010
DE,police protection - officers,692,4596085,0,0,0,692,692,4596085,2010
DE,police protection - other,299,1115099,11,24881,1258,307,310,1139980,2010
DE,corrections,2844,10490193,47,66544,5199,2876,2891,10556737,2010
DE,highways,1553,4901873,4,6987,447,1556,1557,4908860,2010
DE,air transportation,0,0,0,0,0,0,0,0,2010
DE,water transport and terminals,273,1082580,0,0,0,273,273,1082580,2010
DE,public welfare,1503,5038844,76,132720,7950,1552,1579,5171564,2010
DE,health,1951,7029607,141,270092,14142,2037,2092,7299699,2010
DE,hospitals,1664,5501133,90,124210,8023,1712,1754,5625343,2010
DE,social insurance administration,335,1068016,21,35052,1784,346,356,1103068,2010
DE,solid waste management,162,562387,17,24146,1877,173,179,586533,2010
DE,sewerage,0,0,0,0,0,0,0,0,2010
DE,parks and recreation,307,738961,27,19632,1472,316,334,758593,2010
DE,housing and community development,0,0,0,0,0,0,0,0,2010
DE,natural resources,467,1764989,58,80877,5569,500,525,1845866,2010
DE,water transport and terminals,0,0,0,0,0,0,0,0,2010
DE,electric power,0,0,0,0,0,0,0,0,2010
DE,gas supply,0,0,0,0,0,0,0,0,2010
DE,transit,819,3462335,3,7931,434,821,822,3470266,2010
DE,education - elementary and secondary instructional,0,0,0,0,0,0,0,0,2010
DE,education - elementary and secondary other,0,0,0,0,0,0,0,0,2010
DE,education - higher education instructional,1455,10954715,3295,5986492,206646,2699,4750,16941207,2010
DE,education - higher education other,3951,16797746,4065,3486052,228801,5330,8016,20283798,2010
DE,education - other,327,1785339,25,36615,1720,338,352,1821954,2010
DE,libraries,0,0,0,0,0,0,0,0,2010
DE,liquor stores,0,0,0,0,0,0,0,0,2010
DE,other and unallocable,1512,5939467,201,143547,8388,1561,1713,6083014,2010
FL,total,170261,657428592,43649,48417327,2508476,184465,213910,705845919,2010
FL,financial administration,6416,21175210,176,233407,14693,6499,6592,21408617,2010
FL,other government administration,2270,10154999,188,257766,16456,2362,2458,10412765,2010
FL,judicial and legal,19532,77427689,902,1403110,77100,19970,20434,78830799,2010
FL,police protection - officers,2196,9305017,411,659161,18057,2298,2607,9964178,2010
FL,police protection - other,2030,6957549,120,108010,7816,2074,2150,7065559,2010
FL,corrections,30592,93145808,363,528034,21179,30712,30955,93673842,2010
FL,highways,7616,31016495,77,66440,5657,7648,7693,31082935,2010
FL,air transportation,0,0,0,0,0,0,0,0,2010
FL,water transport and terminals,0,0,0,0,0,0,0,0,2010
FL,public welfare,9897,29615921,342,339300,25757,10043,10239,29955221,2010
FL,health,20009,64538875,1003,1695035,96022,20552,21012,66233910,2010
FL,hospitals,3813,11531197,86,148032,6817,3852,3899,11679229,2010
FL,social insurance administration,2488,8271371,10,19456,1014,2494,2498,8290827,2010
FL,solid waste management,0,0,0,0,0,0,0,0,2010
FL,sewerage,0,0,0,0,0,0,0,0,2010
FL,parks and recreation,1261,3065683,296,242302,18468,1365,1557,3307985,2010
FL,housing and community development,0,0,0,0,0,0,0,0,2010
FL,natural resources,8906,29061688,2498,2426008,152530,9767,11404,31487696,2010
FL,water transport and terminals,0,0,0,0,0,0,0,0,2010
FL,electric power,0,0,0,0,0,0,0,0,2010
FL,gas supply,0,0,0,0,0,0,0,0,2010
FL,transit,636,2693468,50,82081,6196,671,686,2775549,2010
FL,education - elementary and secondary instructional,0,0,0,0,0,0,0,0,2010
FL,education - elementary and secondary other,0,0,0,0,0,0,0,0,2010
FL,education - higher education instructional,15853,123104706,16072,20885020,776168,20243,31925,143989726,2010
FL,education - higher education other,27025,103455517,20272,18563395,1212760,33902,47297,122018912,2010
FL,education - other,3002,9950904,290,240832,16040,3092,3292,10191736,2010
FL,libraries,0,0,0,0,0,0,0,0,2010
FL,liquor stores,0,0,0,0,0,0,0,0,2010
FL,other and unallocable,6719,22956495,493,519938,35746,6921,7212,23476433,2010
GA,total,109674,416167424,44393,44277691,2562593,124159,154067,460445115,2010
GA,financial administration,3350,13674018,175,207462,11622,3416,3525,13881480,2010
GA,other government administration,964,3739644,250,234384,20530,1080,1214,3974028,2010
GA,judicial and legal,3578,15423675,107,268583,9459,3631,3685,15692258,2010
GA,police protection - officers,1086,4464548,1,1408,176,1087,1087,4465956,2010
GA,police protection - other,935,3209804,34,48798,3310,954,969,3258602,2010
GA,corrections,18995,47019486,577,865138,42456,19234,19572,47884624,2010
GA,highways,5580,16781086,45,24398,754,5585,5625,16805484,2010
GA,air transportation,41,174332,9,10018,578,44,50,184350,2010
GA,water transport and terminals,936,5523326,0,0,0,936,936,5523326,2010
GA,public welfare,8473,25242584,116,157303,4884,8500,8589,25399887,2010
GA,health,4134,14659496,421,946906,68054,4519,4555,15606402,2010
GA,hospitals,6903,16460188,1048,1771990,83482,7376,7951,18232178,2010
GA,social insurance administration,2235,6482972,208,262992,19318,2344,2443,6745964,2010
GA,solid waste management,0,0,0,0,0,0,0,0,2010
GA,sewerage,0,0,0,0,0,0,0,0,2010
GA,parks and recreation,1244,3399034,633,442860,49322,1523,1877,3841894,2010
GA,housing and community development,0,0,0,0,0,0,0,0,2010
GA,natural resources,3619,11372487,1308,1453412,104838,4211,4927,12825899,2010
GA,water transport and terminals,0,0,0,0,0,0,0,0,2010
GA,electric power,0,0,0,0,0,0,0,0,2010
GA,gas supply,0,0,0,0,0,0,0,0,2010
GA,transit,0,0,0,0,0,0,0,0,2010
GA,education - elementary and secondary instructional,0,0,0,0,0,0,0,0,2010
GA,education - elementary and secondary other,0,0,0,0,0,0,0,0,2010
GA,education - higher education instructional,13787,86798759,15561,19492159,822179,18434,29348,106290918,2010
GA,education - higher education other,28201,119369953,22774,16626794,1236476,35189,50975,135996747,2010
GA,education - other,2750,11461840,768,1101177,61453,3097,3518,12563017,2010
GA,libraries,0,0,0,0,0,0,0,0,2010
GA,liquor stores,0,0,0,0,0,0,0,0,2010
GA,other and unallocable,2863,10910192,358,361909,23702,2999,3221,11272101,2010
HI,total,53439,210691614,20195,18515592,828576,58121,73634,229207206,2010
HI,financial administration,703,2434072,3,6748,276,705,706,2440820,2010
HI,other government administration,710,2617690,174,371526,10831,771,884,2989216,2010
HI,judicial and legal,2439,10132030,47,89302,2650,2454,2486,10221332,2010
HI,police protection - officers,0,0,0,0,0,0,0,0,2010
HI,police protection - other,0,0,0,0,0,0,0,0,2010
HI,corrections,2372,9475188,12,38582,886,2377,2384,9513770,2010
HI,highways,849,3476430,11,10500,858,854,860,3486930,2010
HI,air transportation,940,3539678,11,14986,836,945,951,3554664,2010
HI,water transport and terminals,203,783130,0,0,0,203,203,783130,2010
HI,public welfare,475,1778610,32,22224,2440,489,507,1800834,2010
HI,health,2051,8818956,54,169672,4728,2078,2105,8988628,2010
HI,hospitals,4073,18252306,573,1327842,39575,4297,4646,19580148,2010
HI,social insurance administration,317,1201288,28,56736,2236,330,345,1258024,2010
HI,solid waste management,0,0,0,0,0,0,0,0,2010
HI,sewerage,0,0,0,0,0,0,0,0,2010
HI,parks and recreation,141,474644,508,97192,6076,175,649,571836,2010
HI,housing and community development,0,0,0,0,0,0,0,0,2010
HI,natural resources,1002,4417460,279,288708,16342,1094,1281,4706168,2010
HI,water transport and terminals,0,0,0,0,0,0,0,0,2010
HI,electric power,0,0,0,0,0,0,0,0,2010
HI,gas supply,0,0,0,0,0,0,0,0,2010
HI,transit,0,0,0,0,0,0,0,0,2010
HI,education - elementary and secondary instructional,17762,69880690,8915,8081270,334390,19651,26677,77961960,2010
HI,education - elementary and secondary other,7337,15285854,2793,1167436,72734,7748,10130,16453290,2010
HI,education - higher education instructional,3545,23770588,1342,2863532,97494,4096,4887,26634120,2010
HI,education - higher education other,4361,18572356,5134,3704230,218578,5596,9495,22276586,2010
HI,education - other,119,465158,2,4516,160,120,121,469674,2010
HI,libraries,488,1475844,210,127948,11938,555,698,1603792,2010
HI,liquor stores,0,0,0,0,0,0,0,0,2010
HI,other and unallocable,3552,13839642,67,72642,5548,3583,3619,13912284,2010
ID,total,18313,78377334,10220,10539244,632841,21940,28533,88916578,2010
ID,financial administration,1157,5185541,187,334742,22387,1291,1344,5520283,2010
ID,other government administration,124,706994,198,496950,17565,229,322,1203944,2010
ID,judicial and legal,487,3650354,14,34878,1262,495,501,3685232,2010
ID,police protection - officers,256,1147009,0,0,0,256,256,1147009,2010
ID,police protection - other,171,513524,20,24890,1946,182,191,538414,2010
ID,corrections,1927,7871376,23,38590,2270,1940,1950,7909966,2010
ID,highways,1542,4985638,121,194124,16822,1637,1663,5179762,2010
ID,air transportation,0,0,0,0,0,0,0,0,2010
ID,water transport and terminals,0,0,0,0,0,0,0,0,2010
ID,public welfare,1576,5149460,146,193712,13441,1655,1722,5343172,2010
ID,health,1022,4200809,122,212930,8625,1071,1144,4413739,2010
ID,hospitals,649,1997347,128,147395,12007,717,777,2144742,2010
ID,social insurance administration,568,2796912,238,391659,16348,666,806,3188571,2010
ID,solid waste management,0,0,0,0,0,0,0,0,2010
ID,sewerage,0,0,0,0,0,0,0,0,2010
ID,parks and recreation,176,670540,78,87554,5994,212,254,758094,2010
ID,housing and community development,0,0,0,0,0,0,0,0,2010
ID,natural resources,1491,6995486,766,1089794,57030,1830,2257,8085280,2010
ID,water transport and terminals,0,0,0,0,0,0,0,0,2010
ID,electric power,0,0,0,0,0,0,0,0,2010
ID,gas supply,0,0,0,0,0,0,0,0,2010
ID,transit,0,0,0,0,0,0,0,0,2010
ID,education - elementary and secondary instructional,0,0,0,0,0,0,0,0,2010
ID,education - elementary and secondary other,0,0,0,0,0,0,0,0,2010
ID,education - higher education instructional,2182,12456650,2192,3117715,125449,2891,4374,15574365,2010
ID,education - higher education other,3706,13950050,5629,3706271,306371,5437,9335,17656321,2010
ID,education - other,351,1750824,144,246009,10890,417,495,1996833,2010
ID,libraries,0,0,0,0,0,0,0,0,2010
ID,liquor stores,166,608774,145,145414,10354,228,311,754188,2010
ID,other and unallocable,762,3740046,69,76617,4080,786,831,3816663,2010
IL,total,105848,563580096,52739,83154278,4416061,131352,158587,646734374,2010
IL,financial administration,4940,23014037,307,556271,33080,5141,5247,23570308,2010
IL,other government administration,2136,12830826,45,85747,3424,2156,2181,12916573,2010
IL,judicial and legal,2603,22084557,72,209556,5171,2634,2675,22294113,2010
IL,police protection - officers,2198,16334054,0,0,0,2198,2198,16334054,2010
IL,police protection - other,1475,8079548,14,49264,1134,1481,1489,8128812,2010
IL,corrections,11126,60983718,4,21138,366,11128,11130,61004856,2010
IL,highways,5974,33219039,1246,4753887,140148,6818,7220,37972926,2010
IL,air transportation,0,0,0,0,0,0,0,0,2010
IL,water transport and terminals,60,363456,0,0,0,60,60,363456,2010
IL,public welfare,9293,48640482,34,91444,3084,9311,9327,48731926,2010
IL,health,2467,14019262,8,23194,603,2471,2475,14042456,2010
IL,hospitals,10791,53727474,782,1776117,58971,11127,11573,55503591,2010
IL,social insurance administration,2088,11423746,364,1459962,35796,2304,2452,12883708,2010
IL,solid waste management,0,0,0,0,0,0,0,0,2010
IL,sewerage,0,0,0,0,0,0,0,0,2010
IL,parks and recreation,454,2107904,27,84084,3844,477,481,2191988,2010
IL,housing and community development,0,0,0,0,0,0,0,0,2010
IL,natural resources,2432,11440731,1466,2902572,188962,3501,3898,14343303,2010
IL,water transport and terminals,0,0,0,0,0,0,0,0,2010
IL,electric power,0,0,0,0,0,0,0,0,2010
IL,gas supply,0,0,0,0,0,0,0,0,2010
IL,transit,0,0,0,0,0,0,0,0,2010
IL,education - elementary and secondary instructional,0,0,0,0,0,0,0,0,2010
IL,education - elementary and secondary other,0,0,0,0,0,0,0,0,2010
IL,education - higher education instructional,13107,87472657,17915,34198868,1456225,21552,31022,121671525,2010
IL,education - higher education other,26394,114335115,30159,36187306,2454623,40502,56553,150522421,2010
IL,education - other,2044,10188590,14,50940,1438,2052,2058,10239530,2010
IL,libraries,0,0,0,0,0,0,0,0,2010
IL,liquor stores,0,0,0,0,0,0,0,0,2010
IL,other and unallocable,6266,33314900,282,703928,29192,6439,6548,34018828,2010
IN,total,76219,306638453,40353,32495003,2337104,89549,116572,339133456,2010
IN,financial administration,2130,8721362,23,26959,1452,2137,2153,8748321,2010
IN,other government administration,547,2439663,256,553277,21452,677,803,2992940,2010
IN,judicial and legal,1389,9194519,50,33907,1719,1399,1439,9228426,2010
IN,police protection - officers,1282,5877794,0,0,0,1282,1282,5877794,2010
IN,police protection - other,673,2158118,5,4390,338,675,678,2162508,2010
IN,corrections,6795,20641784,4,2244,164,6796,6799,20644028,2010
IN,highways,3985,12801098,86,56525,3710,4007,4071,12857623,2010
IN,air transportation,0,0,0,0,0,0,0,0,2010
IN,water transport and terminals,28,157765,0,0,0,28,28,157765,2010
IN,public welfare,4693,15334867,37,20932,1731,4704,4730,15355799,2010
IN,health,1769,6875945,11,10863,411,1771,1780,6886808,2010
IN,hospitals,2445,7672826,34,20362,1192,2451,2479,7693188,2010
IN,social insurance administration,1201,3723899,268,134705,12066,1274,1469,3858604,2010
IN,solid waste management,0,0,0,0,0,0,0,0,2010
IN,sewerage,0,0,0,0,0,0,0,0,2010
IN,parks and recreation,122,405133,55,44406,5345,154,177,449539,2010
IN,housing and community development,0,0,0,0,0,0,0,0,2010
IN,natural resources,2003,7691872,511,484632,51958,2309,2514,8176504,2010
IN,water transport and terminals,0,0,0,0,0,0,0,0,2010
IN,electric power,0,0,0,0,0,0,0,0,2010
IN,gas supply,0,0,0,0,0,0,0,0,2010
IN,transit,0,0,0,0,0,0,0,0,2010
IN,education - elementary and secondary instructional,0,0,0,0,0,0,0,0,2010
IN,education - elementary and secondary other,0,0,0,0,0,0,0,0,2010
IN,education - higher education instructional,18393,100524718,12853,17585708,882308,23389,31246,118110426,2010
IN,education - higher education other,25573,90730200,25928,13399307,1344777,33256,51501,104129507,2010
IN,education - other,1069,4015613,129,66234,5252,1101,1198,4081847,2010
IN,libraries,0,0,0,0,0,0,0,0,2010
IN,liquor stores,0,0,0,0,0,0,0,0,2010
IN,other and unallocable,2122,7671277,103,50552,3229,2139,2225,7721829,2010
IA,total,41986,223605894,24645,31574559,1653060,51328,66631,255180453,2010
IA,financial administration,1124,5111703,50,110692,5954,1158,1174,5222395,2010
IA,other government administration,350,1865275,277,579765,20675,467,627,2445040,2010
IA,judicial and legal,2059,10133385,142,311613,22860,2188,2201,10444998,2010
IA,police protection - officers,653,4514089,0,0,0,653,653,4514089,2010
IA,police protection - other,340,1778455,26,24340,1452,348,366,1802795,2010
IA,corrections,3165,13857277,101,226139,8599,3214,3266,14083416,2010
IA,highways,2405,10676003,0,0,0,2405,2405,10676003,2010
IA,air transportation,0,0,0,0,0,0,0,0,2010
IA,water transport and terminals,0,0,0,0,0,0,0,0,2010
IA,public welfare,3028,13051920,56,123091,6213,3063,3084,13175011,2010
IA,health,449,2341588,42,65182,3031,466,491,2406770,2010
IA,hospitals,6321,36430174,3157,5496872,279428,7901,9478,41927046,2010
IA,social insurance administration,723,3384832,3,7709,392,725,726,3392541,2010
IA,solid waste management,0,0,0,0,0,0,0,0,2010
IA,sewerage,0,0,0,0,0,0,0,0,2010
IA,parks and recreation,78,336017,0,0,0,78,78,336017,2010
IA,housing and community development,0,0,0,0,0,0,0,0,2010
IA,natural resources,1547,7830136,197,219101,17674,1647,1744,8049237,2010
IA,water transport and terminals,0,0,0,0,0,0,0,0,2010
IA,electric power,0,0,0,0,0,0,0,0,2010
IA,gas supply,0,0,0,0,0,0,0,0,2010
IA,transit,0,0,0,0,0,0,0,0,2010
IA,education - elementary and secondary instructional,0,0,0,0,0,0,0,0,2010
IA,education - elementary and secondary other,0,0,0,0,0,0,0,0,2010
IA,education - higher education instructional,3705,33851239,6901,16663673,610472,7154,10606,50514912,2010
IA,education - higher education other,12079,59396593,13357,7145648,644478,15720,25436,66542241,2010
IA,education - other,1134,5570253,112,224348,10110,1191,1246,5794601,2010
IA,libraries,0,0,0,0,0,0,0,0,2010
IA,liquor stores,0,0,0,0,0,0,0,0,2010
IA,other and unallocable,2826,13476955,224,376386,21722,2950,3050,13853341,2010
KS,total,38820,162197139,15907,15588523,886179,43824,54727,177785662,2010
KS,financial administration,1896,7003745,211,341049,13760,1972,2107,7344794,2010
KS,other government administration,503,1654418,198,584781,23993,639,701,2239199,2010
KS,judicial and legal,2045,8710112,101,131880,6631,2082,2146,8841992,2010
KS,police protection - officers,360,1757263,21,38566,2110,372,381,1795829,2010
KS,police protection - other,720,2924277,41,55979,3102,738,761,2980256,2010
KS,corrections,3397,10328487,20,22904,1431,3406,3417,10351391,2010
KS,highways,3161,11401298,139,177211,11364,3225,3300,11578509,2010
KS,air transportation,0,0,0,0,0,0,0,0,2010
KS,water transport and terminals,0,0,0,0,0,0,0,0,2010
KS,public welfare,2211,7032819,55,61817,5336,2240,2266,7094636,2010
KS,health,1175,4749961,38,62846,2282,1188,1213,4812807,2010
KS,hospitals,3001,9441147,401,260508,12208,3071,3402,9701655,2010
KS,social insurance administration,96,329651,1,199,33,96,97,329850,2010
KS,solid waste management,0,0,0,0,0,0,0,0,2010
KS,sewerage,0,0,0,0,0,0,0,0,2010
KS,parks and recreation,621,1705258,9,1951,102,622,630,1707209,2010
KS,housing and community development,0,0,0,0,0,0,0,0,2010
KS,natural resources,768,3056168,108,91290,7114,808,876,3147458,2010
KS,water transport and terminals,0,0,0,0,0,0,0,0,2010
KS,electric power,0,0,0,0,0,0,0,0,2010
KS,gas supply,0,0,0,0,0,0,0,0,2010
KS,transit,0,0,0,0,0,0,0,0,2010
KS,education - elementary and secondary instructional,0,0,0,0,0,0,0,0,2010
KS,education - elementary and secondary other,0,0,0,0,0,0,0,0,2010
KS,education - higher education instructional,4660,36280809,5155,8129653,357847,6682,9815,44410462,2010
KS,education - higher education other,10468,41405207,9089,5226222,424551,12867,19557,46631429,2010
KS,education - other,635,2562678,60,77446,2263,648,695,2640124,2010
KS,libraries,0,0,0,0,0,0,0,0,2010
KS,liquor stores,0,0,0,0,0,0,0,0,2010
KS,other and unallocable,3103,11853841,260,324221,12052,3168,3363,12178062,2010
KY,total,70296,276941347,27831,32739848,1771384,80714,98127,309681195,2010
KY,financial administration,2283,8845212,6,14010,428,2286,2289,8859222,2010
KY,other government administration,647,3242956,186,649878,28739,820,833,3892834,2010
KY,judicial and legal,4740,17239036,588,1308252,82149,5235,5328,18547288,2010
KY,police protection - officers,1034,4087589,0,0,0,1034,1034,4087589,2010
KY,police protection - other,1237,4904918,0,0,0,1237,1237,4904918,2010
KY,corrections,4138,11222037,0,0,0,4138,4138,11222037,2010
KY,highways,4534,14905641,1,900,70,4534,4535,14906541,2010
KY,air transportation,0,0,0,0,0,0,0,0,2010
KY,water transport and terminals,0,0,0,0,0,0,0,0,2010
KY,public welfare,5745,18076564,0,0,0,5745,5745,18076564,2010
KY,health,2846,10894782,93,225813,11358,2910,2939,11120595,2010
KY,hospitals,4802,19894990,676,1113956,35218,5001,5478,21008946,2010
KY,social insurance administration,980,3067857,0,0,0,980,980,3067857,2010
KY,solid waste management,0,0,0,0,0,0,0,0,2010
KY,sewerage,0,0,0,0,0,0,0,0,2010
KY,parks and recreation,1102,2861970,104,112765,12169,1175,1206,2974735,2010
KY,housing and community development,0,0,0,0,0,0,0,0,2010
KY,natural resources,2932,9178616,84,126363,6825,2970,3016,9304979,2010
KY,water transport and terminals,0,0,0,0,0,0,0,0,2010
KY,electric power,0,0,0,0,0,0,0,0,2010
KY,gas supply,0,0,0,0,0,0,0,0,2010
KY,transit,0,0,0,0,0,0,0,0,2010
KY,education - elementary and secondary instructional,0,0,0,0,0,0,0,0,2010
KY,education - elementary and secondary other,0,0,0,0,0,0,0,0,2010
KY,education - higher education instructional,9154,64157075,7907,13280821,520510,12233,17061,77437896,2010
KY,education - higher education other,18739,64340837,17968,15722729,1064197,24975,36707,80063566,2010
KY,education - other,1938,7999884,206,166306,9038,1993,2144,8166190,2010
KY,libraries,0,0,0,0,0,0,0,0,2010
KY,liquor stores,0,0,0,0,0,0,0,0,2010
KY,other and unallocable,3445,12021383,12,18055,683,3448,3457,12039438,2010
LA,total,80953,346664346,23372,21415249,1374083,88720,104325,368079595,2010
LA,financial administration,2362,9678685,126,158887,11321,2425,2488,9837572,2010
LA,other government administration,2201,10176930,690,665300,38246,2425,2891,10842230,2010
LA,judicial and legal,1637,7196311,36,30997,2264,1650,1673,7227308,2010
LA,police protection - officers,1032,5684443,0,0,0,1032,1032,5684443,2010
LA,police protection - other,655,3376757,45,90271,4364,679,700,3467028,2010
LA,corrections,6965,27054358,59,85285,7280,7006,7024,27139643,2010
LA,highways,4763,18857596,51,64194,4158,4786,4814,18921790,2010
LA,air transportation,0,0,0,0,0,0,0,0,2010
LA,water transport and terminals,255,1261098,3,12822,334,257,258,1273920,2010
LA,public welfare,5821,21288363,87,109113,6198,5855,5908,21397476,2010
LA,health,3810,17078044,110,208136,10882,3873,3920,17286180,2010
LA,hospitals,13834,54268817,1899,2498163,147333,14667,15733,56766980,2010
LA,social insurance administration,750,2932080,56,84165,5781,783,806,3016245,2010
LA,solid waste management,0,0,0,0,0,0,0,0,2010
LA,sewerage,0,0,0,0,0,0,0,0,2010
LA,parks and recreation,889,2492173,193,214216,20849,1006,1082,2706389,2010
LA,housing and community development,0,0,0,0,0,0,0,0,2010
LA,natural resources,4088,17239677,841,847667,63601,4445,4929,18087344,2010
LA,water transport and terminals,0,0,0,0,0,0,0,0,2010
LA,electric power,0,0,0,0,0,0,0,0,2010
LA,gas supply,0,0,0,0,0,0,0,0,2010
LA,transit,0,0,0,0,0,0,0,0,2010
LA,education - elementary and secondary instructional,1371,5541932,304,155365,10904,1433,1675,5697297,2010
LA,education - elementary and secondary other,215,1010244,74,136139,8185,261,289,1146383,2010
LA,education - higher education instructional,8243,56880422,5717,8508457,395297,10478,13960,65388879,2010
LA,education - higher education other,15993,58500988,12097,6414247,583085,19286,28090,64915235,2010
LA,education - other,3271,14192686,796,955311,43238,3514,4067,15147997,2010
LA,libraries,0,0,0,0,0,0,0,0,2010
LA,liquor stores,0,0,0,0,0,0,0,0,2010
LA,other and unallocable,2798,11952742,188,176514,10763,2859,2986,12129256,2010
ME,total,17731,72039664,10346,12642901,601424,21130,28077,84682565,2010
ME,financial administration,869,3459199,566,927534,38046,1083,1435,4386733,2010
ME,other government administration,280,1373043,252,717284,25938,428,532,2090327,2010
ME,judicial and legal,613,2829290,140,277756,9748,668,753,3107046,2010
ME,police protection - officers,320,1726690,0,0,0,320,320,1726690,2010
ME,police protection - other,266,976600,2,4773,230,267,268,981373,2010
ME,corrections,888,3745404,365,1267322,51065,1176,1253,5012726,2010
ME,highways,2158,7750602,86,108758,5943,2191,2244,7859360,2010
ME,air transportation,0,0,0,0,0,0,0,0,2010
ME,water transport and terminals,63,230581,22,37011,2641,78,85,267592,2010
ME,public welfare,2979,10088027,79,178694,7930,3024,3058,10266721,2010
ME,health,958,3811001,192,381142,12938,1032,1150,4192143,2010
ME,hospitals,348,1589023,204,446581,20032,461,552,2035604,2010
ME,social insurance administration,275,1039523,176,284984,11137,338,451,1324507,2010
ME,solid waste management,0,0,0,0,0,0,0,0,2010
ME,sewerage,0,0,0,0,0,0,0,0,2010
ME,parks and recreation,100,368897,69,102787,3955,123,169,471684,2010
ME,housing and community development,0,0,0,0,0,0,0,0,2010
ME,natural resources,841,3632818,353,639758,22038,966,1194,4272576,2010
ME,water transport and terminals,0,0,0,0,0,0,0,0,2010
ME,electric power,0,0,0,0,0,0,0,0,2010
ME,gas supply,0,0,0,0,0,0,0,0,2010
ME,transit,0,0,0,0,0,0,0,0,2010
ME,education - elementary and secondary instructional,14,32207,15,13410,1904,25,29,45617,2010
ME,education - elementary and secondary other,4,4765,34,18726,2128,16,38,23491,2010
ME,education - higher education instructional,1718,10040273,2381,3190957,124191,2419,4099,13231230,2010
ME,education - higher education other,3653,13468667,4837,2813131,216817,4879,8490,16281798,2010
ME,education - other,154,668486,99,156957,6160,189,253,825443,2010
ME,libraries,0,0,0,0,0,0,0,0,2010
ME,liquor stores,1,4443,0,0,0,1,1,4443,2010
ME,other and unallocable,1229,5200125,474,1075336,38583,1446,1703,6275461,2010
MD,total,80260,373226119,13670,37729374,1426996,88318,93930,410955493,2010
MD,financial administration,3445,15077856,115,274778,13130,3519,3560,15352634,2010
MD,other government administration,1446,7498415,311,593696,18084,1549,1757,8092111,2010
MD,judicial and legal,4783,25883131,438,1044798,61021,5127,5221,26927929,2010
MD,police protection - officers,1516,8560619,0,0,0,1516,1516,8560619,2010
MD,police protection - other,834,3531454,42,102100,5422,864,876,3633554,2010
MD,corrections,12347,50531076,318,696109,44116,12597,12665,51227185,2010
MD,highways,4710,20525580,2,5141,97,4710,4712,20530721,2010
MD,air transportation,488,2328382,1,1408,20,488,489,2329790,2010
MD,water transport and terminals,281,1504493,1,906,29,281,282,1505399,2010
MD,public welfare,6474,25423365,121,313330,18206,6578,6595,25736695,2010
MD,health,5882,25443040,767,1591184,92430,6404,6649,27034224,2010
MD,hospitals,3991,16555470,621,1093831,57044,4313,4612,17649301,2010
MD,social insurance administration,954,4169876,169,417078,26240,1102,1123,4586954,2010
MD,solid waste management,0,0,0,0,0,0,0,0,2010
MD,sewerage,0,0,0,0,0,0,0,0,2010
MD,parks and recreation,342,1434659,141,207804,12416,412,483,1642463,2010
MD,housing and community development,0,0,0,0,0,0,0,0,2010
MD,natural resources,1877,9385930,314,727308,37725,2090,2191,10113238,2010
MD,water transport and terminals,0,0,0,0,0,0,0,0,2010
MD,electric power,0,0,0,0,0,0,0,0,2010
MD,gas supply,0,0,0,0,0,0,0,0,2010
MD,transit,744,3761232,1,1809,42,744,745,3763041,2010
MD,education - elementary and secondary instructional,0,0,0,0,0,0,0,0,2010
MD,education - elementary and secondary other,0,0,0,0,0,0,0,0,2010
MD,education - higher education instructional,6909,51943152,4475,22876489,604523,10324,11384,74819641,2010
MD,education - higher education other,14937,63004556,4825,5564171,325977,16778,19762,68568727,2010
MD,education - other,1861,8572551,285,724631,33128,2048,2146,9297182,2010
MD,libraries,0,0,0,0,0,0,0,0,2010
MD,liquor stores,0,0,0,0,0,0,0,0,2010
MD,other and unallocable,6439,28091282,723,1492803,77346,6874,7162,29584085,2010
MA,total,84163,418537743,32241,48086147,1872842,95354,116404,466623890,2010
MA,financial administration,3773,18979220,319,1071267,21295,3901,4092,20050487,2010
MA,other government administration,1608,6288382,278,1268487,25630,1755,1886,7556869,2010
MA,judicial and legal,9061,45946422,486,1524569,40824,9307,9547,47470991,2010
MA,police protection - officers,5550,31210841,79,195150,6440,5588,5629,31405991,2010
MA,police protection - other,676,2688739,6,16321,372,678,682,2705060,2010
MA,corrections,6162,30615079,49,149624,2894,6179,6211,30764703,2010
MA,highways,3460,17786974,124,458980,15819,3550,3584,18245954,2010
MA,air transportation,1002,6766901,0,0,0,1002,1002,6766901,2010
MA,water transport and terminals,160,1074334,0,0,0,160,160,1074334,2010
MA,public welfare,6809,33092888,520,1608017,32371,7004,7329,34700905,2010
MA,health,6713,27626936,885,2600571,85877,7231,7598,30227507,2010
MA,hospitals,6101,25368372,823,2373867,77920,6545,6924,27742239,2010
MA,social insurance administration,1569,7202479,44,187725,3077,1588,1613,7390204,2010
MA,solid waste management,0,0,0,0,0,0,0,0,2010
MA,sewerage,823,5215249,36,190890,2746,839,859,5406139,2010
MA,parks and recreation,557,2683287,75,94249,4650,584,632,2777536,2010
MA,housing and community development,0,0,0,0,0,0,0,0,2010
MA,natural resources,1178,6410592,152,392414,13336,1259,1330,6803006,2010
MA,water transport and terminals,479,2875122,15,86272,1418,488,494,2961394,2010
MA,electric power,0,0,0,0,0,0,0,0,2010
MA,gas supply,0,0,0,0,0,0,0,0,2010
MA,transit,0,0,0,0,0,0,0,0,2010
MA,education - elementary and secondary instructional,62,322870,8,10654,420,65,70,333524,2010
MA,education - elementary and secondary other,31,142030,16,8582,506,34,47,150612,2010
MA,education - higher education instructional,6264,39401213,11721,20335562,675085,10320,17985,59736775,2010
MA,education - higher education other,15915,72223817,16150,13977501,831694,20886,32065,86201318,2010
MA,education - other,1053,5777910,98,306297,5260,1085,1151,6084207,2010
MA,libraries,0,0,0,0,0,0,0,0,2010
MA,liquor stores,0,0,0,0,0,0,0,0,2010
MA,other and unallocable,5157,28838086,357,1229148,25208,5306,5514,30067234,2010
MI,total,119258,621119387,67632,83632045,4661430,145606,186890,704751432,2010
MI,financial administration,3863,20414247,313,1032043,42838,4105,4176,21446290,2010
MI,other government administration,1655,7769873,10,29372,654,1659,1665,7799245,2010
MI,judicial and legal,1405,9719994,44,140527,4778,1432,1449,9860521,2010
MI,police protection - officers,1744,8796658,0,0,0,1744,1744,8796658,2010
MI,police protection - other,845,2770126,47,70000,3050,862,892,2840126,2010
MI,corrections,15000,81706838,176,773055,23507,15133,15176,82479893,2010
MI,highways,2713,13182539,309,773760,35858,2916,3022,13956299,2010
MI,air transportation,0,0,0,0,0,0,0,0,2010
MI,water transport and terminals,0,0,0,0,0,0,0,0,2010
MI,public welfare,9994,45116427,827,3288899,141703,10795,10821,48405326,2010
MI,health,1732,9050489,190,436596,17366,1830,1922,9487085,2010
MI,hospitals,13716,65116961,6131,21693305,892014,18756,19847,86810266,2010
MI,social insurance administration,1039,5083174,44,102862,5103,1068,1083,5186036,2010
MI,solid waste management,0,0,0,0,0,0,0,0,2010
MI,sewerage,0,0,0,0,0,0,0,0,2010
MI,parks and recreation,219,1030031,108,352785,12496,290,327,1382816,2010
MI,housing and community development,0,0,0,0,0,0,0,0,2010
MI,natural resources,3431,16397727,1075,1620772,93497,3959,4506,18018499,2010
MI,water transport and terminals,0,0,0,0,0,0,0,0,2010
MI,electric power,0,0,0,0,0,0,0,0,2010
MI,gas supply,0,0,0,0,0,0,0,0,2010
MI,transit,0,0,0,0,0,0,0,0,2010
MI,education - elementary and secondary instructional,0,0,0,0,0,0,0,0,2010
MI,education - elementary and secondary other,0,0,0,0,0,0,0,0,2010
MI,education - higher education instructional,18376,140793743,10072,16597385,667207,22157,28448,157391128,2010
MI,education - higher education other,37206,163349131,47640,35199260,2643919,52142,84846,198548391,2010
MI,education - other,442,2349927,135,500652,20003,555,577,2850579,2010
MI,libraries,0,0,0,0,0,0,0,0,2010
MI,liquor stores,0,0,0,0,0,0,0,0,2010
MI,other and unallocable,5878,28471502,511,1020772,57437,6203,6389,29492274,2010
MN,total,66665,355864431,31772,48293400,2347935,79941,98437,404157831,2010
MN,financial administration,2776,13812893,101,250689,15238,2864,2877,14063582,2010
MN,other government administration,939,4320483,179,407094,20097,1054,1118,4727577,2010
MN,judicial and legal,3005,16113697,445,1628007,62752,3359,3450,17741704,2010
MN,police protection - officers,549,3101659,0,0,0,549,549,3101659,2010
MN,police protection - other,426,1612864,44,96829,4508,451,470,1709693,2010
MN,corrections,4103,17732956,132,371567,17949,4204,4235,18104523,2010
MN,highways,4664,21960385,184,387846,17440,4763,4848,22348231,2010
MN,air transportation,0,0,0,0,0,0,0,0,2010
MN,water transport and terminals,0,0,0,0,0,0,0,0,2010
MN,public welfare,1682,7985123,1323,3106632,221911,2936,3005,11091755,2010
MN,health,2349,12022660,254,710732,28297,2509,2603,12733392,2010
MN,hospitals,3552,17521977,1362,3777757,236110,4886,4914,21299734,2010
MN,social insurance administration,1252,5524566,116,295906,13140,1327,1368,5820472,2010
MN,solid waste management,0,0,0,0,0,0,0,0,2010
MN,sewerage,639,3710272,13,32991,1065,645,652,3743263,2010
MN,parks and recreation,528,2448624,156,200640,11338,593,684,2649264,2010
MN,housing and community development,0,0,0,0,0,0,0,0,2010
MN,natural resources,2696,13181269,615,1177348,70711,3096,3311,14358617,2010
MN,water transport and terminals,0,0,0,0,0,0,0,0,2010
MN,electric power,0,0,0,0,0,0,0,0,2010
MN,gas supply,0,0,0,0,0,0,0,0,2010
MN,transit,2272,10035698,362,827826,37628,2485,2634,10863524,2010
MN,education - elementary and secondary instructional,0,0,0,0,0,0,0,0,2010
MN,education - elementary and secondary other,0,0,0,0,0,0,0,0,2010
MN,education - higher education instructional,11203,72152928,11108,17845362,634939,14791,22311,89998290,2010
MN,education - higher education other,17295,96163806,13942,14473141,839079,22039,31237,110636947,2010
MN,education - other,3415,19743655,1250,2291749,96755,3962,4665,22035404,2010
MN,libraries,0,0,0,0,0,0,0,0,2010
MN,liquor stores,0,0,0,0,0,0,0,0,2010
MN,other and unallocable,3320,16718916,186,411284,18978,3428,3506,17130200,2010
MS,total,51483,182080950,12743,13873696,950735,56858,64226,195954646,2010
MS,financial administration,1309,4737010,43,69416,4703,1336,1352,4806426,2010
MS,other government administration,479,1832482,83,90029,4787,507,562,1922511,2010
MS,judicial and legal,720,4202302,7,10263,245,721,727,4212565,2010
MS,police protection - officers,710,2737712,0,0,0,710,710,2737712,2010
MS,police protection - other,485,1155566,0,0,0,485,485,1155566,2010
MS,corrections,3328,8873760,16,33546,2177,3340,3344,8907306,2010
MS,highways,3402,9793718,15,38566,2469,3416,3417,9832284,2010
MS,air transportation,0,0,0,0,0,0,0,0,2010
MS,water transport and terminals,44,206105,0,0,0,44,44,206105,2010
MS,public welfare,2991,9669218,0,0,0,2991,2991,9669218,2010
MS,health,3053,10255363,72,215128,8665,3101,3125,10470491,2010
MS,hospitals,11433,33837603,410,869949,40322,11661,11843,34707552,2010
MS,social insurance administration,764,2491084,393,945069,66259,1138,1157,3436153,2010
MS,solid waste management,0,0,0,0,0,0,0,0,2010
MS,sewerage,0,0,0,0,0,0,0,0,2010
MS,parks and recreation,351,852979,73,57122,6544,389,424,910101,2010
MS,housing and community development,0,0,0,0,0,0,0,0,2010
MS,natural resources,2879,8786712,671,634354,47961,3150,3550,9421066,2010
MS,water transport and terminals,45,121435,7,9608,818,50,52,131043,2010
MS,electric power,0,0,0,0,0,0,0,0,2010
MS,gas supply,0,0,0,0,0,0,0,0,2010
MS,transit,0,0,0,0,0,0,0,0,2010
MS,education - elementary and secondary instructional,0,0,0,0,0,0,0,0,2010
MS,education - elementary and secondary other,0,0,0,0,0,0,0,0,2010
MS,education - higher education instructional,5772,32559481,1456,2370845,108350,6385,7228,34930326,2010
MS,education - higher education other,9126,35043293,8930,7701720,583362,12422,18056,42745013,2010
MS,education - other,1586,5038265,30,47829,2725,1602,1616,5086094,2010
MS,libraries,0,0,0,0,0,0,0,0,2010
MS,liquor stores,109,290788,0,0,0,109,109,290788,2010
MS,other and unallocable,2897,9596074,537,780252,71348,3301,3434,10376326,2010
MO,total,79202,278652161,25061,23806653,1700374,88818,104263,302458814,2010
MO,financial administration,3018,10637012,160,214752,17473,3115,3178,10851764,2010
MO,other government administration,748,2575030,293,676236,31752,930,1041,3251266,2010
MO,judicial and legal,3853,14410256,375,344924,29858,4021,4228,14755180,2010
MO,police protection - officers,1222,6066590,0,0,0,1222,1222,6066590,2010
MO,police protection - other,1146,3566080,132,140348,11880,1213,1278,3706428,2010
MO,corrections,12414,32346516,164,141394,10844,12475,12578,32487910,2010
MO,highways,6016,21226998,348,293428,18100,6118,6364,21520426,2010
MO,air transportation,0,0,0,0,0,0,0,0,2010
MO,water transport and terminals,0,0,0,0,0,0,0,0,2010
MO,public welfare,7481,19378596,376,343956,21810,7604,7857,19722552,2010
MO,health,2991,8985819,178,301354,19025,3099,3169,9287173,2010
MO,hospitals,10491,32076109,1148,1755811,101968,11067,11639,33831920,2010
MO,social insurance administration,560,1635479,96,133082,10328,618,656,1768561,2010
MO,solid waste management,0,0,0,0,0,0,0,0,2010
MO,sewerage,0,0,0,0,0,0,0,0,2010
MO,parks and recreation,479,1417042,186,86594,8520,527,665,1503636,2010
MO,housing and community development,0,0,0,0,0,0,0,0,2010
MO,natural resources,2208,7425795,511,518099,51655,2500,2719,7943894,2010
MO,water transport and terminals,0,0,0,0,0,0,0,0,2010
MO,electric power,0,0,0,0,0,0,0,0,2010
MO,gas supply,0,0,0,0,0,0,0,0,2010
MO,transit,0,0,0,0,0,0,0,0,2010
MO,education - elementary and secondary instructional,0,0,0,0,0,0,0,0,2010
MO,education - elementary and secondary other,0,0,0,0,0,0,0,0,2010
MO,education - higher education instructional,8047,49296097,7357,9315378,478307,10750,15404,58611475,2010
MO,education - higher education other,13455,50541609,12460,7324025,754226,17725,25915,57865634,2010
MO,education - other,1083,3664528,1038,1934372,116840,1743,2121,5598900,2010
MO,libraries,0,0,0,0,0,0,0,0,2010
MO,liquor stores,0,0,0,0,0,0,0,0,2010
MO,other and unallocable,3990,13402605,239,282900,17788,4091,4229,13685505,2010
MT,total,17112,68714247,9107,9259408,577573,20375,26219,77973655,2010
MT,financial administration,946,3509676,69,112413,7186,987,1015,3622089,2010
MT,other government administration,369,1715069,99,117199,7267,409,468,1832268,2010
MT,judicial and legal,640,2819532,76,145039,7380,682,716,2964571,2010
MT,police protection - officers,231,465755,0,0,0,231,231,465755,2010
MT,police protection - other,249,863053,16,26869,1548,258,265,889922,2010
MT,corrections,1323,5306894,29,62191,2546,1337,1352,5369085,2010
MT,highways,2031,8797499,161,229503,12753,2103,2192,9027002,2010
MT,air transportation,0,0,0,0,0,0,0,0,2010
MT,water transport and terminals,0,0,0,0,0,0,0,0,2010
MT,public welfare,1537,5395567,238,303359,18945,1644,1775,5698926,2010
MT,health,855,3338972,153,286907,14050,935,1008,3625879,2010
MT,hospitals,508,1751810,210,265016,18097,610,718,2016826,2010
MT,social insurance administration,746,2999124,43,106403,5821,779,789,3105527,2010
MT,solid waste management,0,0,0,0,0,0,0,0,2010
MT,sewerage,0,0,0,0,0,0,0,0,2010
MT,parks and recreation,81,288227,32,32238,2026,92,113,320465,2010
MT,housing and community development,0,0,0,0,0,0,0,0,2010
MT,natural resources,1349,5358168,308,488011,29686,1517,1657,5846179,2010
MT,water transport and terminals,0,0,0,0,0,0,0,0,2010
MT,electric power,0,0,0,0,0,0,0,0,2010
MT,gas supply,0,0,0,0,0,0,0,0,2010
MT,transit,0,0,0,0,0,0,0,0,2010
MT,education - elementary and secondary instructional,0,0,0,0,0,0,0,0,2010
MT,education - elementary and secondary other,0,0,0,0,0,0,0,0,2010
MT,education - higher education instructional,1341,7941366,1886,2972242,132259,2089,3227,10913608,2010
MT,education - higher education other,3456,12080957,5523,3672918,293305,5112,8979,15753875,2010
MT,education - other,316,1305708,139,204828,12289,385,455,1510536,2010
MT,libraries,0,0,0,0,0,0,0,0,2010
MT,liquor stores,26,95616,2,2865,224,27,28,98481,2010
MT,other and unallocable,1108,4681254,123,231407,12191,1178,1231,4912661,2010
NE,total,27084,108674826,10633,11904360,969448,32560,37717,120579186,2010
NE,financial administration,737,2636767,12,23230,1270,744,749,2659997,2010
NE,other government administration,280,1264416,103,100945,6180,315,383,1365361,2010
NE,judicial and legal,730,3525616,64,63726,4215,753,794,3589342,2010
NE,police protection - officers,476,2462207,0,0,0,476,476,2462207,2010
NE,police protection - other,290,954993,17,22501,2074,301,307,977494,2010
NE,corrections,2862,9243145,112,113568,7700,2906,2974,9356713,2010
NE,highways,2137,7917605,8,18841,801,2142,2145,7936446,2010
NE,air transportation,26,111293,0,0,0,26,26,111293,2010
NE,water transport and terminals,0,0,0,0,0,0,0,0,2010
NE,public welfare,2381,7049019,261,379426,23768,2516,2642,7428445,2010
NE,health,639,2792437,19,32865,2095,650,658,2825302,2010
NE,hospitals,3288,12341643,792,1823883,117081,3949,4080,14165526,2010
NE,social insurance administration,283,1064091,5,5734,395,285,288,1069825,2010
NE,solid waste management,0,0,0,0,0,0,0,0,2010
NE,sewerage,0,0,0,0,0,0,0,0,2010
NE,parks and recreation,208,696227,161,128773,13541,285,369,825000,2010
NE,housing and community development,0,0,0,0,0,0,0,0,2010
NE,natural resources,1519,5646316,751,1574713,110738,2143,2270,7221029,2010
NE,water transport and terminals,0,0,0,0,0,0,0,0,2010
NE,electric power,0,0,0,0,0,0,0,0,2010
NE,gas supply,0,0,0,0,0,0,0,0,2010
NE,transit,0,0,0,0,0,0,0,0,2010
NE,education - elementary and secondary instructional,0,0,0,0,0,0,0,0,2010
NE,education - elementary and secondary other,0,0,0,0,0,0,0,0,2010
NE,education - higher education instructional,2771,18927687,1130,2219677,102923,3353,3901,21147364,2010
NE,education - higher education other,5987,22573078,6994,5210122,565239,9180,12981,27783200,2010
NE,education - other,624,2346130,33,41556,2430,638,657,2387686,2010
NE,libraries,0,0,0,0,0,0,0,0,2010
NE,liquor stores,0,0,0,0,0,0,0,0,2010
NE,other and unallocable,1846,7122156,171,144800,8998,1898,2017,7266956,2010
NV,total,25344,123949243,9761,11826961,531415,28345,35105,135776204,2010
NV,financial administration,1405,5542012,20,33416,963,1411,1425,5575428,2010
NV,other government administration,892,4565119,116,166903,7286,933,1008,4732022,2010
NV,judicial and legal,731,4723914,17,33955,574,734,748,4757869,2010
NV,police protection - officers,449,2633150,0,0,0,449,449,2633150,2010
NV,police protection - other,392,1751197,0,0,0,392,392,1751197,2010
NV,corrections,3657,16630009,50,134635,2214,3670,3707,16764644,2010
NV,highways,1805,8127195,3,4749,361,1807,1808,8131944,2010
NV,air transportation,0,0,0,0,0,0,0,0,2010
NV,water transport and terminals,0,0,0,0,0,0,0,0,2010
NV,public welfare,1677,6184140,14,21680,774,1682,1691,6205820,2010
NV,health,1485,6604603,36,90097,2776,1501,1521,6694700,2010
NV,hospitals,1406,6684841,79,238120,4889,1434,1485,6922961,2010
NV,social insurance administration,717,2695510,2,1703,84,717,719,2697213,2010
NV,solid waste management,0,0,0,0,0,0,0,0,2010
NV,sewerage,0,0,0,0,0,0,0,0,2010
NV,parks and recreation,130,504476,55,79787,4000,153,185,584263,2010
NV,housing and community development,0,0,0,0,0,0,0,0,2010
NV,natural resources,926,4333742,119,181864,9404,979,1045,4515606,2010
NV,water transport and terminals,18,108563,0,0,0,18,18,108563,2010
NV,electric power,18,108563,0,0,0,18,18,108563,2010
NV,gas supply,0,0,0,0,0,0,0,0,2010
NV,transit,0,0,0,0,0,0,0,0,2010
NV,education - elementary and secondary instructional,0,0,0,0,0,0,0,0,2010
NV,education - elementary and secondary other,0,0,0,0,0,0,0,0,2010
NV,education - higher education instructional,2087,17543423,3268,3658044,118915,2758,5355,21201467,2010
NV,education - higher education other,5249,24279550,5918,7074837,375498,7370,11167,31354387,2010
NV,education - other,133,665175,2,3905,89,134,135,669080,2010
NV,libraries,0,0,0,0,0,0,0,0,2010
NV,liquor stores,0,0,0,0,0,0,0,0,2010
NV,other and unallocable,2167,10264061,62,103266,3588,2185,2229,10367327,2010
NH,total,15712,72018984,10399,12207424,619612,19470,26111,84226408,2010
NH,financial administration,777,3525606,38,49364,3280,797,815,3574970,2010
NH,other government administration,333,1478416,105,134597,8946,386,438,1613013,2010
NH,judicial and legal,956,4064835,7,13800,769,961,963,4078635,2010
NH,police protection - officers,329,1913078,0,0,0,329,329,1913078,2010
NH,police protection - other,164,637692,18,29592,1982,176,182,667284,2010
NH,corrections,1152,4887325,43,74393,4262,1178,1195,4961718,2010
NH,highways,1674,6522575,271,342738,35209,1886,1945,6865313,2010
NH,air transportation,27,108468,20,37676,2524,41,47,146144,2010
NH,water transport and terminals,8,41074,7,6589,534,11,15,47663,2010
NH,public welfare,1454,5630952,99,179425,7745,1500,1553,5810377,2010
NH,health,865,3983733,58,82328,5338,896,923,4066061,2010
NH,hospitals,717,2871153,73,133117,1944,729,790,3004270,2010
NH,social insurance administration,355,1380646,93,158381,7618,401,448,1539027,2010
NH,solid waste management,0,0,0,0,0,0,0,0,2010
NH,sewerage,0,0,0,0,0,0,0,0,2010
NH,parks and recreation,77,295255,237,167006,18828,190,314,462261,2010
NH,housing and community development,0,0,0,0,0,0,0,0,2010
NH,natural resources,356,1674959,79,73006,5335,388,435,1747965,2010
NH,water transport and terminals,26,137338,3,7718,263,28,29,145056,2010
NH,electric power,0,0,0,0,0,0,0,0,2010
NH,gas supply,0,0,0,0,0,0,0,0,2010
NH,transit,0,0,0,0,0,0,0,0,2010
NH,education - elementary and secondary instructional,0,0,0,0,0,0,0,0,2010
NH,education - elementary and secondary other,0,0,0,0,0,0,0,0,2010
NH,education - higher education instructional,1471,10794324,2685,5307126,152423,2403,4156,16101450,2010
NH,education - higher education other,2634,12101083,5702,4571487,295701,4430,8336,16672570,2010
NH,education - other,312,1331378,22,35523,2057,324,334,1366901,2010
NH,libraries,0,0,0,0,0,0,0,0,2010
NH,liquor stores,300,1181643,482,416794,39675,539,782,1598437,2010
NH,other and unallocable,1725,7457451,357,386764,25179,1877,2082,7844215,2010
NJ,total,137558,793355353,39435,51147705,2290284,152003,176993,844503058,2010
NJ,financial administration,5512,26155147,454,784201,49078,5829,5966,26939348,2010
NJ,other government administration,948,5460016,19,28515,1756,959,967,5488531,2010
NJ,judicial and legal,13513,77740952,175,277982,13533,13601,13688,78018934,2010
NJ,police protection - officers,2992,24091597,0,0,0,2992,2992,24091597,2010
NJ,police protection - other,1341,5986005,21,79237,1900,1353,1362,6065242,2010
NJ,corrections,9475,54804915,14,32043,1078,9482,9489,54836958,2010
NJ,highways,6075,34433343,550,661687,35633,6277,6625,35095030,2010
NJ,air transportation,0,0,0,0,0,0,0,0,2010
NJ,water transport and terminals,80,463769,2,5784,350,82,82,469553,2010
NJ,public welfare,8880,43805963,208,385606,17439,8992,9088,44191569,2010
NJ,health,4269,23975780,688,2007679,31924,4475,4957,25983459,2010
NJ,hospitals,16643,72549784,2474,4832312,285708,18486,19117,77382096,2010
NJ,social insurance administration,1704,7782597,301,766799,40501,1965,2005,8549396,2010
NJ,solid waste management,559,3634436,1,979,124,560,560,3635415,2010
NJ,sewerage,0,0,0,0,0,0,0,0,2010
NJ,parks and recreation,1441,6774622,2336,1303075,99424,2008,3777,8077697,2010
NJ,housing and community development,0,0,0,0,0,0,0,0,2010
NJ,natural resources,1887,10672691,310,458889,21842,2022,2197,11131580,2010
NJ,water transport and terminals,120,603218,0,0,0,120,120,603218,2010
NJ,electric power,0,0,0,0,0,0,0,0,2010
NJ,gas supply,0,0,0,0,0,0,0,0,2010
NJ,transit,10014,59858350,827,1648277,84161,10489,10841,61506627,2010
NJ,education - elementary and secondary instructional,11506,84238619,1781,2640415,137514,12438,13287,86879034,2010
NJ,education - elementary and secondary other,5015,19527479,2691,3400871,202748,6382,7706,22928350,2010
NJ,education - higher education instructional,7549,80302921,8376,16809793,364290,9835,15925,97112714,2010
NJ,education - higher education other,18789,98258541,17450,13973543,838073,24003,36239,112232084,2010
NJ,education - other,2612,14507693,500,606612,46743,2914,3112,15114305,2010
NJ,libraries,0,0,0,0,0,0,0,0,2010
NJ,liquor stores,0,0,0,0,0,0,0,0,2010
NJ,other and unallocable,6634,37726915,257,443406,16465,6739,6891,38170321,2010
NM,total,42398,168649318,14132,15495628,1012603,48160,56530,184144946,2010
NM,financial administration,1221,5138970,5,6315,443,1224,1226,5145285,2010
NM,other government administration,196,997762,16,37934,1454,204,212,1035696,2010
NM,judicial and legal,3173,13552417,141,225374,12679,3245,3314,13777791,2010
NM,police protection - officers,575,3014782,0,0,0,575,575,3014782,2010
NM,police protection - other,159,1375507,0,0,0,159,159,1375507,2010
NM,corrections,4009,13688894,34,80047,4246,4033,4043,13768941,2010
NM,highways,2276,8281706,0,0,0,2276,2276,8281706,2010
NM,air transportation,5,21562,0,0,0,5,5,21562,2010
NM,water transport and terminals,0,0,0,0,0,0,0,0,2010
NM,public welfare,1820,6245612,6,7353,480,1823,1826,6252965,2010
NM,health,2531,10073399,74,220588,11863,2598,2605,10293987,2010
NM,hospitals,6821,27715864,976,2332649,125201,7567,7797,30048513,2010
NM,social insurance administration,681,2371061,5,11010,589,684,686,2382071,2010
NM,solid waste management,0,0,0,0,0,0,0,0,2010
NM,sewerage,0,0,0,0,0,0,0,0,2010
NM,parks and recreation,713,2384345,23,45662,2790,729,736,2430007,2010
NM,housing and community development,0,0,0,0,0,0,0,0,2010
NM,natural resources,1081,4616809,33,58015,3103,1099,1114,4674824,2010
NM,water transport and terminals,0,0,0,0,0,0,0,0,2010
NM,electric power,0,0,0,0,0,0,0,0,2010
NM,gas supply,0,0,0,0,0,0,0,0,2010
NM,transit,0,0,0,0,0,0,0,0,2010
NM,education - elementary and secondary instructional,0,0,0,0,0,0,0,0,2010
NM,education - elementary and secondary other,0,0,0,0,0,0,0,0,2010
NM,education - higher education instructional,3452,15923960,3844,5360605,205052,4610,7296,21284565,2010
NM,education - higher education other,10846,41773973,8917,7049117,640245,14463,19763,48823090,2010
NM,education - other,1015,4103019,50,47686,3783,1037,1065,4150705,2010
NM,libraries,0,0,0,0,0,0,0,0,2010
NM,liquor stores,0,0,0,0,0,0,0,0,2010
NM,other and unallocable,1824,7369676,8,13273,675,1829,1832,7382949,2010
NY,total,233660,1281447971,54048,78668491,2997045,251150,287708,1360116462,2010
NY,financial administration,12622,62113691,153,337770,11634,12689,12775,62451461,2010
NY,other government administration,4479,19286824,535,669184,39934,4706,5014,19956008,2010
NY,judicial and legal,21177,134418918,714,2523779,85144,21661,21891,136942697,2010
NY,police protection - officers,4790,41640994,0,0,0,4790,4790,41640994,2010
NY,police protection - other,1590,6982212,151,213725,19344,1699,1741,7195937,2010
NY,corrections,31585,165504328,451,1360366,45113,31840,32036,166864694,2010
NY,highways,11716,58032751,959,1050427,72961,12130,12675,59083178,2010
NY,air transportation,185,760956,0,0,0,185,185,760956,2010
NY,water transport and terminals,699,4005983,24,48292,1995,711,723,4054275,2010
NY,public welfare,4598,22075672,427,1058326,52213,4892,5025,23133998,2010
NY,health,9314,52694208,409,1394297,43276,9563,9723,54088505,2010
NY,hospitals,41026,201364312,4896,15274021,513706,43935,45922,216638333,2010
NY,social insurance administration,8541,43525416,84,268216,11046,8603,8625,43793632,2010
NY,solid waste management,0,0,0,0,0,0,0,0,2010
NY,sewerage,0,0,0,0,0,0,0,0,2010
NY,parks and recreation,1860,8845313,981,1627527,86616,2349,2841,10472840,2010
NY,housing and community development,0,0,0,0,0,0,0,0,2010
NY,natural resources,3320,17458061,73,126295,4724,3346,3393,17584356,2010
NY,water transport and terminals,0,0,0,0,0,0,0,0,2010
NY,electric power,1675,13116271,51,148351,5134,1704,1726,13264622,2010
NY,gas supply,0,0,0,0,0,0,0,0,2010
NY,transit,16040,110123717,262,480779,31023,16214,16302,110604496,2010
NY,education - elementary and secondary instructional,0,0,0,0,0,0,0,0,2010
NY,education - elementary and secondary other,0,0,0,0,0,0,0,0,2010
NY,education - higher education instructional,14882,107467180,20173,27543129,752597,19339,35055,135010309,2010
NY,education - higher education other,26772,118172396,23044,22474926,1161610,33658,49816,140647322,2010
NY,education - other,4283,21566151,155,344360,14185,4363,4438,21910511,2010
NY,libraries,0,0,0,0,0,0,0,0,2010
NY,liquor stores,0,0,0,0,0,0,0,0,2010
NY,other and unallocable,12506,72292617,506,1724721,44790,12773,13012,74017338,2010
NC,total,132097,513334278,41925,43607856,2533459,146409,174022,556942134,2010
NC,financial administration,3741,15788905,21,43098,1520,3750,3762,15832003,2010
NC,other government administration,748,4049500,417,817382,39562,972,1165,4866882,2010
NC,judicial and legal,7037,31739468,189,387475,7669,7080,7226,32126943,2010
NC,police protection - officers,2468,14437060,8,17162,1000,2474,2476,14454222,2010
NC,police protection - other,988,3831201,14,32641,1370,996,1002,3863842,2010
NC,corrections,21169,64806799,49,79362,946,21175,21218,64886161,2010
NC,highways,10900,36303776,50,44248,1938,10911,10950,36348024,2010
NC,air transportation,0,0,0,0,0,0,0,0,2010
NC,water transport and terminals,250,1025717,0,0,0,250,250,1025717,2010
NC,public welfare,1197,4243592,36,68639,2500,1211,1233,4312231,2010
NC,health,2634,10296396,161,332693,15544,2722,2795,10629089,2010
NC,hospitals,18937,73998351,1741,4407185,94281,19469,20678,78405536,2010
NC,social insurance administration,2480,9307586,22,44363,1158,2487,2502,9351949,2010
NC,solid waste management,382,1683361,0,0,0,382,382,1683361,2010
NC,sewerage,0,0,0,0,0,0,0,0,2010
NC,parks and recreation,1850,5313879,272,299054,30166,2020,2122,5612933,2010
NC,housing and community development,0,0,0,0,0,0,0,0,2010
NC,natural resources,4413,15946420,272,347410,34171,4605,4685,16293830,2010
NC,water transport and terminals,0,0,0,0,0,0,0,0,2010
NC,electric power,0,0,0,0,0,0,0,0,2010
NC,gas supply,0,0,0,0,0,0,0,0,2010
NC,transit,0,0,0,0,0,0,0,0,2010
NC,education - elementary and secondary instructional,0,0,0,0,0,0,0,0,2010
NC,education - elementary and secondary other,0,0,0,0,0,0,0,0,2010
NC,education - higher education instructional,14441,90049400,13502,16141659,547318,17533,27943,106191059,2010
NC,education - higher education other,31874,103512763,24838,19971460,1719744,41589,56712,123484223,2010
NC,education - other,2249,8994070,61,124138,1466,2258,2310,9118208,2010
NC,libraries,0,0,0,0,0,0,0,0,2010
NC,liquor stores,0,0,0,0,0,0,0,0,2010
NC,other and unallocable,4339,18006034,272,449887,33106,4525,4611,18455921,2010
ND,total,15537,63754669,9121,7230277,461268,18139,24658,70984946,2010
ND,financial administration,640,2349450,38,42342,2441,654,678,2391792,2010
ND,other government administration,204,777346,152,118773,3787,225,356,896119,2010
ND,judicial and legal,555,2568574,53,29621,1464,563,608,2598195,2010
ND,police protection - officers,138,712760,3,2720,187,139,141,715480,2010
ND,police protection - other,51,153163,0,0,0,51,51,153163,2010
ND,corrections,724,2453248,74,149192,5715,756,798,2602440,2010
ND,highways,1009,4107279,8,10716,525,1012,1017,4117995,2010
ND,air transportation,0,0,0,0,0,0,0,0,2010
ND,water transport and terminals,0,0,0,0,0,0,0,0,2010
ND,public welfare,505,1550054,58,66380,4604,531,563,1616434,2010
ND,health,1248,4378363,273,270046,21271,1368,1521,4648409,2010
ND,hospitals,877,2472979,146,198756,7751,921,1023,2671735,2010
ND,social insurance administration,353,1274813,123,123515,6687,391,476,1398328,2010
ND,solid waste management,0,0,0,0,0,0,0,0,2010
ND,sewerage,0,0,0,0,0,0,0,0,2010
ND,parks and recreation,168,466749,17,21397,1443,177,185,488146,2010
ND,housing and community development,0,0,0,0,0,0,0,0,2010
ND,natural resources,609,2423963,597,360621,32598,793,1206,2784584,2010
ND,water transport and terminals,0,0,0,0,0,0,0,0,2010
ND,electric power,0,0,0,0,0,0,0,0,2010
ND,gas supply,0,0,0,0,0,0,0,0,2010
ND,transit,0,0,0,0,0,0,0,0,2010
ND,education - elementary and secondary instructional,0,0,0,0,0,0,0,0,2010
ND,education - elementary and secondary other,0,0,0,0,0,0,0,0,2010
ND,education - higher education instructional,2093,13879154,2540,3268096,133584,2846,4633,17147250,2010
ND,education - higher education other,4712,17394966,4857,2374050,228584,6003,9569,19769016,2010
ND,education - other,269,959935,32,59560,2719,284,301,1019495,2010
ND,libraries,0,0,0,0,0,0,0,0,2010
ND,liquor stores,0,0,0,0,0,0,0,0,2010
ND,other and unallocable,1382,5831873,150,134492,7908,1425,1532,5966365,2010
OH,total,115342,576137366,72336,75764331,4343104,139907,187678,651901697,2010
OH,financial administration,7057,36283083,387,677793,37078,7266,7444,36960876,2010
OH,other government administration,904,4245735,122,87719,7273,946,1026,4333454,2010
OH,judicial and legal,2698,15816028,577,1373337,39444,2921,3275,17189365,2010
OH,police protection - officers,1404,7936211,0,0,0,1404,1404,7936211,2010
OH,police protection - other,1149,4660948,10,27513,1457,1157,1159,4688461,2010
OH,corrections,15426,66531316,71,159780,7786,15470,15497,66691096,2010
OH,highways,6734,30422117,304,538046,30341,6905,7038,30960163,2010
OH,air transportation,0,0,0,0,0,0,0,0,2010
OH,water transport and terminals,0,0,0,0,0,0,0,0,2010
OH,public welfare,2493,14206981,302,557602,43952,2741,2795,14764583,2010
OH,health,3355,18265921,223,492584,21464,3476,3578,18758505,2010
OH,hospitals,13948,66176202,2912,5750353,214445,15159,16860,71926555,2010
OH,social insurance administration,1912,8684457,360,964160,49169,2190,2272,9648617,2010
OH,solid waste management,0,0,0,0,0,0,0,0,2010
OH,sewerage,0,0,0,0,0,0,0,0,2010
OH,parks and recreation,426,1815531,835,410341,27894,584,1261,2225872,2010
OH,housing and community development,0,0,0,0,0,0,0,0,2010
OH,natural resources,2654,11198066,303,303197,21244,2775,2957,11501263,2010
OH,water transport and terminals,0,0,0,0,0,0,0,0,2010
OH,electric power,0,0,0,0,0,0,0,0,2010
OH,gas supply,0,0,0,0,0,0,0,0,2010
OH,transit,0,0,0,0,0,0,0,0,2010
OH,education - elementary and secondary instructional,0,0,0,0,0,0,0,0,2010
OH,education - elementary and secondary other,0,0,0,0,0,0,0,0,2010
OH,education - higher education instructional,15858,117146111,19979,27173685,1057722,21852,35837,144319796,2010
OH,education - higher education other,32331,136676245,45115,36240624,2737318,47805,77446,172916869,2010
OH,education - other,2222,11056543,291,497144,20324,2336,2513,11553687,2010
OH,libraries,0,0,0,0,0,0,0,0,2010
OH,liquor stores,0,0,0,0,0,0,0,0,2010
OH,other and unallocable,4771,25015871,545,510453,26193,4920,5316,25526324,2010
OK,total,61922,239274416,26828,26199155,1516141,70501,88750,265473571,2010
OK,financial administration,1585,5979196,27,31435,1655,1594,1612,6010631,2010
OK,other government administration,743,2816571,120,191928,13343,820,863,3008499,2010
OK,judicial and legal,2862,12637581,121,168055,8875,2911,2983,12805636,2010
OK,police protection - officers,1029,5159215,3,1508,48,1029,1032,5160723,2010
OK,police protection - other,916,3146215,67,74350,5554,947,983,3220565,2010
OK,corrections,5328,16913818,49,107663,4069,5351,5377,17021481,2010
OK,highways,3002,10114302,0,0,0,3002,3002,10114302,2010
OK,air transportation,11,51124,1,1520,152,12,12,52644,2010
OK,water transport and terminals,0,0,0,0,0,0,0,0,2010
OK,public welfare,6865,20390453,30,53626,3075,6882,6895,20444079,2010
OK,health,5552,20094690,345,699809,32159,5734,5897,20794499,2010
OK,hospitals,2558,7879210,77,137420,9387,2612,2635,8016630,2010
OK,social insurance administration,1397,4829118,103,161844,10364,1455,1500,4990962,2010
OK,solid waste management,92,355518,16,16060,1271,99,108,371578,2010
OK,sewerage,0,0,0,0,0,0,0,0,2010
OK,parks and recreation,653,1696727,250,237537,23514,785,903,1934264,2010
OK,housing and community development,0,0,0,0,0,0,0,0,2010
OK,natural resources,1715,5982771,821,694851,42272,1954,2536,6677622,2010
OK,water transport and terminals,0,0,0,0,0,0,0,0,2010
OK,electric power,542,2947552,7,16144,838,546,549,2963696,2010
OK,gas supply,0,0,0,0,0,0,0,0,2010
OK,transit,0,0,0,0,0,0,0,0,2010
OK,education - elementary and secondary instructional,0,0,0,0,0,0,0,0,2010
OK,education - elementary and secondary other,0,0,0,0,0,0,0,0,2010
OK,education - higher education instructional,6451,42303909,7075,9799471,361651,8498,13526,52103380,2010
OK,education - higher education other,16261,59687376,17569,13608726,985533,21841,33830,73296102,2010
OK,education - other,1949,7282686,62,62590,4093,1973,2011,7345276,2010
OK,libraries,0,0,0,0,0,0,0,0,2010
OK,liquor stores,0,0,0,0,0,0,0,0,2010
OK,other and unallocable,2411,9006384,85,134618,8288,2456,2496,9141002,2010
OR,total,58139,258833632,24918,30799111,1276363,65348,83057,289632743,2010
OR,financial administration,4024,16334483,258,438159,28749,4187,4282,16772642,2010
OR,other government administration,920,4204195,214,448956,18939,1026,1134,4653151,2010
OR,judicial and legal,3046,13536209,225,653628,26463,3195,3271,14189837,2010
OR,police protection - officers,736,4163968,0,0,0,736,736,4163968,2010
OR,police protection - other,631,2575756,143,154557,6636,668,774,2730313,2010
OR,corrections,5398,22108391,140,433166,18618,5503,5538,22541557,2010
OR,highways,3688,15901999,245,1001064,35752,3890,3933,16903063,2010
OR,air transportation,16,62261,0,0,0,16,16,62261,2010
OR,water transport and terminals,0,0,0,0,0,0,0,0,2010
OR,public welfare,8013,27177758,380,643380,26573,8164,8393,27821138,2010
OR,health,1467,5809917,156,313843,12273,1537,1623,6123760,2010
OR,hospitals,4749,18731102,3067,5936670,125102,5455,7816,24667772,2010
OR,social insurance administration,2311,10919983,116,324369,12077,2379,2427,11244352,2010
OR,solid waste management,0,0,0,0,0,0,0,0,2010
OR,sewerage,0,0,0,0,0,0,0,0,2010
OR,parks and recreation,427,1663220,21,24708,2122,439,448,1687928,2010
OR,housing and community development,0,0,0,0,0,0,0,0,2010
OR,natural resources,2406,9499558,305,501940,29908,2574,2711,10001498,2010
OR,water transport and terminals,0,0,0,0,0,0,0,0,2010
OR,electric power,0,0,0,0,0,0,0,0,2010
OR,gas supply,0,0,0,0,0,0,0,0,2010
OR,transit,0,0,0,0,0,0,0,0,2010
OR,education - elementary and secondary instructional,0,0,0,0,0,0,0,0,2010
OR,education - elementary and secondary other,0,0,0,0,0,0,0,0,2010
OR,education - higher education instructional,10050,63523062,3350,6426338,164323,10978,13400,69949400,2010
OR,education - higher education other,7729,32116355,16025,13173271,753710,11988,23754,45289626,2010
OR,education - other,693,2873205,66,75575,4047,716,759,2948780,2010
OR,libraries,0,0,0,0,0,0,0,0,2010
OR,liquor stores,224,882202,15,18914,1070,230,239,901116,2010
OR,other and unallocable,1611,6750008,192,230573,10001,1667,1803,6980581,2010
PA,total,142420,650015551,66553,109998726,4376534,168268,208973,760014277,2010
PA,financial administration,6828,29093819,1426,2944754,145027,7701,8254,32038573,2010
PA,other government administration,3155,12884287,590,2403212,64479,3541,3745,15287499,2010
PA,judicial and legal,3065,22002437,9,30511,1220,3072,3074,22032948,2010
PA,police protection - officers,5069,28471796,7,11783,443,5072,5076,28483579,2010
PA,police protection - other,1335,7511670,374,1002752,36810,1557,1709,8514422,2010
PA,corrections,18283,76461739,1267,4055477,96913,18867,19550,80517216,2010
PA,highways,12499,46748685,3892,8418763,382384,14793,16391,55167448,2010
PA,air transportation,40,181183,42,89625,2415,55,82,270808,2010
PA,water transport and terminals,184,822769,47,3122,272,186,231,825891,2010
PA,public welfare,11271,42483259,1779,3543977,114994,11964,13050,46027236,2010
PA,health,1759,8231693,276,483644,13082,1839,2035,8715337,2010
PA,hospitals,11108,37378759,1818,3284744,99049,11694,12926,40663503,2010
PA,social insurance administration,3766,15092882,1459,3444247,117329,4473,5225,18537129,2010
PA,solid waste management,0,0,0,0,0,0,0,0,2010
PA,sewerage,0,0,0,0,0,0,0,0,2010
PA,parks and recreation,1567,6406288,1894,4402712,171244,2599,3461,10809000,2010
PA,housing and community development,0,0,0,0,0,0,0,0,2010
PA,natural resources,5276,23773935,2840,5267285,233850,6651,8116,29041220,2010
PA,water transport and terminals,0,0,0,0,0,0,0,0,2010
PA,electric power,0,0,0,0,0,0,0,0,2010
PA,gas supply,0,0,0,0,0,0,0,0,2010
PA,transit,0,0,0,0,0,0,0,0,2010
PA,education - elementary and secondary instructional,0,0,0,0,0,0,0,0,2010
PA,education - elementary and secondary other,0,0,0,0,0,0,0,0,2010
PA,education - higher education instructional,14949,117933530,11994,32598052,657841,18714,26943,150531582,2010
PA,education - higher education other,29102,120466489,33011,31224398,1893525,40246,62113,151690887,2010
PA,education - other,3907,16193919,559,1188333,37218,4130,4466,17382252,2010
PA,libraries,0,0,0,0,0,0,0,0,2010
PA,liquor stores,3112,10498923,2294,4461000,254621,4646,5406,14959923,2010
PA,other and unallocable,6145,27377489,975,1140335,53818,6468,7120,28517824,2010
RI,total,16875,89407912,6547,6551529,283227,18694,23422,95959441,2010
RI,financial administration,839,4151053,10,21999,732,844,849,4173052,2010
RI,other government administration,540,2719519,387,230150,5414,574,927,2949669,2010
RI,judicial and legal,1141,6362698,18,45630,1570,1152,1159,6408328,2010
RI,police protection - officers,238,1720342,0,0,0,238,238,1720342,2010
RI,police protection - other,75,390124,2,1725,42,75,77,391849,2010
RI,corrections,1585,8850797,1,4636,77,1585,1586,8855433,2010
RI,highways,723,3453313,47,71913,4235,747,770,3525226,2010
RI,air transportation,175,1047189,2,4598,248,176,177,1051787,2010
RI,water transport and terminals,0,0,0,0,0,0,0,0,2010
RI,public welfare,1194,6081882,29,91962,4111,1221,1223,6173844,2010
RI,health,922,4943127,81,55837,2756,940,1003,4998964,2010
RI,hospitals,737,4030600,0,0,0,737,737,4030600,2010
RI,social insurance administration,430,2113252,7,28286,1025,437,437,2141538,2010
RI,solid waste management,100,562483,5,3322,221,101,105,565805,2010
RI,sewerage,246,1124573,0,0,0,246,246,1124573,2010
RI,parks and recreation,54,193335,0,0,0,54,54,193335,2010
RI,housing and community development,0,0,0,0,0,0,0,0,2010
RI,natural resources,410,2211784,32,57081,2185,424,442,2268865,2010
RI,water transport and terminals,0,0,0,0,0,0,0,0,2010
RI,electric power,0,0,0,0,0,0,0,0,2010
RI,gas supply,0,0,0,0,0,0,0,0,2010
RI,transit,742,3498170,42,103785,6706,780,784,3601955,2010
RI,education - elementary and secondary instructional,329,1830612,41,70680,4038,355,370,1901292,2010
RI,education - elementary and secondary other,166,543244,59,47340,4722,196,225,590584,2010
RI,education - higher education instructional,1817,11384167,2615,3733392,105033,2495,4432,15117559,2010
RI,education - higher education other,2232,10066005,3106,1849030,135181,3104,5338,11915035,2010
RI,education - other,489,2562960,18,42795,1497,499,507,2605755,2010
RI,libraries,0,0,0,0,0,0,0,0,2010
RI,liquor stores,0,0,0,0,0,0,0,0,2010
RI,other and unallocable,1691,9566683,45,87368,3434,1714,1736,9654051,2010
SC,total,70024,266804945,19729,19530800,1184928,77083,89753,286335745,2010
SC,financial administration,3485,11468858,103,231704,11676,3555,3588,11700562,2010
SC,other government administration,629,2394096,511,603796,36266,845,1140,2997892,2010
SC,judicial and legal,752,3707296,30,43640,2480,768,782,3750936,2010
SC,police protection - officers,1309,4856816,1,3798,52,1309,1310,4860614,2010
SC,police protection - other,627,2021898,1,2828,60,627,628,2024726,2010
SC,corrections,7436,21044060,14,25326,1392,7444,7450,21069386,2010
SC,highways,4852,14989192,8,15110,460,4855,4860,15004302,2010
SC,air transportation,12,54380,0,0,0,12,12,54380,2010
SC,water transport and terminals,494,2651250,3,4567,232,495,497,2655817,2010
SC,public welfare,4322,11972852,3,6316,206,4323,4325,11979168,2010
SC,health,5562,18726132,121,356247,10631,5626,5683,19082379,2010
SC,hospitals,6854,20219699,154,549513,20139,6970,7008,20769212,2010
SC,social insurance administration,1504,4486880,168,320478,22192,1637,1672,4807358,2010
SC,solid waste management,0,0,0,0,0,0,0,0,2010
SC,sewerage,0,0,0,0,0,0,0,0,2010
SC,parks and recreation,510,1388752,33,19058,2224,524,543,1407810,2010
SC,housing and community development,0,0,0,0,0,0,0,0,2010
SC,natural resources,2005,6252999,243,282652,23075,2144,2248,6535651,2010
SC,water transport and terminals,10,60526,0,0,0,10,10,60526,2010
SC,electric power,1837,10618402,21,47171,2236,1850,1858,10665573,2010
SC,gas supply,0,0,0,0,0,0,0,0,2010
SC,transit,0,0,0,0,0,0,0,0,2010
SC,education - elementary and secondary instructional,0,0,0,0,0,0,0,0,2010
SC,education - elementary and secondary other,0,0,0,0,0,0,0,0,2010
SC,education - higher education instructional,8378,53908770,7468,8582187,394856,10728,15846,62490957,2010
SC,education - higher education other,14851,59637263,10574,7951916,630657,18606,25425,67589179,2010
SC,education - other,2970,10733512,219,396062,21192,3098,3189,11129574,2010
SC,libraries,0,0,0,0,0,0,0,0,2010
SC,liquor stores,0,0,0,0,0,0,0,0,2010
SC,other and unallocable,1625,5611312,54,88431,4902,1657,1679,5699743,2010
SD,total,12574,49511378,6197,4868113,307724,14310,18771,54379491,2010
SD,financial administration,438,1940013,11,18890,1362,445,449,1958903,2010
SD,other government administration,321,1309979,70,81566,5761,353,391,1391545,2010
SD,judicial and legal,581,2607724,95,132278,8709,630,676,2740002,2010
SD,police protection - officers,189,771182,3,8042,250,191,192,779224,2010
SD,police protection - other,108,310010,8,12568,890,113,116,322578,2010
SD,corrections,867,2752153,25,41448,3022,884,892,2793601,2010
SD,highways,952,3657477,92,133932,8829,1002,1044,3791409,2010
SD,air transportation,0,0,0,0,0,0,0,0,2010
SD,water transport and terminals,0,0,0,0,0,0,0,0,2010
SD,public welfare,1053,3514001,39,71795,5090,1082,1092,3585796,2010
SD,health,589,2450870,132,363152,17308,688,721,2814022,2010
SD,hospitals,883,2882978,150,220105,15330,970,1033,3103083,2010
SD,social insurance administration,289,891288,12,16156,1306,296,301,907444,2010
SD,solid waste management,0,0,0,0,0,0,0,0,2010
SD,sewerage,0,0,0,0,0,0,0,0,2010
SD,parks and recreation,128,430433,24,20608,2117,140,152,451041,2010
SD,housing and community development,0,0,0,0,0,0,0,0,2010
SD,natural resources,931,3801040,324,397680,24572,1070,1255,4198720,2010
SD,water transport and terminals,0,0,0,0,0,0,0,0,2010
SD,electric power,0,0,0,0,0,0,0,0,2010
SD,gas supply,0,0,0,0,0,0,0,0,2010
SD,transit,0,0,0,0,0,0,0,0,2010
SD,education - elementary and secondary instructional,0,0,0,0,0,0,0,0,2010
SD,education - elementary and secondary other,0,0,0,0,0,0,0,0,2010
SD,education - higher education instructional,1456,9212210,1055,1475992,63924,1817,2511,10688202,2010
SD,education - higher education other,2607,8353120,4082,1775574,142053,3408,6689,10128694,2010
SD,education - other,370,1359803,19,28482,2258,382,389,1388285,2010
SD,libraries,0,0,0,0,0,0,0,0,2010
SD,liquor stores,0,0,0,0,0,0,0,0,2010
SD,other and unallocable,812,3267097,56,69845,4943,839,868,3336942,2010
TN,total,74226,283670389,25758,23869657,1463027,82871,99984,307540046,2010
TN,financial administration,3366,13632344,46,72340,5894,3401,3412,13704684,2010
TN,other government administration,838,3317242,9,7715,631,841,847,3324957,2010
TN,judicial and legal,2471,12609737,7,14185,523,2473,2478,12623922,2010
TN,police protection - officers,977,4616566,0,0,0,977,977,4616566,2010
TN,police protection - other,654,2334090,11,36638,1444,663,665,2370728,2010
TN,corrections,6959,19907068,49,81676,5194,6988,7008,19988744,2010
TN,highways,4204,13192512,0,0,0,4204,4204,13192512,2010
TN,air transportation,0,0,0,0,0,0,0,0,2010
TN,water transport and terminals,0,0,0,0,0,0,0,0,2010
TN,public welfare,8054,25100876,3,5472,398,8057,8057,25106348,2010
TN,health,4634,19853511,90,296695,12798,4707,4724,20150206,2010
TN,hospitals,5123,23956474,162,498014,20799,5242,5285,24454488,2010
TN,social insurance administration,1332,4278530,307,577072,44692,1601,1639,4855602,2010
TN,solid waste management,0,0,0,0,0,0,0,0,2010
TN,sewerage,0,0,0,0,0,0,0,0,2010
TN,parks and recreation,983,2416862,210,179100,19866,1103,1193,2595962,2010
TN,housing and community development,0,0,0,0,0,0,0,0,2010
TN,natural resources,3485,13302500,548,923289,73402,3911,4033,14225789,2010
TN,water transport and terminals,0,0,0,0,0,0,0,0,2010
TN,electric power,0,0,0,0,0,0,0,0,2010
TN,gas supply,0,0,0,0,0,0,0,0,2010
TN,transit,0,0,0,0,0,0,0,0,2010
TN,education - elementary and secondary instructional,0,0,0,0,0,0,0,0,2010
TN,education - elementary and secondary other,0,0,0,0,0,0,0,0,2010
TN,education - higher education instructional,8505,48341944,9831,12202911,564037,11859,18336,60544855,2010
TN,education - higher education other,17809,59558064,13995,8481533,688841,21863,31804,68039597,2010
TN,education - other,2074,7389630,449,442573,22322,2210,2523,7832203,2010
TN,libraries,0,0,0,0,0,0,0,0,2010
TN,liquor stores,0,0,0,0,0,0,0,0,2010
TN,other and unallocable,2758,9862439,41,50444,2186,2771,2799,9912883,2010
TX,total,284371,1217076969,80267,111176484,5936002,317912,364638,1328253453,2010
TX,financial administration,7061,30825870,121,191784,8103,7109,7182,31017654,2010
TX,other government administration,2122,9235278,467,503278,29102,2286,2589,9738556,2010
TX,judicial and legal,5624,28131705,134,683893,18583,5729,5758,28815598,2010
TX,police protection - officers,3503,16773382,0,0,0,3503,3503,16773382,2010
TX,police protection - other,3006,9492907,93,95560,7670,3050,3099,9588467,2010
TX,corrections,44486,126761930,637,846650,52915,44785,45123,127608580,2010
TX,highways,14096,55802345,555,1093331,28139,14255,14651,56895676,2010
TX,air transportation,0,0,0,0,0,0,0,0,2010
TX,water transport and terminals,0,0,0,0,0,0,0,0,2010
TX,public welfare,22896,70516812,252,466502,24012,23032,23148,70983314,2010
TX,health,26290,90149368,510,1394543,41839,26527,26800,91543911,2010
TX,hospitals,30072,147697505,2246,7324509,237156,31411,32318,155022014,2010
TX,social insurance administration,4765,16581778,46,80055,4084,4788,4811,16661833,2010
TX,solid waste management,0,0,0,0,0,0,0,0,2010
TX,sewerage,0,0,0,0,0,0,0,0,2010
TX,parks and recreation,1179,3647919,154,177237,16934,1275,1333,3825156,2010
TX,housing and community development,0,0,0,0,0,0,0,0,2010
TX,natural resources,10173,45152022,2042,4495949,157001,11059,12215,49647971,2010
TX,water transport and terminals,0,0,0,0,0,0,0,0,2010
TX,electric power,0,0,0,0,0,0,0,0,2010
TX,gas supply,0,0,0,0,0,0,0,0,2010
TX,transit,0,0,0,0,0,0,0,0,2010
TX,education - elementary and secondary instructional,0,0,0,0,0,0,0,0,2010
TX,education - elementary and secondary other,0,0,0,0,0,0,0,0,2010
TX,education - higher education instructional,25427,224935177,27158,49734047,2168638,37677,52585,274669224,2010
TX,education - higher education other,71121,287216295,45252,42629366,3077814,88513,116373,329845661,2010
TX,education - other,4760,21235623,311,899097,37159,4970,5071,22134720,2010
TX,libraries,0,0,0,0,0,0,0,0,2010
TX,liquor stores,0,0,0,0,0,0,0,0,2010
TX,other and unallocable,7790,32921053,289,560683,26853,7943,8079,33481736,2010
UT,total,43494,191777272,21799,23627283,1379989,51291,65293,215404555,2010
UT,financial administration,2384,10657048,197,146061,11548,2449,2581,10803109,2010
UT,other government administration,333,1661745,28,50715,1630,343,361,1712460,2010
UT,judicial and legal,1558,6876806,110,260692,6998,1597,1668,7137498,2010
UT,police protection - officers,412,1879600,0,0,0,412,412,1879600,2010
UT,police protection - other,330,1325222,73,82173,5302,359,403,1407395,2010
UT,corrections,3008,10657348,216,170843,13370,3084,3224,10828191,2010
UT,highways,1606,6829958,9,11052,1001,1612,1615,6841010,2010
UT,air transportation,0,0,0,0,0,0,0,0,2010
UT,water transport and terminals,0,0,0,0,0,0,0,0,2010
UT,public welfare,2796,9832039,215,296058,17335,2894,3011,10128097,2010
UT,health,1703,6676587,218,319033,15909,1793,1921,6995620,2010
UT,hospitals,6516,24517648,1236,1779508,75256,6941,7752,26297156,2010
UT,social insurance administration,835,2917547,42,119979,6713,873,877,3037526,2010
UT,solid waste management,0,0,0,0,0,0,0,0,2010
UT,sewerage,0,0,0,0,0,0,0,0,2010
UT,parks and recreation,284,936019,63,63779,5391,314,347,999798,2010
UT,housing and community development,0,0,0,0,0,0,0,0,2010
UT,natural resources,1265,4821319,255,184725,11179,1328,1520,5006044,2010
UT,water transport and terminals,0,0,0,0,0,0,0,0,2010
UT,electric power,0,0,0,0,0,0,0,0,2010
UT,gas supply,0,0,0,0,0,0,0,0,2010
UT,transit,0,0,0,0,0,0,0,0,2010
UT,education - elementary and secondary instructional,0,0,0,0,0,0,0,0,2010
UT,education - elementary and secondary other,0,0,0,0,0,0,0,0,2010
UT,education - higher education instructional,6409,48312245,5540,8110448,312910,8178,11949,56422693,2010
UT,education - higher education other,11389,43268197,12781,11160536,836593,16116,24170,54428733,2010
UT,education - other,918,4102826,466,648933,39770,1143,1384,4751759,2010
UT,libraries,0,0,0,0,0,0,0,0,2010
UT,liquor stores,263,723360,309,180837,17380,361,572,904197,2010
UT,other and unallocable,1485,5781758,41,41911,1704,1494,1526,5823669,2010
VT,total,13364,62072453,3280,4173247,181408,14408,16644,66245700,2010
VT,financial administration,575,2505079,5,7586,316,576,580,2512665,2010
VT,other government administration,620,2215547,29,14791,870,624,649,2230338,2010
VT,judicial and legal,657,2805527,34,17976,1100,663,691,2823503,2010
VT,police protection - officers,363,2749241,16,10437,717,367,379,2759678,2010
VT,police protection - other,323,1717493,54,45952,3452,343,377,1763445,2010
VT,corrections,1049,4477999,6,3224,199,1050,1055,4481223,2010
VT,highways,1013,4231023,2,1313,66,1013,1015,4232336,2010
VT,air transportation,0,0,0,0,0,0,0,0,2010
VT,water transport and terminals,0,0,0,0,0,0,0,0,2010
VT,public welfare,1297,5502285,37,37733,1526,1305,1334,5540018,2010
VT,health,462,2034314,135,161828,12281,531,597,2196142,2010
VT,hospitals,295,1261960,15,23851,576,298,310,1285811,2010
VT,social insurance administration,219,883386,3,3385,97,220,222,886771,2010
VT,solid waste management,0,0,0,0,0,0,0,0,2010
VT,sewerage,0,0,0,0,0,0,0,0,2010
VT,parks and recreation,109,477438,2,580,42,109,111,478018,2010
VT,housing and community development,0,0,0,0,0,0,0,0,2010
VT,natural resources,532,2568584,35,178674,4375,558,567,2747258,2010
VT,water transport and terminals,0,0,0,0,0,0,0,0,2010
VT,electric power,0,0,0,0,0,0,0,0,2010
VT,gas supply,0,0,0,0,0,0,0,0,2010
VT,transit,0,0,0,0,0,0,0,0,2010
VT,education - elementary and secondary instructional,0,0,0,0,0,0,0,0,2010
VT,education - elementary and secondary other,0,0,0,0,0,0,0,0,2010
VT,education - higher education instructional,1311,9651576,1184,2341300,74094,1738,2495,11992876,2010
VT,education - higher education other,2930,11686040,1626,1178919,74381,3361,4556,12864959,2010
VT,education - other,509,2281558,29,65765,3153,528,538,2347323,2010
VT,libraries,0,0,0,0,0,0,0,0,2010
VT,liquor stores,50,249602,1,877,55,50,51,250479,2010
VT,other and unallocable,1050,4773801,67,79056,4108,1074,1117,4852857,2010
VA,total,105968,464599744,51859,65998988,3314765,124709,157827,530598732,2010
VA,financial administration,3922,16569398,576,863602,62130,4274,4498,17433000,2010
VA,other government administration,513,2517974,514,931365,47071,792,1027,3449339,2010
VA,judicial and legal,3552,16746486,363,472112,16276,3643,3915,17218598,2010
VA,police protection - officers,2168,10466886,11,19544,1062,2174,2179,10486430,2010
VA,police protection - other,721,2664150,134,123477,7144,762,855,2787627,2010
VA,corrections,13782,42640042,280,449648,28168,13941,14062,43089690,2010
VA,highways,7559,31722054,133,192246,9030,7610,7692,31914300,2010
VA,air transportation,0,0,0,0,0,0,0,0,2010
VA,water transport and terminals,127,664428,2,4014,290,129,129,668442,2010
VA,public welfare,2666,10239372,281,507702,27928,2824,2947,10747074,2010
VA,health,5106,20037292,913,1493318,87454,5601,6019,21530610,2010
VA,hospitals,13789,52391638,2427,4589960,171042,14757,16216,56981598,2010
VA,social insurance administration,1301,4870946,506,1120645,70048,1696,1807,5991591,2010
VA,solid waste management,0,0,0,0,0,0,0,0,2010
VA,sewerage,0,0,0,0,0,0,0,0,2010
VA,parks and recreation,691,2422072,570,523502,42274,930,1261,2945574,2010
VA,housing and community development,0,0,0,0,0,0,0,0,2010
VA,natural resources,1990,9006688,361,541939,36709,2199,2351,9548627,2010
VA,water transport and terminals,0,0,0,0,0,0,0,0,2010
VA,electric power,0,0,0,0,0,0,0,0,2010
VA,gas supply,0,0,0,0,0,0,0,0,2010
VA,transit,0,0,0,0,0,0,0,0,2010
VA,education - elementary and secondary instructional,0,0,0,0,0,0,0,0,2010
VA,education - elementary and secondary other,0,0,0,0,0,0,0,0,2010
VA,education - higher education instructional,14496,107512824,15300,28097871,778995,18895,29796,135610695,2010
VA,education - higher education other,26461,101840713,26651,21974113,1633894,35691,53112,123814826,2010
VA,education - other,2603,11589323,626,1075328,54345,2910,3229,12664651,2010
VA,libraries,0,0,0,0,0,0,0,0,2010
VA,liquor stores,857,2799498,1454,1865728,172550,1832,2311,4665226,2010
VA,other and unallocable,3664,17897960,757,1152874,68355,4049,4421,19050834,2010
WA,total,100548,493993663,54599,83902236,3932657,122772,155147,577895899,2010
WA,financial administration,2975,14609214,104,260896,10550,3034,3079,14870110,2010
WA,other government administration,1375,6429627,222,586868,20857,1492,1597,7016495,2010
WA,judicial and legal,1915,10655218,147,445630,14254,1995,2062,11100848,2010
WA,police protection - officers,1076,6944486,0,0,0,1076,1076,6944486,2010
WA,police protection - other,1057,4600570,44,94988,4308,1081,1101,4695558,2010
WA,corrections,9280,40220610,521,1196870,53989,9585,9801,41417480,2010
WA,highways,5825,30985326,133,397246,17780,5926,5958,31382572,2010
WA,air transportation,0,0,0,0,0,0,0,0,2010
WA,water transport and terminals,0,0,0,0,0,0,0,0,2010
WA,public welfare,8999,36550614,1125,2138321,80620,9454,10124,38688935,2010
WA,health,4807,22056750,1200,3259998,164138,5735,6007,25316748,2010
WA,hospitals,8779,48125139,3547,13416727,334229,10668,12326,61541866,2010
WA,social insurance administration,2917,12875232,305,820346,45134,3172,3222,13695578,2010
WA,solid waste management,149,785002,18,58724,1962,160,167,843726,2010
WA,sewerage,0,0,0,0,0,0,0,0,2010
WA,parks and recreation,655,2958246,26,41876,2008,666,681,3000122,2010
WA,housing and community development,0,0,0,0,0,0,0,0,2010
WA,natural resources,4603,20145421,886,1452347,81562,5063,5489,21597768,2010
WA,water transport and terminals,0,0,0,0,0,0,0,0,2010
WA,electric power,0,0,0,0,0,0,0,0,2010
WA,gas supply,0,0,0,0,0,0,0,0,2010
WA,transit,0,0,0,0,0,0,0,0,2010
WA,education - elementary and secondary instructional,0,0,0,0,0,0,0,0,2010
WA,education - elementary and secondary other,0,0,0,0,0,0,0,0,2010
WA,education - higher education instructional,12652,86924822,12959,28692840,642304,16280,25611,115617662,2010
WA,education - higher education other,26047,114692210,31721,28467688,2326022,39190,57768,143159898,2010
WA,education - other,1807,8491381,821,1072065,40084,2041,2628,9563446,2010
WA,libraries,0,0,0,0,0,0,0,0,2010
WA,liquor stores,557,2260894,598,1024272,73368,972,1155,3285166,2010
WA,other and unallocable,5073,23682901,222,474534,19488,5182,5295,24157435,2010
WV,total,35915,127637477,11698,10108834,577484,39375,47613,137746311,2010
WV,financial administration,1911,5669648,45,62580,3334,1931,1956,5732228,2010
WV,other government administration,212,764352,311,765878,25175,371,523,1530230,2010
WV,judicial and legal,1472,6291864,34,46736,3400,1492,1506,6338600,2010
WV,police protection - officers,614,3087870,0,0,0,614,614,3087870,2010
WV,police protection - other,396,978158,19,11498,920,401,415,989656,2010
WV,corrections,3335,8893482,7,8268,790,3339,3342,8901750,2010
WV,highways,5079,15189604,26,50112,3950,5101,5105,15239716,2010
WV,air transportation,3,11870,0,0,0,3,3,11870,2010
WV,water transport and terminals,4,14380,0,0,0,4,4,14380,2010
WV,public welfare,3317,8553975,20,31670,1550,3325,3337,8585645,2010
WV,health,754,2404902,62,89848,4074,777,816,2494750,2010
WV,hospitals,1791,4678164,102,128782,8778,1840,1893,4806946,2010
WV,social insurance administration,644,1954014,81,129996,10236,706,725,2084010,2010
WV,solid waste management,11,39858,0,0,0,11,11,39858,2010
WV,sewerage,0,0,0,0,0,0,0,0,2010
WV,parks and recreation,383,815530,323,227678,30162,553,706,1043208,2010
WV,housing and community development,0,0,0,0,0,0,0,0,2010
WV,natural resources,1877,6343240,190,130482,13848,1958,2067,6473722,2010
WV,water transport and terminals,0,0,0,0,0,0,0,0,2010
WV,electric power,0,0,0,0,0,0,0,0,2010
WV,gas supply,0,0,0,0,0,0,0,0,2010
WV,transit,9,30368,0,0,0,9,9,30368,2010
WV,education - elementary and secondary instructional,0,0,0,0,0,0,0,0,2010
WV,education - elementary and secondary other,0,0,0,0,0,0,0,0,2010
WV,education - higher education instructional,3697,22838309,4239,5096141,163113,4680,7936,27934450,2010
WV,education - higher education other,6864,26251454,5962,3042951,297183,8655,12826,29294405,2010
WV,education - other,1268,4980048,146,189872,6266,1305,1414,5169920,2010
WV,libraries,0,0,0,0,0,0,0,0,2010
WV,liquor stores,53,153266,1,1626,134,54,54,154892,2010
WV,other and unallocable,2221,7693121,130,94716,4571,2246,2351,7787837,2010
WI,total,56385,276365755,49236,50276851,2839735,72428,105621,326642606,2010
WI,financial administration,2222,10461244,392,684176,42318,2460,2614,11145420,2010
WI,other government administration,829,3839061,337,760794,28549,992,1166,4599855,2010
WI,judicial and legal,1987,12412898,294,844146,30777,2160,2281,13257044,2010
WI,police protection - officers,583,3026308,3,3321,155,584,586,3029629,2010
WI,police protection - other,301,1244695,24,34857,1897,312,325,1279552,2010
WI,corrections,9819,40667421,696,2275826,62356,10172,10515,42943247,2010
WI,highways,1378,6981648,49,122828,5269,1408,1427,7104476,2010
WI,air transportation,0,0,0,0,0,0,0,0,2010
WI,water transport and terminals,0,0,0,0,0,0,0,0,2010
WI,public welfare,1661,7013068,388,874347,48991,1937,2049,7887415,2010
WI,health,1322,6372116,444,1216659,45865,1581,1766,7588775,2010
WI,hospitals,2993,12080100,652,1732373,63042,3349,3645,13812473,2010
WI,social insurance administration,939,3783704,34,74408,4295,964,973,3858112,2010
WI,solid waste management,0,0,0,0,0,0,0,0,2010
WI,sewerage,0,0,0,0,0,0,0,0,2010
WI,parks and recreation,110,452249,62,121684,6429,146,172,573933,2010
WI,housing and community development,0,0,0,0,0,0,0,0,2010
WI,natural resources,1836,7937302,897,1470702,78293,2277,2733,9408004,2010
WI,water transport and terminals,0,0,0,0,0,0,0,0,2010
WI,electric power,0,0,0,0,0,0,0,0,2010
WI,gas supply,0,0,0,0,0,0,0,0,2010
WI,transit,0,0,0,0,0,0,0,0,2010
WI,education - elementary and secondary instructional,0,0,0,0,0,0,0,0,2010
WI,education - elementary and secondary other,0,0,0,0,0,0,0,0,2010
WI,education - higher education instructional,8494,56188646,11575,13611607,684251,12360,20069,69800253,2010
WI,education - higher education other,16728,78667164,32234,24059022,1629135,25932,48962,102726186,2010
WI,education - other,841,4064869,324,878259,33755,1032,1165,4943128,2010
WI,libraries,0,0,0,0,0,0,0,0,2010
WI,liquor stores,0,0,0,0,0,0,0,0,2010
WI,other and unallocable,4342,21173262,831,1511842,74358,4762,5173,22685104,2010
WY,total,12410,52619843,3313,2929236,207574,13577,15723,55549079,2010
WY,financial administration,570,2718303,7,13253,560,572,577,2731556,2010
WY,other government administration,133,705057,92,74400,2682,146,225,779457,2010
WY,judicial and legal,528,2747581,48,153715,5490,559,576,2901296,2010
WY,police protection - officers,198,856256,0,0,0,198,198,856256,2010
WY,police protection - other,102,510475,0,0,0,102,102,510475,2010
WY,corrections,1351,4788508,4,6466,420,1353,1355,4794974,2010
WY,highways,1792,7439588,79,139619,10806,1853,1871,7579207,2010
WY,air transportation,0,0,0,0,0,0,0,0,2010
WY,water transport and terminals,0,0,0,0,0,0,0,0,2010
WY,public welfare,763,3068172,32,58940,3552,783,795,3127112,2010
WY,health,751,3164577,86,149713,7955,796,837,3314290,2010
WY,hospitals,717,2381524,37,82310,3170,735,754,2463834,2010
WY,social insurance administration,118,406174,11,12730,880,123,129,418904,2010
WY,solid waste management,0,0,0,0,0,0,0,0,2010
WY,sewerage,0,0,0,0,0,0,0,0,2010
WY,parks and recreation,153,596870,51,61096,2695,168,204,657966,2010
WY,housing and community development,0,0,0,0,0,0,0,0,2010
WY,natural resources,993,4187370,33,50732,2939,1009,1026,4238102,2010
WY,water transport and terminals,0,0,0,0,0,0,0,0,2010
WY,electric power,0,0,0,0,0,0,0,0,2010
WY,gas supply,0,0,0,0,0,0,0,0,2010
WY,transit,0,0,0,0,0,0,0,0,2010
WY,education - elementary and secondary instructional,0,0,0,0,0,0,0,0,2010
WY,education - elementary and secondary other,0,0,0,0,0,0,0,0,2010
WY,education - higher education instructional,1034,6660277,726,907544,49538,1314,1760,7567821,2010
WY,education - higher education other,1995,7216352,2064,1160991,113267,2635,4059,8377343,2010
WY,education - other,239,1178299,6,7938,480,241,245,1186237,2010
WY,libraries,0,0,0,0,0,0,0,0,2010
WY,liquor stores,40,144670,0,0,0,40,40,144670,2010
WY,other and unallocable,933,3849790,37,49789,3140,950,970,3899579,2010
