state,government_function,full_time_employees,full_time_pay,part_time_employees,part_time_pay,part_time_hours,full_time_equivalent_employees,total_employees,march_pay,year
US,total,3779258,17896466096,1534267,2075395894,101208722,4359380,5313525,19971861990,2011
US,financial administration,156478,698943007,9923,19000352,996058,162283,166401,717943359,2011
US,other government administration,47816,221979710,10526,21689766,879449,52935,58342,243669476,2011
US,judicial and legal,167030,879804374,9790,23556923,878403,172177,176820,903361297,2011
US,police protection - officers,66671,415881399,609,1072513,31071,66850,67280,416953912,2011
US,police protection - other,36601,148136633,1999,3483019,183716,37656,38600,151619652,2011
US,corrections,457250,1896879032,8874,24571562,927765,462549,466124,1921450594,2011
US,highways,218127,960745935,11636,25584566,1179034,225003,229763,986330501,2011
US,air transportation,3063,16208012,70,142770,5750,3097,3133,16350782,2011
US,water transport and terminals,4599,24071948,107,86531,4810,4625,4706,24158479,2011
US,public welfare,224812,853763980,11642,26634923,1285054,232198,236454,880398903,2011
US,health,189298,800195443,13861,31405042,1240753,196424,203159,831600485,2011
US,hospitals,355365,1613581803,70958,249213880,7680329,399219,426323,1862795683,2011
US,social insurance administration,82327,344051736,8474,18727997,924758,87702,90801,362779733,2011
US,solid waste management,1954,11049461,101,221573,10420,2014,2055,11271034,2011
US,sewerage,1695,9932510,48,228699,3845,1717,1743,10161209,2011
US,parks and recreation,27993,101562113,13325,15137376,1043357,34016,41318,116699489,2011
US,housing and community development,0,0,0,0,0,0,0,0,2011
US,natural resources,123611,536100174,28206,43521798,2476072,137735,151817,579621972,2011
US,water transport and terminals,716,3885596,28,108239,2472,731,744,3993835,2011
US,electric power,4059,27293645,42,126143,4741,4085,4101,27419788,2011
US,gas supply,0,0,0,0,0,0,0,0,2011
US,transit,31804,186656584,1733,3301459,174059,32787,33537,189958043,2011
US,education - elementary and secondary instructional,31610,170231607,11397,10674774,475810,34522,43007,180906381,2011
US,education - elementary and secondary other,12755,37143009,5183,4745167,222098,14138,17938,41888176,2011
US,education - higher education instructional,406426,2977122071,428441,731300650,26625609,559007,834867,3708422721,2011
US,education - higher education other,860344,3740943358,854647,765753922,51270550,1153516,1714991,4506697280,2011
US,education - other,79846,352918468,13389,22384310,1013142,85724,93235,375302778,2011
US,libraries,466,1595184,220,218172,17392,564,686,1813356,2011
US,liquor stores,6450,22104642,5360,8123664,554684,9697,11810,30228306,2011
US,other and unallocable,180092,843684662,13678,24380104,1097521,186409,193770,868064766,2011
AL,total,80409,335458306,28418,28641636,1634457,89768,108827,364099942,2011
AL,financial administration,2601,11243034,50,63882,4643,2627,2651,11306916,2011
AL,other government administration,510,2593402,115,174630,9602,564,625,2768032,2011
AL,judicial and legal,3299,14982720,88,164812,7278,3340,3387,15147532,2011
AL,police protection - officers,831,3724426,0,0,0,831,831,3724426,2011
AL,police protection - other,773,2427068,0,0,0,773,773,2427068,2011
AL,corrections,5416,17460781,58,118300,7080,5456,5474,17579081,2011
AL,highways,4672,15995536,99,60812,7920,4717,4771,16056348,2011
AL,air transportation,0,0,0,0,0,0,0,0,2011
AL,water transport and terminals,570,2437340,1,1650,60,570,571,2438990,2011
AL,public welfare,4315,14877704,95,76680,8974,4366,4410,14954384,2011
AL,health,5830,22008313,442,543479,56665,6150,6272,22551792,2011
AL,hospitals,11571,46777748,1449,2859323,109168,12187,13020,49637071,2011
AL,social insurance administration,905,3421928,88,132430,12750,977,993,3554358,2011
AL,solid waste management,0,0,0,0,0,0,0,0,2011
AL,sewerage,0,0,0,0,0,0,0,0,2011
AL,parks and recreation,380,1013502,243,234694,28308,540,623,1248196,2011
AL,housing and community development,0,0,0,0,0,0,0,0,2011
AL,natural resources,2037,7761786,141,171625,13424,2113,2178,7933411,2011
AL,water transport and terminals,0,0,0,0,0,0,0,0,2011
AL,electric power,0,0,0,0,0,0,0,0,2011
AL,gas supply,0,0,0,0,0,0,0,0,2011
AL,transit,0,0,0,0,0,0,0,0,2011
AL,education - elementary and secondary instructional,0,0,0,0,0,0,0,0,2011
AL,education - elementary and secondary other,0,0,0,0,0,0,0,0,2011
AL,education - higher education instructional,9352,67479665,9877,11490665,473447,12085,19229,78970330,2011
AL,education - higher education other,21540,80095277,15012,11725690,834162,26326,36552,91820967,2011
AL,education - other,2991,10902983,160,244204,9713,3044,3151,11147187,2011
AL,libraries,0,0,0,0,0,0,0,0,2011
AL,liquor stores,740,1925854,10,16426,938,745,750,1942280,2011
AL,other and unallocable,2076,8329239,490,562334,50325,2357,2566,8891573,2011
AK,total,24633,130839514,5603,7529911,363302,26747,30236,138369425,2011
AK,financial administration,1078,6007614,35,44796,1900,1090,1113,6052410,2011
AK,other government administration,807,4182994,53,112906,4458,834,860,4295900,2011
AK,judicial and legal,1434,8403348,47,99116,3530,1455,1481,8502464,2011
AK,police protection - officers,301,2439858,0,0,0,301,301,2439858,2011
AK,police protection - other,363,1597422,38,24570,1572,372,401,1621992,2011
AK,corrections,1893,9577060,58,112879,6332,1932,1951,9689939,2011
AK,highways,3104,17133454,45,67640,3932,3128,3149,17201094,2011
AK,air transportation,0,0,0,0,0,0,0,0,2011
AK,water transport and terminals,0,0,0,0,0,0,0,0,2011
AK,public welfare,1781,7887224,123,191162,18138,1890,1904,8078386,2011
AK,health,702,3836096,21,34288,1718,713,723,3870384,2011
AK,hospitals,222,1206750,40,108832,3411,243,262,1315582,2011
AK,social insurance administration,431,1881512,10,16568,936,437,441,1898080,2011
AK,solid waste management,0,0,0,0,0,0,0,0,2011
AK,sewerage,0,0,0,0,0,0,0,0,2011
AK,parks and recreation,101,461206,2,2744,166,102,103,463950,2011
AK,housing and community development,0,0,0,0,0,0,0,0,2011
AK,natural resources,2319,12175853,121,266167,9661,2376,2440,12442020,2011
AK,water transport and terminals,0,0,0,0,0,0,0,0,2011
AK,electric power,0,0,0,0,0,0,0,0,2011
AK,gas supply,0,0,0,0,0,0,0,0,2011
AK,transit,0,0,0,0,0,0,0,0,2011
AK,education - elementary and secondary instructional,2036,8991454,592,686506,38064,2270,2628,9677960,2011
AK,education - elementary and secondary other,685,2338939,695,643828,41259,936,1380,2982767,2011
AK,education - higher education instructional,1269,10564407,1101,1624097,66918,1647,2370,12188504,2011
AK,education - higher education other,2889,14314376,2498,3386696,155135,3765,5387,17701072,2011
AK,education - other,315,1633494,60,46104,2984,333,375,1679598,2011
AK,libraries,0,0,0,0,0,0,0,0,2011
AK,liquor stores,0,0,0,0,0,0,0,0,2011
AK,other and unallocable,2903,16206453,64,61012,3188,2923,2967,16267465,2011
AZ,total,57907,256773209,27280,29510389,1924981,68786,85187,286283598,2011
AZ,financial administration,2923,11231432,37,84815,3329,2942,2960,11316247,2011
AZ,other government administration,694,2787239,130,242373,8385,743,824,3029612,2011
AZ,judicial and legal,2023,9212929,81,261784,7987,2069,2104,9474713,2011
AZ,police protection - officers,1127,6286110,1,1791,106,1128,1128,6287901,2011
AZ,police protection - other,771,3403425,29,44639,1946,782,800,3448064,2011
AZ,corrections,10094,37354296,31,103298,3341,10113,10125,37457594,2011
AZ,highways,2723,11161221,27,58600,2263,2736,2750,11219821,2011
AZ,air transportation,0,0,0,0,0,0,0,0,2011
AZ,water transport and terminals,0,0,0,0,0,0,0,0,2011
AZ,public welfare,4752,15302028,113,315149,11418,4817,4865,15617177,2011
AZ,health,2356,9157560,48,114410,4716,2383,2404,9271970,2011
AZ,hospitals,642,2565568,18,73598,2024,653,660,2639166,2011
AZ,social insurance administration,1706,4837242,60,77997,5940,1740,1766,4915239,2011
AZ,solid waste management,0,0,0,0,0,0,0,0,2011
AZ,sewerage,0,0,0,0,0,0,0,0,2011
AZ,parks and recreation,293,783006,6,9726,469,296,299,792732,2011
AZ,housing and community development,0,0,0,0,0,0,0,0,2011
AZ,natural resources,1728,6905584,725,932877,59045,2061,2453,7838461,2011
AZ,water transport and terminals,0,0,0,0,0,0,0,0,2011
AZ,electric power,8,61443,0,0,0,8,8,61443,2011
AZ,gas supply,0,0,0,0,0,0,0,0,2011
AZ,transit,0,0,0,0,0,0,0,0,2011
AZ,education - elementary and secondary instructional,0,0,0,0,0,0,0,0,2011
AZ,education - elementary and secondary other,0,0,0,0,0,0,0,0,2011
AZ,education - higher education instructional,6913,51525532,8838,11316657,616125,10394,15751,62842189,2011
AZ,education - higher education other,13091,62040739,16664,15206921,1162854,19662,29755,77247660,2011
AZ,education - other,3078,10166666,267,374790,22207,3204,3345,10541456,2011
AZ,libraries,0,0,0,0,0,0,0,0,2011
AZ,liquor stores,0,0,0,0,0,0,0,0,2011
AZ,other and unallocable,2985,11991189,205,290964,12826,3055,3190,12282153,2011
AR,total,57093,224931067,16146,15233438,967885,62562,73239,240164505,2011
AR,financial administration,1987,7279354,7,7744,426,1990,1994,7287098,2011
AR,other government administration,748,3308760,186,347173,15736,837,934,3655933,2011
AR,judicial and legal,1370,5740435,150,230387,14828,1453,1520,5970822,2011
AR,police protection - officers,558,2498426,0,0,0,558,558,2498426,2011
AR,police protection - other,665,2172817,10,12069,846,670,675,2184886,2011
AR,corrections,5388,16019448,10,14320,651,5392,5398,16033768,2011
AR,highways,3449,12554549,0,0,0,3449,3449,12554549,2011
AR,air transportation,0,0,0,0,0,0,0,0,2011
AR,water transport and terminals,0,0,0,0,0,0,0,0,2011
AR,public welfare,3981,12765837,58,59366,4992,4010,4039,12825203,2011
AR,health,3952,15706616,166,193617,12591,4023,4118,15900233,2011
AR,hospitals,6492,23905249,491,893357,56308,6810,6983,24798606,2011
AR,social insurance administration,1433,4404097,12,30152,713,1437,1445,4434249,2011
AR,solid waste management,0,0,0,0,0,0,0,0,2011
AR,sewerage,0,0,0,0,0,0,0,0,2011
AR,parks and recreation,735,2098648,213,130721,18598,840,948,2229369,2011
AR,housing and community development,0,0,0,0,0,0,0,0,2011
AR,natural resources,1774,6560708,476,402477,31891,1955,2250,6963185,2011
AR,water transport and terminals,0,0,0,0,0,0,0,0,2011
AR,electric power,0,0,0,0,0,0,0,0,2011
AR,gas supply,0,0,0,0,0,0,0,0,2011
AR,transit,0,0,0,0,0,0,0,0,2011
AR,education - elementary and secondary instructional,0,0,0,0,0,0,0,0,2011
AR,education - elementary and secondary other,0,0,0,0,0,0,0,0,2011
AR,education - higher education instructional,6536,44983813,5233,6997934,266691,8041,11769,51981747,2011
AR,education - higher education other,14130,49307584,8849,5593995,523027,17086,22979,54901579,2011
AR,education - other,1383,5126418,55,84104,4133,1406,1438,5210522,2011
AR,libraries,0,0,0,0,0,0,0,0,2011
AR,liquor stores,0,0,0,0,0,0,0,0,2011
AR,other and unallocable,2512,10498308,230,236022,16454,2605,2742,10734330,2011
CA,total,335971,2069813547,155149,332590372,12628322,407321,491120,2402403919,2011
CA,financial administration,23056,105505857,2826,5110031,310854,24812,25882,110615888,2011
CA,other government administration,3678,20175247,299,883276,29621,3855,3977,21058523,2011
CA,judicial and legal,6273,39825439,481,1284401,37588,6485,6754,41109840,2011
CA,police protection - officers,8121,65779702,68,106678,2419,8135,8189,65886380,2011
CA,police protection - other,3400,13256242,56,106645,5087,3429,3456,13362887,2011
CA,corrections,58555,365008333,2254,7320512,257077,60007,60809,372328845,2011
CA,highways,19554,135223162,917,3252786,133885,20310,20471,138475948,2011
CA,air transportation,0,0,0,0,0,0,0,0,2011
CA,water transport and terminals,0,0,0,0,0,0,0,0,2011
CA,public welfare,3411,15496762,349,517109,17737,3511,3760,16013871,2011
CA,health,12225,68973257,1443,4052777,128550,12949,13668,73026034,2011
CA,hospitals,29445,216866164,17099,105727594,2468303,43390,46544,322593758,2011
CA,social insurance administration,17365,77870109,1950,4650498,234323,18688,19315,82520607,2011
CA,solid waste management,580,3046209,35,93163,3260,598,615,3139372,2011
CA,sewerage,0,0,0,0,0,0,0,0,2011
CA,parks and recreation,2396,11211208,1751,2662411,177741,3400,4147,13873619,2011
CA,housing and community development,0,0,0,0,0,0,0,0,2011
CA,natural resources,12881,68842548,2828,5073514,361934,14926,15709,73916062,2011
CA,water transport and terminals,0,0,0,0,0,0,0,0,2011
CA,electric power,0,0,0,0,0,0,0,0,2011
CA,gas supply,0,0,0,0,0,0,0,0,2011
CA,transit,0,0,0,0,0,0,0,0,2011
CA,education - elementary and secondary instructional,0,0,0,0,0,0,0,0,2011
CA,education - elementary and secondary other,0,0,0,0,0,0,0,0,2011
CA,education - higher education instructional,24225,210501292,29715,55965187,2008679,35574,53940,266466479,2011
CA,education - higher education other,87530,527436292,90260,129627765,6217051,122655,177790,657064057,2011
CA,education - other,3990,19041874,731,1282624,62605,4342,4721,20324498,2011
CA,libraries,0,0,0,0,0,0,0,0,2011
CA,liquor stores,0,0,0,0,0,0,0,0,2011
CA,other and unallocable,19286,105753850,2087,4873401,171608,20255,21373,110627251,2011
CO,total,54882,276811082,44008,78068109,3005539,72113,98890,354879191,2011
CO,financial administration,1845,9057432,125,296244,10828,1914,1970,9353676,2011
CO,other government administration,415,1805870,176,471925,22375,558,591,2277795,2011
CO,judicial and legal,4053,20431280,604,1720094,61916,4453,4657,22151374,2011
CO,police protection - officers,1050,6370698,0,0,0,1050,1050,6370698,2011
CO,police protection - other,448,1764732,54,162609,1670,457,502,1927341,2011
CO,corrections,7464,31391921,75,238106,8299,7516,7539,31630027,2011
CO,highways,2923,13596386,144,379506,14674,3018,3067,13975892,2011
CO,air transportation,0,0,0,0,0,0,0,0,2011
CO,water transport and terminals,0,0,0,0,0,0,0,0,2011
CO,public welfare,1875,8244290,387,993937,40564,2136,2262,9238227,2011
CO,health,1209,6756232,148,468985,14246,1301,1357,7225217,2011
CO,hospitals,4515,17580814,962,4107854,131312,5281,5477,21688668,2011
CO,social insurance administration,931,4360759,280,721075,34569,1154,1211,5081834,2011
CO,solid waste management,0,0,0,0,0,0,0,0,2011
CO,sewerage,0,0,0,0,0,0,0,0,2011
CO,parks and recreation,253,1173026,103,99332,4608,283,356,1272358,2011
CO,housing and community development,0,0,0,0,0,0,0,0,2011
CO,natural resources,1586,8183385,362,744360,17666,1698,1948,8927745,2011
CO,water transport and terminals,0,0,0,0,0,0,0,0,2011
CO,electric power,0,0,0,0,0,0,0,0,2011
CO,gas supply,0,0,0,0,0,0,0,0,2011
CO,transit,0,0,0,0,0,0,0,0,2011
CO,education - elementary and secondary instructional,0,0,0,0,0,0,0,0,2011
CO,education - elementary and secondary other,0,0,0,0,0,0,0,0,2011
CO,education - higher education instructional,8580,65363048,12089,31214113,1074103,14646,20669,96577161,2011
CO,education - higher education other,14406,63533518,27411,34815391,1505419,22911,41817,98348909,2011
CO,education - other,990,4850803,1020,1429311,54904,1344,2010,6280114,2011
CO,libraries,0,0,0,0,0,0,0,0,2011
CO,liquor stores,0,0,0,0,0,0,0,0,2011
CO,other and unallocable,2339,12346888,68,205267,8386,2393,2407,12552155,2011
CT,total,53305,312667560,23519,38284825,1479870,62090,76824,350952385,2011
CT,financial administration,2492,13495752,151,462984,17897,2594,2643,13958736,2011
CT,other government administration,1142,5978726,239,817565,26322,1291,1381,6796291,2011
CT,judicial and legal,4758,27953120,323,795097,11681,4824,5081,28748217,2011
CT,police protection - officers,1206,7345722,1,2980,133,1207,1207,7348702,2011
CT,police protection - other,648,3577021,50,48915,1796,658,698,3625936,2011
CT,corrections,7020,38828066,134,451708,10930,7081,7154,39279774,2011
CT,highways,2940,17196995,5,22508,720,2944,2945,17219503,2011
CT,air transportation,140,869154,0,0,0,140,140,869154,2011
CT,water transport and terminals,0,0,0,0,0,0,0,0,2011
CT,public welfare,5429,30264627,384,1546146,54955,5739,5813,31810773,2011
CT,health,3685,19624145,610,1850045,51357,3975,4295,21474190,2011
CT,hospitals,5221,31638697,1971,7580396,231906,6538,7192,39219093,2011
CT,social insurance administration,675,3936709,4,10908,410,677,679,3947617,2011
CT,solid waste management,48,342568,4,10536,520,51,52,353104,2011
CT,sewerage,0,0,0,0,0,0,0,0,2011
CT,parks and recreation,166,922585,12,17298,768,170,178,939883,2011
CT,housing and community development,0,0,0,0,0,0,0,0,2011
CT,natural resources,782,3959124,101,204878,7700,826,883,4164002,2011
CT,water transport and terminals,0,0,0,0,0,0,0,0,2011
CT,electric power,0,0,0,0,0,0,0,0,2011
CT,gas supply,0,0,0,0,0,0,0,0,2011
CT,transit,0,0,0,0,0,0,0,0,2011
CT,education - elementary and secondary instructional,0,0,0,0,0,0,0,0,2011
CT,education - elementary and secondary other,0,0,0,0,0,0,0,0,2011
CT,education - higher education instructional,4292,33477997,7491,13406888,408427,6787,11783,46884885,2011
CT,education - higher education other,7940,45341617,10660,9277216,580467,11450,18600,54618833,2011
CT,education - other,2195,12986720,877,1109365,45067,2449,3072,14096085,2011
CT,libraries,0,0,0,0,0,0,0,0,2011
CT,liquor stores,0,0,0,0,0,0,0,0,2011
CT,other and unallocable,2526,14928215,502,669392,28814,2689,3028,15597607,2011
DE,total,23182,98304766,8112,10981384,503530,26215,31294,109286150,2011
DE,financial administration,829,2773443,23,25796,1345,837,852,2799239,2011
DE,other government administration,318,1337255,91,300448,9733,377,409,1637703,2011
DE,judicial and legal,1714,7748872,62,129655,5838,1749,1776,7878527,2011
DE,police protection - officers,745,4917197,0,0,0,745,745,4917197,2011
DE,police protection - other,249,1178016,11,21708,1107,255,260,1199724,2011
DE,corrections,2871,10833042,41,57373,4415,2899,2912,10890415,2011
DE,highways,1541,5045480,0,0,0,1541,1541,5045480,2011
DE,air transportation,0,0,0,0,0,0,0,0,2011
DE,water transport and terminals,273,1110293,0,0,0,273,273,1110293,2011
DE,public welfare,1553,5293905,68,123897,6995,1595,1621,5417802,2011
DE,health,2007,7417829,138,274361,14060,2093,2145,7692190,2011
DE,hospitals,1534,5174951,81,105729,6221,1571,1615,5280680,2011
DE,social insurance administration,344,1130532,22,36972,1973,355,366,1167504,2011
DE,solid waste management,141,509681,21,39201,3053,159,162,548882,2011
DE,sewerage,0,0,0,0,0,0,0,0,2011
DE,parks and recreation,310,746900,28,21051,1574,320,338,767951,2011
DE,housing and community development,0,0,0,0,0,0,0,0,2011
DE,natural resources,467,1804885,74,97232,5825,503,541,1902117,2011
DE,water transport and terminals,0,0,0,0,0,0,0,0,2011
DE,electric power,0,0,0,0,0,0,0,0,2011
DE,gas supply,0,0,0,0,0,0,0,0,2011
DE,transit,805,3359176,3,7393,354,807,808,3366569,2011
DE,education - elementary and secondary instructional,0,0,0,0,0,0,0,0,2011
DE,education - elementary and secondary other,0,0,0,0,0,0,0,0,2011
DE,education - higher education instructional,1500,11538855,3204,6092480,208512,2756,4704,17631335,2011
DE,education - higher education other,4034,18083552,4021,3457495,221464,5368,8055,21541047,2011
DE,education - other,341,1976480,18,35400,1824,352,359,2011880,2011
DE,libraries,0,0,0,0,0,0,0,0,2011
DE,liquor stores,0,0,0,0,0,0,0,0,2011
DE,other and unallocable,1606,6324422,206,155193,9237,1660,1812,6479615,2011
FL,total,168583,654588814,45079,52328878,2764944,184237,213662,706917692,2011
FL,financial administration,6262,20851358,134,170981,11300,6325,6396,21022339,2011
FL,other government administration,1861,8024521,161,197600,13915,1939,2022,8222121,2011
FL,judicial and legal,19605,77349541,768,1259405,66555,19984,20373,78608946,2011
FL,police protection - officers,2197,9535989,377,607031,16583,2291,2574,10143020,2011
FL,police protection - other,1964,6706467,100,92466,5716,1996,2064,6798933,2011
FL,corrections,30302,91475012,222,383175,14237,30382,30524,91858187,2011
FL,highways,7403,30072267,62,56120,4786,7430,7465,30128387,2011
FL,air transportation,0,0,0,0,0,0,0,0,2011
FL,water transport and terminals,0,0,0,0,0,0,0,0,2011
FL,public welfare,9936,29362257,326,342416,25829,10082,10262,29704673,2011
FL,health,19501,63144976,1201,2513572,126931,20219,20702,65658548,2011
FL,hospitals,3773,11287344,71,135221,6454,3809,3844,11422565,2011
FL,social insurance administration,2542,8618681,13,22223,1223,2549,2555,8640904,2011
FL,solid waste management,0,0,0,0,0,0,0,0,2011
FL,sewerage,0,0,0,0,0,0,0,0,2011
FL,parks and recreation,1248,3006083,290,221721,17841,1349,1538,3227804,2011
FL,housing and community development,0,0,0,0,0,0,0,0,2011
FL,natural resources,8789,29177498,2523,2819562,147998,9625,11312,31997060,2011
FL,water transport and terminals,0,0,0,0,0,0,0,0,2011
FL,electric power,0,0,0,0,0,0,0,0,2011
FL,gas supply,0,0,0,0,0,0,0,0,2011
FL,transit,605,2725929,56,98606,7316,646,661,2824535,2011
FL,education - elementary and secondary instructional,0,0,0,0,0,0,0,0,2011
FL,education - elementary and secondary other,0,0,0,0,0,0,0,0,2011
FL,education - higher education instructional,15823,125068923,17174,22359324,970707,21312,32997,147428247,2011
FL,education - higher education other,27314,105959395,20859,20335169,1279918,34570,48173,126294564,2011
FL,education - other,2985,10178851,309,237643,14926,3070,3294,10416494,2011
FL,libraries,0,0,0,0,0,0,0,0,2011
FL,liquor stores,0,0,0,0,0,0,0,0,2011
FL,other and unallocable,6473,22043722,433,476643,32709,6659,6906,22520365,2011
GA,total,110625,432202937,43755,43856018,2301035,123627,154380,476058955,2011
GA,financial administration,3487,13760120,27,77734,2250,3501,3514,13837854,2011
GA,other government administration,937,3583874,203,166923,13927,1015,1140,3750797,2011
GA,judicial and legal,3648,16005273,11,38422,928,3654,3659,16043695,2011
GA,police protection - officers,1012,4271561,0,0,0,1012,1012,4271561,2011
GA,police protection - other,915,3176741,7,8824,680,919,922,3185565,2011
GA,corrections,17197,45861960,349,848516,34156,17390,17546,46710476,2011
GA,highways,5047,16009918,41,19766,936,5052,5088,16029684,2011
GA,air transportation,69,251844,0,0,0,69,69,251844,2011
GA,water transport and terminals,936,5664722,0,0,0,936,936,5664722,2011
GA,public welfare,8516,26065798,115,121808,4596,8542,8631,26187606,2011
GA,health,4810,17448508,109,117408,4524,4835,4919,17565916,2011
GA,hospitals,7099,20022538,158,423714,18204,7202,7257,20446252,2011
GA,social insurance administration,2217,6602198,80,101944,6796,2255,2297,6704142,2011
GA,solid waste management,0,0,0,0,0,0,0,0,2011
GA,sewerage,0,0,0,0,0,0,0,0,2011
GA,parks and recreation,1268,3573467,700,518843,56124,1585,1968,4092310,2011
GA,housing and community development,0,0,0,0,0,0,0,0,2011
GA,natural resources,3573,11560075,1057,1129734,83332,4043,4630,12689809,2011
GA,water transport and terminals,0,0,0,0,0,0,0,0,2011
GA,electric power,0,0,0,0,0,0,0,0,2011
GA,gas supply,0,0,0,0,0,0,0,0,2011
GA,transit,0,0,0,0,0,0,0,0,2011
GA,education - elementary and secondary instructional,0,0,0,0,0,0,0,0,2011
GA,education - elementary and secondary other,0,0,0,0,0,0,0,0,2011
GA,education - higher education instructional,14182,90210451,17401,24240873,809643,18754,31583,114451324,2011
GA,education - higher education other,29770,125135465,22900,14730160,1204039,36575,52670,139865625,2011
GA,education - other,2906,11953843,444,1105822,45440,3163,3350,13059665,2011
GA,libraries,0,0,0,0,0,0,0,0,2011
GA,liquor stores,0,0,0,0,0,0,0,0,2011
GA,other and unallocable,3036,11044581,153,205527,15460,3125,3189,11250108,2011
HI,total,53574,215573311,19409,15837761,778187,58142,72983,231411072,2011
HI,financial administration,673,2463738,2,4498,198,674,675,2468236,2011
HI,other government administration,702,2654593,167,333154,14350,784,869,2987747,2011
HI,judicial and legal,2422,10078306,50,91154,2316,2435,2472,10169460,2011
HI,police protection - officers,0,0,0,0,0,0,0,0,2011
HI,police protection - other,0,0,0,0,0,0,0,0,2011
HI,corrections,2296,9357061,10,39454,718,2300,2306,9396515,2011
HI,highways,831,3460202,18,12402,1406,839,849,3472604,2011
HI,air transportation,921,3584182,9,13486,684,925,930,3597668,2011
HI,water transport and terminals,199,734194,0,0,0,199,199,734194,2011
HI,public welfare,426,1592696,30,16858,2288,439,456,1609554,2011
HI,health,1943,8317638,46,137320,3928,1965,1989,8454958,2011
HI,hospitals,4270,18803647,687,1770311,51081,4560,4957,20573958,2011
HI,social insurance administration,294,1064724,25,42736,1998,305,319,1107460,2011
HI,solid waste management,0,0,0,0,0,0,0,0,2011
HI,sewerage,0,0,0,0,0,0,0,0,2011
HI,parks and recreation,136,466726,497,96064,6192,171,633,562790,2011
HI,housing and community development,0,0,0,0,0,0,0,0,2011
HI,natural resources,961,4259484,277,277620,15344,1047,1238,4537104,2011
HI,water transport and terminals,0,0,0,0,0,0,0,0,2011
HI,electric power,0,0,0,0,0,0,0,0,2011
HI,gas supply,0,0,0,0,0,0,0,0,2011
HI,transit,0,0,0,0,0,0,0,0,2011
HI,education - elementary and secondary instructional,17404,74871026,9894,8113354,383022,19711,27298,82984380,2011
HI,education - elementary and secondary other,7268,15314782,2215,800140,72992,7708,9483,16114922,2011
HI,education - higher education instructional,3708,24275024,655,805306,26734,3859,4363,25080330,2011
HI,education - higher education other,5130,19038110,4548,3003076,172782,6106,9678,22041186,2011
HI,education - other,114,451050,2,4544,160,115,116,455594,2011
HI,libraries,466,1595184,220,218172,17392,564,686,1813356,2011
HI,liquor stores,0,0,0,0,0,0,0,0,2011
HI,other and unallocable,3410,13190944,57,58112,4602,3436,3467,13249056,2011
ID,total,18318,82615308,10023,10444071,602060,21773,28341,93059379,2011
ID,financial administration,1151,5607003,179,372464,24761,1301,1330,5979467,2011
ID,other government administration,257,1204141,59,129688,7571,304,316,1333829,2011
ID,judicial and legal,457,3610776,48,213989,3983,481,505,3824765,2011
ID,police protection - officers,255,1118402,0,0,0,255,255,1118402,2011
ID,police protection - other,190,700056,18,22910,1326,197,208,722966,2011
ID,corrections,1925,8850445,25,57152,2777,1942,1950,8907597,2011
ID,highways,1509,5468866,98,178592,16893,1604,1607,5647458,2011
ID,air transportation,0,0,0,0,0,0,0,0,2011
ID,water transport and terminals,0,0,0,0,0,0,0,0,2011
ID,public welfare,1517,5376967,153,204394,10901,1580,1670,5581361,2011
ID,health,967,4491591,92,178064,7224,1009,1059,4669655,2011
ID,hospitals,566,1865047,94,95716,7829,610,660,1960763,2011
ID,social insurance administration,564,2954488,212,321099,13763,647,776,3275587,2011
ID,solid waste management,0,0,0,0,0,0,0,0,2011
ID,sewerage,0,0,0,0,0,0,0,0,2011
ID,parks and recreation,146,621842,78,109744,7249,190,224,731586,2011
ID,housing and community development,0,0,0,0,0,0,0,0,2011
ID,natural resources,1548,7749884,633,819084,50737,1850,2181,8568968,2011
ID,water transport and terminals,0,0,0,0,0,0,0,0,2011
ID,electric power,0,0,0,0,0,0,0,0,2011
ID,gas supply,0,0,0,0,0,0,0,0,2011
ID,transit,0,0,0,0,0,0,0,0,2011
ID,education - elementary and secondary instructional,0,0,0,0,0,0,0,0,2011
ID,education - elementary and secondary other,0,0,0,0,0,0,0,0,2011
ID,education - higher education instructional,2155,12285261,2335,3379631,125131,2861,4490,15664892,2011
ID,education - higher education other,3783,13887091,5617,3810349,292626,5437,9400,17697440,2011
ID,education - other,357,1964398,146,251932,10838,423,503,2216330,2011
ID,libraries,0,0,0,0,0,0,0,0,2011
ID,liquor stores,161,655143,150,152390,11473,230,311,807533,2011
ID,other and unallocable,810,4203907,86,146873,6978,852,896,4350780,2011
IL,total,105892,575157010,52604,83799322,4376851,131153,158496,658956332,2011
IL,financial administration,4860,26323168,296,587787,31904,5053,5156,26910955,2011
IL,other government administration,2086,12498599,32,81312,3019,2104,2118,12579911,2011
IL,judicial and legal,2613,22437376,72,204210,5204,2644,2685,22641586,2011
IL,police protection - officers,2063,15767648,0,0,0,2063,2063,15767648,2011
IL,police protection - other,1470,8169198,22,69032,1748,1481,1492,8238230,2011
IL,corrections,11691,63687354,4,21828,366,11693,11695,63709182,2011
IL,highways,6002,34538655,1208,4470558,135935,6820,7210,39009213,2011
IL,air transportation,0,0,0,0,0,0,0,0,2011
IL,water transport and terminals,56,338308,0,0,0,56,56,338308,2011
IL,public welfare,9058,49363452,23,77478,2344,9072,9081,49440930,2011
IL,health,2424,14476820,6,29250,652,2428,2430,14506070,2011
IL,hospitals,10746,53166439,781,1663036,54349,11054,11527,54829475,2011
IL,social insurance administration,2089,11630042,314,1321958,51846,2401,2403,12952000,2011
IL,solid waste management,0,0,0,0,0,0,0,0,2011
IL,sewerage,0,0,0,0,0,0,0,0,2011
IL,parks and recreation,439,2106700,30,89146,4122,463,469,2195846,2011
IL,housing and community development,0,0,0,0,0,0,0,0,2011
IL,natural resources,2402,11619967,1467,2976795,188820,3470,3869,14596762,2011
IL,water transport and terminals,0,0,0,0,0,0,0,0,2011
IL,electric power,0,0,0,0,0,0,0,0,2011
IL,gas supply,0,0,0,0,0,0,0,0,2011
IL,transit,0,0,0,0,0,0,0,0,2011
IL,education - elementary and secondary instructional,0,0,0,0,0,0,0,0,2011
IL,education - elementary and secondary other,0,0,0,0,0,0,0,0,2011
IL,education - higher education instructional,13406,89903220,17901,34880492,1499545,22112,31307,124783712,2011
IL,education - higher education other,26278,116970108,30180,36694385,2371415,39878,56458,153664493,2011
IL,education - other,2107,9164916,21,53702,1352,2114,2128,9218618,2011
IL,libraries,0,0,0,0,0,0,0,0,2011
IL,liquor stores,0,0,0,0,0,0,0,0,2011
IL,other and unallocable,6102,32995040,247,578353,24230,6247,6349,33573393,2011
IN,total,73874,307147452,44219,40297213,2791809,89796,118093,347444665,2011
IN,financial administration,1972,8188037,25,37704,2236,1985,1997,8225741,2011
IN,other government administration,557,2365793,324,419663,30000,737,881,2785456,2011
IN,judicial and legal,1389,9176492,51,67213,3666,1411,1440,9243705,2011
IN,police protection - officers,1262,5752444,0,0,0,1262,1262,5752444,2011
IN,police protection - other,656,2217635,2,2351,208,657,658,2219986,2011
IN,corrections,6285,19102605,3,4855,287,6286,6288,19107460,2011
IN,highways,3789,12591025,82,123756,8497,3840,3871,12714781,2011
IN,air transportation,0,0,0,0,0,0,0,0,2011
IN,water transport and terminals,27,139021,0,0,0,27,27,139021,2011
IN,public welfare,4530,14969659,42,50149,3959,4554,4572,15019808,2011
IN,health,1704,6721721,10,21531,846,1709,1714,6743252,2011
IN,hospitals,2190,6976312,26,40020,2030,2202,2216,7016332,2011
IN,social insurance administration,1274,3947998,247,284548,25594,1428,1521,4232546,2011
IN,solid waste management,0,0,0,0,0,0,0,0,2011
IN,sewerage,0,0,0,0,0,0,0,0,2011
IN,parks and recreation,116,386053,50,55259,5426,149,166,441312,2011
IN,housing and community development,0,0,0,0,0,0,0,0,2011
IN,natural resources,1924,7424155,541,692489,50875,2224,2465,8116644,2011
IN,water transport and terminals,0,0,0,0,0,0,0,0,2011
IN,electric power,0,0,0,0,0,0,0,0,2011
IN,gas supply,0,0,0,0,0,0,0,0,2011
IN,transit,0,0,0,0,0,0,0,0,2011
IN,education - elementary and secondary instructional,0,0,0,0,0,0,0,0,2011
IN,education - elementary and secondary other,0,0,0,0,0,0,0,0,2011
IN,education - higher education instructional,17087,96627160,13191,24493782,1235334,24079,30278,121120942,2011
IN,education - higher education other,25995,98863553,29399,13823313,1409534,34048,55394,112686866,2011
IN,education - other,1018,3882811,120,74690,6140,1055,1138,3957501,2011
IN,libraries,0,0,0,0,0,0,0,0,2011
IN,liquor stores,0,0,0,0,0,0,0,0,2011
IN,other and unallocable,2099,7814978,106,105890,7177,2143,2205,7920868,2011
IA,total,40561,227515034,26190,33350980,1736824,50378,66751,260866014,2011
IA,financial administration,1028,4884958,37,105809,4237,1053,1065,4990767,2011
IA,other government administration,246,1523907,359,628653,34569,441,605,2152560,2011
IA,judicial and legal,2105,11178220,135,343588,14995,2189,2240,11521808,2011
IA,police protection - officers,652,3657601,4,6175,356,654,656,3663776,2011
IA,police protection - other,320,1557445,26,17349,602,323,346,1574794,2011
IA,corrections,2963,13782990,181,546303,21508,3084,3144,14329293,2011
IA,highways,2284,10666651,0,0,0,2284,2284,10666651,2011
IA,air transportation,0,0,0,0,0,0,0,0,2011
IA,water transport and terminals,0,0,0,0,0,0,0,0,2011
IA,public welfare,2787,12385099,60,142878,6343,2823,2847,12527977,2011
IA,health,436,2406333,50,76106,3514,456,486,2482439,2011
IA,hospitals,6052,38189816,3663,6080521,326653,7898,9715,44270337,2011
IA,social insurance administration,723,3471483,3,7906,392,725,726,3479389,2011
IA,solid waste management,0,0,0,0,0,0,0,0,2011
IA,sewerage,0,0,0,0,0,0,0,0,2011
IA,parks and recreation,98,564039,11,13740,1523,107,109,577779,2011
IA,housing and community development,0,0,0,0,0,0,0,0,2011
IA,natural resources,1478,7872087,202,234511,16924,1574,1680,8106598,2011
IA,water transport and terminals,0,0,0,0,0,0,0,0,2011
IA,electric power,0,0,0,0,0,0,0,0,2011
IA,gas supply,0,0,0,0,0,0,0,0,2011
IA,transit,0,0,0,0,0,0,0,0,2011
IA,education - elementary and secondary instructional,0,0,0,0,0,0,0,0,2011
IA,education - elementary and secondary other,0,0,0,0,0,0,0,0,2011
IA,education - higher education instructional,3564,34305647,7140,17434960,629170,7119,10704,51740607,2011
IA,education - higher education other,12046,61718758,13909,6856160,634261,15630,25955,68574918,2011
IA,education - other,1086,5583487,127,254079,12052,1154,1213,5837566,2011
IA,libraries,0,0,0,0,0,0,0,0,2011
IA,liquor stores,0,0,0,0,0,0,0,0,2011
IA,other and unallocable,2693,13766513,283,602242,29725,2864,2976,14368755,2011
KS,total,38293,161919375,16448,16457993,931707,43555,54741,178377368,2011
KS,financial administration,1894,7068203,194,350468,13509,1969,2088,7418671,2011
KS,other government administration,474,1619110,181,571121,22821,604,655,2190231,2011
KS,judicial and legal,2030,8677011,121,146272,7572,2072,2151,8823283,2011
KS,police protection - officers,327,1596812,24,42662,2274,340,351,1639474,2011
KS,police protection - other,737,3025333,39,52293,3137,755,776,3077626,2011
KS,corrections,3415,10533020,18,23600,1477,3424,3433,10556620,2011
KS,highways,3192,11244279,112,125671,10005,3249,3304,11369950,2011
KS,air transportation,0,0,0,0,0,0,0,0,2011
KS,water transport and terminals,0,0,0,0,0,0,0,0,2011
KS,public welfare,2211,7235493,57,50539,4982,2239,2268,7286032,2011
KS,health,1177,4738327,32,55726,2355,1190,1209,4794053,2011
KS,hospitals,2420,7292455,387,234075,9457,2474,2807,7526530,2011
KS,social insurance administration,96,338091,1,204,33,96,97,338295,2011
KS,solid waste management,0,0,0,0,0,0,0,0,2011
KS,sewerage,0,0,0,0,0,0,0,0,2011
KS,parks and recreation,618,1752093,9,2566,281,620,627,1754659,2011
KS,housing and community development,0,0,0,0,0,0,0,0,2011
KS,natural resources,777,3193132,101,112467,8384,823,878,3305599,2011
KS,water transport and terminals,0,0,0,0,0,0,0,0,2011
KS,electric power,0,0,0,0,0,0,0,0,2011
KS,gas supply,0,0,0,0,0,0,0,0,2011
KS,transit,0,0,0,0,0,0,0,0,2011
KS,education - elementary and secondary instructional,0,0,0,0,0,0,0,0,2011
KS,education - elementary and secondary other,0,0,0,0,0,0,0,0,2011
KS,education - higher education instructional,4623,36280190,5054,8415006,355191,6629,9677,44695196,2011
KS,education - higher education other,10605,42774321,9799,5882319,474537,13287,20404,48656640,2011
KS,education - other,644,2718378,76,96575,3307,663,720,2814953,2011
KS,libraries,0,0,0,0,0,0,0,0,2011
KS,liquor stores,0,0,0,0,0,0,0,0,2011
KS,other and unallocable,3053,11833127,243,296429,12385,3121,3296,12129556,2011
KY,total,71863,277874637,24912,26311312,1626804,81493,96775,304185949,2011
KY,financial administration,2235,8239557,7,15310,650,2239,2242,8254867,2011
KY,other government administration,608,2986252,169,608752,25653,763,777,3595004,2011
KY,judicial and legal,4648,16702982,570,1228532,76980,5111,5218,17931514,2011
KY,police protection - officers,1066,4197944,0,0,0,1066,1066,4197944,2011
KY,police protection - other,1242,4807552,0,0,0,1242,1242,4807552,2011
KY,corrections,4183,10886449,0,0,0,4183,4183,10886449,2011
KY,highways,4544,13693094,1,900,68,4544,4545,13693994,2011
KY,air transportation,0,0,0,0,0,0,0,0,2011
KY,water transport and terminals,0,0,0,0,0,0,0,0,2011
KY,public welfare,5838,17390400,0,0,0,5838,5838,17390400,2011
KY,health,3132,11828867,37,125363,6401,3168,3169,11954230,2011
KY,hospitals,4996,19946579,676,1386566,43626,5242,5672,21333145,2011
KY,social insurance administration,951,2751634,0,0,0,951,951,2751634,2011
KY,solid waste management,0,0,0,0,0,0,0,0,2011
KY,sewerage,0,0,0,0,0,0,0,0,2011
KY,parks and recreation,993,2455374,94,96006,10102,1054,1087,2551380,2011
KY,housing and community development,0,0,0,0,0,0,0,0,2011
KY,natural resources,2906,10102970,81,151693,7838,2950,2987,10254663,2011
KY,water transport and terminals,0,0,0,0,0,0,0,0,2011
KY,electric power,0,0,0,0,0,0,0,0,2011
KY,gas supply,0,0,0,0,0,0,0,0,2011
KY,transit,0,0,0,0,0,0,0,0,2011
KY,education - elementary and secondary instructional,0,0,0,0,0,0,0,0,2011
KY,education - elementary and secondary other,0,0,0,0,0,0,0,0,2011
KY,education - higher education instructional,9201,63338239,7860,11372535,556224,12475,17061,74710774,2011
KY,education - higher education other,20015,69910695,15204,11145892,889884,25301,35219,81056587,2011
KY,education - other,1869,7352526,207,168970,9065,1928,2076,7521496,2011
KY,libraries,0,0,0,0,0,0,0,0,2011
KY,liquor stores,0,0,0,0,0,0,0,0,2011
KY,other and unallocable,3436,11283523,6,10793,313,3438,3442,11294316,2011
LA,total,76775,331117038,23012,21428196,1349113,84402,99787,352545234,2011
LA,financial administration,2370,9623351,126,140620,11016,2432,2496,9763971,2011
LA,other government administration,2155,10284193,690,714264,36400,2360,2845,10998457,2011
LA,judicial and legal,1646,7304981,46,40079,2499,1660,1692,7345060,2011
LA,police protection - officers,968,5720945,0,0,0,968,968,5720945,2011
LA,police protection - other,748,3475903,81,148615,7147,789,829,3624518,2011
LA,corrections,6534,25451803,69,87103,6476,6571,6603,25538906,2011
LA,highways,4619,18681802,44,41268,2467,4633,4663,18723070,2011
LA,air transportation,0,0,0,0,0,0,0,0,2011
LA,water transport and terminals,264,1422648,3,9978,164,265,267,1432626,2011
LA,public welfare,5271,19283082,82,106574,5900,5304,5353,19389656,2011
LA,health,3098,14501354,70,133794,6984,3137,3168,14635148,2011
LA,hospitals,12517,49793032,1478,2320173,122153,13207,13995,52113205,2011
LA,social insurance administration,991,3854366,57,88104,5931,1025,1048,3942470,2011
LA,solid waste management,0,0,0,0,0,0,0,0,2011
LA,sewerage,0,0,0,0,0,0,0,0,2011
LA,parks and recreation,869,2474358,184,177656,18941,976,1053,2652014,2011
LA,housing and community development,0,0,0,0,0,0,0,0,2011
LA,natural resources,3926,16819994,782,794939,59011,4260,4708,17614933,2011
LA,water transport and terminals,0,0,0,0,0,0,0,0,2011
LA,electric power,0,0,0,0,0,0,0,0,2011
LA,gas supply,0,0,0,0,0,0,0,0,2011
LA,transit,0,0,0,0,0,0,0,0,2011
LA,education - elementary and secondary instructional,1150,4595640,35,45735,1357,1158,1185,4641375,2011
LA,education - elementary and secondary other,180,837744,8,40076,1021,186,188,877820,2011
LA,education - higher education instructional,7949,56008308,6409,9125625,410596,10270,14358,65133933,2011
LA,education - higher education other,15784,55911200,11981,6385321,602159,19185,27765,62296521,2011
LA,education - other,3009,13072042,703,880379,39013,3234,3712,13952421,2011
LA,libraries,0,0,0,0,0,0,0,0,2011
LA,liquor stores,0,0,0,0,0,0,0,0,2011
LA,other and unallocable,2727,12000292,164,147893,9878,2782,2891,12148185,2011
ME,total,17665,73420012,10872,13626092,651696,21354,28537,87046104,2011
ME,financial administration,856,3413481,590,970304,39546,1081,1446,4383785,2011
ME,other government administration,288,1383718,234,589887,24877,430,522,1973605,2011
ME,judicial and legal,551,3001549,370,606098,22786,680,921,3607647,2011
ME,police protection - officers,301,1508434,0,0,0,301,301,1508434,2011
ME,police protection - other,225,815491,1,901,80,225,226,816392,2011
ME,corrections,899,3735169,370,1408981,57509,1224,1269,5144150,2011
ME,highways,2082,7577690,100,203033,10390,2141,2182,7780723,2011
ME,air transportation,0,0,0,0,0,0,0,0,2011
ME,water transport and terminals,76,227823,10,21217,1331,84,86,249040,2011
ME,public welfare,3318,12611517,102,249420,11084,3381,3420,12860937,2011
ME,health,871,3588094,280,630729,17917,972,1151,4218823,2011
ME,hospitals,350,1543537,213,490483,22028,474,563,2034020,2011
ME,social insurance administration,271,1018969,151,229279,9348,325,422,1248248,2011
ME,solid waste management,0,0,0,0,0,0,0,0,2011
ME,sewerage,0,0,0,0,0,0,0,0,2011
ME,parks and recreation,89,332053,81,123137,4678,115,170,455190,2011
ME,housing and community development,0,0,0,0,0,0,0,0,2011
ME,natural resources,768,3279320,420,747594,27109,921,1188,4026914,2011
ME,water transport and terminals,0,0,0,0,0,0,0,0,2011
ME,electric power,0,0,0,0,0,0,0,0,2011
ME,gas supply,0,0,0,0,0,0,0,0,2011
ME,transit,0,0,0,0,0,0,0,0,2011
ME,education - elementary and secondary instructional,16,28761,16,11690,1661,25,32,40451,2011
ME,education - elementary and secondary other,5,5330,27,13759,1342,13,32,19089,2011
ME,education - higher education instructional,1733,10244143,2532,3439464,136267,2504,4265,13683607,2011
ME,education - higher education other,3619,13225150,4786,2588188,217731,4850,8405,15813338,2011
ME,education - other,163,686677,88,148239,5592,195,251,834916,2011
ME,libraries,0,0,0,0,0,0,0,0,2011
ME,liquor stores,1,4443,0,0,0,1,1,4443,2011
ME,other and unallocable,1183,5188663,501,1153689,40420,1412,1684,6342352,2011
MD,total,77778,365776655,14045,40035650,1581399,86714,91823,405812305,2011
MD,financial administration,2956,12721627,128,292287,15713,3044,3084,13013914,2011
MD,other government administration,1447,7535411,303,583966,17950,1549,1750,8119377,2011
MD,judicial and legal,4704,25431341,442,1072708,62256,5057,5146,26504049,2011
MD,police protection - officers,1448,8082674,0,0,0,1448,1448,8082674,2011
MD,police protection - other,806,3376848,29,79447,4255,830,835,3456295,2011
MD,corrections,12056,49908131,338,744775,48123,12328,12394,50652906,2011
MD,highways,4526,19746301,0,0,0,4526,4526,19746301,2011
MD,air transportation,468,2239981,0,0,0,468,468,2239981,2011
MD,water transport and terminals,270,1447374,0,0,0,270,270,1447374,2011
MD,public welfare,6318,24969990,133,357460,19818,6430,6451,25327450,2011
MD,health,5649,24860837,786,1602763,94205,6180,6435,26463600,2011
MD,hospitals,3648,14888997,525,849694,45287,3906,4173,15738691,2011
MD,social insurance administration,924,3973833,205,480958,29444,1090,1129,4454791,2011
MD,solid waste management,0,0,0,0,0,0,0,0,2011
MD,sewerage,0,0,0,0,0,0,0,0,2011
MD,parks and recreation,332,1420768,167,240930,15077,417,499,1661698,2011
MD,housing and community development,0,0,0,0,0,0,0,0,2011
MD,natural resources,1820,9227224,312,755530,38650,2039,2132,9982754,2011
MD,water transport and terminals,0,0,0,0,0,0,0,0,2011
MD,electric power,0,0,0,0,0,0,0,0,2011
MD,gas supply,0,0,0,0,0,0,0,0,2011
MD,transit,715,3618433,0,0,0,715,715,3618433,2011
MD,education - elementary and secondary instructional,0,0,0,0,0,0,0,0,2011
MD,education - elementary and secondary other,0,0,0,0,0,0,0,0,2011
MD,education - higher education instructional,7036,53628569,4585,23181494,646380,10688,11621,76810063,2011
MD,education - higher education other,14914,64616276,5144,7552515,434284,17368,20058,72168791,2011
MD,education - other,1813,8400781,294,779592,33744,2003,2107,9180373,2011
MD,libraries,0,0,0,0,0,0,0,0,2011
MD,liquor stores,0,0,0,0,0,0,0,0,2011
MD,other and unallocable,5928,25681259,654,1461531,76213,6358,6582,27142790,2011
MA,total,81246,415142357,32858,46329996,1804733,92033,114104,461472353,2011
MA,financial administration,3454,17585044,259,907610,15024,3544,3713,18492654,2011
MA,other government administration,1799,7668502,278,1240113,25191,1943,2077,8908615,2011
MA,judicial and legal,8747,44631096,481,1522364,40301,8989,9228,46153460,2011
MA,police protection - officers,5290,34791774,62,180878,3586,5312,5352,34972652,2011
MA,police protection - other,724,3647338,10,33424,474,726,734,3680762,2011
MA,corrections,5878,29587037,47,150521,2480,5893,5925,29737558,2011
MA,highways,2366,11417483,18,72382,1344,2374,2384,11489865,2011
MA,air transportation,1002,6940132,0,0,0,1002,1002,6940132,2011
MA,water transport and terminals,160,1101838,0,0,0,160,160,1101838,2011
MA,public welfare,6725,33223422,517,1614612,32407,6921,7242,34838034,2011
MA,health,6021,26215414,781,2217985,83600,6525,6802,28433399,2011
MA,hospitals,5434,22496487,673,1764611,58991,5766,6107,24261098,2011
MA,social insurance administration,1547,7208213,44,192532,3077,1566,1591,7400745,2011
MA,solid waste management,0,0,0,0,0,0,0,0,2011
MA,sewerage,825,5264017,36,192675,2680,840,861,5456692,2011
MA,parks and recreation,919,3983987,131,189385,11404,984,1050,4173372,2011
MA,housing and community development,0,0,0,0,0,0,0,0,2011
MA,natural resources,1123,6282706,149,428285,12396,1197,1272,6710991,2011
MA,water transport and terminals,496,2824548,16,87680,1388,504,512,2912228,2011
MA,electric power,0,0,0,0,0,0,0,0,2011
MA,gas supply,0,0,0,0,0,0,0,0,2011
MA,transit,0,0,0,0,0,0,0,0,2011
MA,education - elementary and secondary instructional,62,341162,2,720,60,62,64,341882,2011
MA,education - elementary and secondary other,29,138020,17,18434,1036,35,46,156454,2011
MA,education - higher education instructional,6454,40565498,11990,20288346,655968,10396,18444,60853844,2011
MA,education - higher education other,15888,74488294,16909,13752828,823708,20815,32797,88241122,2011
MA,education - other,1044,5878876,94,279177,4715,1072,1138,6158053,2011
MA,libraries,0,0,0,0,0,0,0,0,2011
MA,liquor stores,0,0,0,0,0,0,0,0,2011
MA,other and unallocable,5259,28861469,344,1195434,24903,5407,5603,30056903,2011
MI,total,118740,629821246,67433,84663309,4631439,144921,186173,714484555,2011
MI,financial administration,3386,18365542,337,1113949,48713,3661,3723,19479491,2011
MI,other government administration,1615,7542423,24,88649,3157,1633,1639,7631072,2011
MI,judicial and legal,1325,9274494,56,196150,6175,1361,1381,9470644,2011
MI,police protection - officers,1568,10430849,0,0,0,1568,1568,10430849,2011
MI,police protection - other,760,3284744,79,257561,6584,797,839,3542305,2011
MI,corrections,14316,70807796,170,823953,23816,14451,14486,71631749,2011
MI,highways,2380,12349533,323,802004,38661,2598,2703,13151537,2011
MI,air transportation,0,0,0,0,0,0,0,0,2011
MI,water transport and terminals,0,0,0,0,0,0,0,0,2011
MI,public welfare,9550,43051359,839,3250074,144176,10365,10389,46301433,2011
MI,health,1594,8457683,133,380402,13380,1670,1727,8838085,2011
MI,hospitals,13737,66493372,6308,22764427,915298,18908,20045,89257799,2011
MI,social insurance administration,1222,5991992,52,121254,4975,1250,1274,6113246,2011
MI,solid waste management,0,0,0,0,0,0,0,0,2011
MI,sewerage,0,0,0,0,0,0,0,0,2011
MI,parks and recreation,221,1070378,127,415860,12184,290,348,1486238,2011
MI,housing and community development,0,0,0,0,0,0,0,0,2011
MI,natural resources,3204,15410637,703,1351355,67506,3586,3907,16761992,2011
MI,water transport and terminals,0,0,0,0,0,0,0,0,2011
MI,electric power,0,0,0,0,0,0,0,0,2011
MI,gas supply,0,0,0,0,0,0,0,0,2011
MI,transit,0,0,0,0,0,0,0,0,2011
MI,education - elementary and secondary instructional,0,0,0,0,0,0,0,0,2011
MI,education - elementary and secondary other,0,0,0,0,0,0,0,0,2011
MI,education - higher education instructional,19400,155254037,10153,16812360,690670,23313,29553,172066397,2011
MI,education - higher education other,37897,170145386,47561,34754066,2583386,52494,85458,204899452,2011
MI,education - other,438,2433288,140,560529,21535,560,578,2993817,2011
MI,libraries,0,0,0,0,0,0,0,0,2011
MI,liquor stores,0,0,0,0,0,0,0,0,2011
MI,other and unallocable,6127,29457733,428,970716,51223,6416,6555,30428449,2011
MN,total,66208,359985375,33196,49569327,2381565,79672,99404,409554702,2011
MN,financial administration,2776,13774506,103,254702,14594,2859,2879,14029208,2011
MN,other government administration,892,3983729,174,429741,20625,1009,1066,4413470,2011
MN,judicial and legal,3094,16351345,514,1619682,63869,3456,3608,17971027,2011
MN,police protection - officers,565,3208551,0,0,0,565,565,3208551,2011
MN,police protection - other,438,1668446,45,92727,4523,464,483,1761173,2011
MN,corrections,4098,17708832,122,375776,18192,4201,4220,18084608,2011
MN,highways,4548,22181010,231,386649,21208,4668,4779,22567659,2011
MN,air transportation,0,0,0,0,0,0,0,0,2011
MN,water transport and terminals,0,0,0,0,0,0,0,0,2011
MN,public welfare,1611,7667040,1292,3111321,218353,2845,2903,10778361,2011
MN,health,2372,12200433,259,744987,28961,2536,2631,12945420,2011
MN,hospitals,3419,16895878,1322,3802202,230216,4720,4741,20698080,2011
MN,social insurance administration,1220,5308435,92,232043,10248,1278,1312,5540478,2011
MN,solid waste management,0,0,0,0,0,0,0,0,2011
MN,sewerage,622,3536373,12,36024,1165,629,634,3572397,2011
MN,parks and recreation,507,2383130,134,171375,9954,564,641,2554505,2011
MN,housing and community development,0,0,0,0,0,0,0,0,2011
MN,natural resources,2619,12898772,608,1264473,75711,3046,3227,14163245,2011
MN,water transport and terminals,0,0,0,0,0,0,0,0,2011
MN,electric power,0,0,0,0,0,0,0,0,2011
MN,gas supply,0,0,0,0,0,0,0,0,2011
MN,transit,2273,11035907,373,920426,43355,2518,2646,11956333,2011
MN,education - elementary and secondary instructional,0,0,0,0,0,0,0,0,2011
MN,education - elementary and secondary other,0,0,0,0,0,0,0,0,2011
MN,education - higher education instructional,11287,74259443,11119,18126490,635912,14880,22406,92385933,2011
MN,education - higher education other,17186,98293208,15352,15176693,864282,22071,32538,113469901,2011
MN,education - other,3394,19943566,1237,2381403,99408,3957,4631,22324969,2011
MN,libraries,0,0,0,0,0,0,0,0,2011
MN,liquor stores,0,0,0,0,0,0,0,0,2011
MN,other and unallocable,3287,16686771,207,442613,20989,3406,3494,17129384,2011
MS,total,52474,193635040,12431,13493421,916892,57656,64905,207128461,2011
MS,financial administration,1365,4830624,41,74922,4412,1390,1406,4905546,2011
MS,other government administration,453,1773262,71,58887,3020,470,524,1832149,2011
MS,judicial and legal,712,4138956,6,9377,163,713,718,4148333,2011
MS,police protection - officers,701,2733741,0,0,0,701,701,2733741,2011
MS,police protection - other,478,1151701,0,0,0,478,478,1151701,2011
MS,corrections,3162,8304913,16,32627,2064,3174,3178,8337540,2011
MS,highways,3338,9538082,10,22089,1379,3346,3348,9560171,2011
MS,air transportation,0,0,0,0,0,0,0,0,2011
MS,water transport and terminals,41,217130,0,0,0,41,41,217130,2011
MS,public welfare,2922,9553264,0,0,0,2922,2922,9553264,2011
MS,health,3057,10459996,79,228330,9343,3109,3136,10688326,2011
MS,hospitals,11992,39397848,455,1033026,51052,12280,12447,40430874,2011
MS,social insurance administration,726,2313008,303,673288,51830,1019,1029,2986296,2011
MS,solid waste management,0,0,0,0,0,0,0,0,2011
MS,sewerage,0,0,0,0,0,0,0,0,2011
MS,parks and recreation,336,816627,80,71226,7958,381,416,887853,2011
MS,housing and community development,0,0,0,0,0,0,0,0,2011
MS,natural resources,2753,8432994,669,653781,48859,3028,3422,9086775,2011
MS,water transport and terminals,49,124781,9,9881,821,54,58,134662,2011
MS,electric power,0,0,0,0,0,0,0,0,2011
MS,gas supply,0,0,0,0,0,0,0,0,2011
MS,transit,0,0,0,0,0,0,0,0,2011
MS,education - elementary and secondary instructional,0,0,0,0,0,0,0,0,2011
MS,education - elementary and secondary other,0,0,0,0,0,0,0,0,2011
MS,education - higher education instructional,6286,37836108,1542,2562978,121160,6971,7828,40399086,2011
MS,education - higher education other,9180,36204016,8959,7748374,592155,12526,18139,43952390,2011
MS,education - other,1515,4875234,32,51917,2758,1531,1547,4927151,2011
MS,libraries,0,0,0,0,0,0,0,0,2011
MS,liquor stores,111,296388,0,0,0,111,111,296388,2011
MS,other and unallocable,3297,10636367,159,262718,19918,3411,3456,10899085,2011
MO,total,77797,276101341,23938,23921197,1689961,87361,101735,300022538,2011
MO,financial administration,3013,10792923,146,199818,16727,3107,3159,10992741,2011
MO,other government administration,728,2594218,295,697094,32140,914,1023,3291312,2011
MO,judicial and legal,3827,14315304,371,335830,29392,3993,4198,14651134,2011
MO,police protection - officers,1348,6567126,0,0,0,1348,1348,6567126,2011
MO,police protection - other,1021,3185072,140,130102,14400,1102,1161,3315174,2011
MO,corrections,12192,31646098,137,137996,10412,12251,12329,31784094,2011
MO,highways,6085,20649106,1,4354,160,6086,6086,20653460,2011
MO,air transportation,0,0,0,0,0,0,0,0,2011
MO,water transport and terminals,0,0,0,0,0,0,0,0,2011
MO,public welfare,7203,18445380,295,330820,20410,7318,7498,18776200,2011
MO,health,2854,8729283,188,329091,16493,2948,3042,9058374,2011
MO,hospitals,9903,30944923,1095,1703348,98510,10460,10998,32648271,2011
MO,social insurance administration,632,1781292,63,74841,5090,661,695,1856133,2011
MO,solid waste management,0,0,0,0,0,0,0,0,2011
MO,sewerage,0,0,0,0,0,0,0,0,2011
MO,parks and recreation,479,1453318,186,88810,8520,527,665,1542128,2011
MO,housing and community development,0,0,0,0,0,0,0,0,2011
MO,natural resources,2114,7001136,535,544549,51739,2406,2649,7545685,2011
MO,water transport and terminals,0,0,0,0,0,0,0,0,2011
MO,electric power,0,0,0,0,0,0,0,0,2011
MO,gas supply,0,0,0,0,0,0,0,0,2011
MO,transit,0,0,0,0,0,0,0,0,2011
MO,education - elementary and secondary instructional,0,0,0,0,0,0,0,0,2011
MO,education - elementary and secondary other,0,0,0,0,0,0,0,0,2011
MO,education - higher education instructional,7978,49850610,7560,9695403,499580,10802,15538,59546013,2011
MO,education - higher education other,13511,51348312,11730,7577491,761888,17824,25241,58925803,2011
MO,education - other,1078,3681840,988,1796152,107996,1688,2066,5477992,2011
MO,libraries,0,0,0,0,0,0,0,0,2011
MO,liquor stores,0,0,0,0,0,0,0,0,2011
MO,other and unallocable,3831,13115400,208,275498,16504,3926,4039,13390898,2011
MT,total,16780,69239987,10051,11905484,710861,20795,26831,81145471,2011
MT,financial administration,969,3577921,78,128947,9031,1021,1047,3706868,2011
MT,other government administration,569,2217856,147,199365,13913,647,716,2417221,2011
MT,judicial and legal,636,2821676,89,180983,8573,684,725,3002659,2011
MT,police protection - officers,216,1017486,0,0,0,216,216,1017486,2011
MT,police protection - other,236,946815,22,54819,2896,252,258,1001634,2011
MT,corrections,1300,5570847,28,52379,2480,1314,1328,5623226,2011
MT,highways,2020,8808749,189,330355,18456,2124,2209,9139104,2011
MT,air transportation,0,0,0,0,0,0,0,0,2011
MT,water transport and terminals,0,0,0,0,0,0,0,0,2011
MT,public welfare,1225,4233520,556,1554491,87070,1717,1781,5788011,2011
MT,health,739,2872674,260,645207,29142,904,999,3517881,2011
MT,hospitals,504,1749680,219,269377,19215,613,723,2019057,2011
MT,social insurance administration,680,2814507,107,286084,16977,776,787,3100591,2011
MT,solid waste management,0,0,0,0,0,0,0,0,2011
MT,sewerage,0,0,0,0,0,0,0,0,2011
MT,parks and recreation,60,216835,78,132774,7534,103,138,349609,2011
MT,housing and community development,0,0,0,0,0,0,0,0,2011
MT,natural resources,1274,5063139,447,840998,45107,1528,1721,5904137,2011
MT,water transport and terminals,0,0,0,0,0,0,0,0,2011
MT,electric power,0,0,0,0,0,0,0,0,2011
MT,gas supply,0,0,0,0,0,0,0,0,2011
MT,transit,0,0,0,0,0,0,0,0,2011
MT,education - elementary and secondary instructional,0,0,0,0,0,0,0,0,2011
MT,education - elementary and secondary other,0,0,0,0,0,0,0,0,2011
MT,education - higher education instructional,1332,8610005,1331,2117881,99798,1895,2663,10727886,2011
MT,education - higher education other,3599,12724934,6189,4491011,317486,5393,9788,17215945,2011
MT,education - other,311,1325192,154,262561,15267,397,465,1587753,2011
MT,libraries,0,0,0,0,0,0,0,0,2011
MT,liquor stores,26,96263,3,3465,330,28,29,99728,2011
MT,other and unallocable,1084,4571888,154,354787,17586,1183,1238,4926675,2011
NE,total,26659,109978829,10401,11996077,956415,32065,37060,121974906,2011
NE,financial administration,782,2998120,14,22277,1137,789,796,3020397,2011
NE,other government administration,277,1206833,97,106659,6346,313,374,1313492,2011
NE,judicial and legal,705,3431388,57,53257,3637,726,762,3484645,2011
NE,police protection - officers,467,2528059,0,0,0,467,467,2528059,2011
NE,police protection - other,279,959065,11,13979,1220,286,290,973044,2011
NE,corrections,2826,9427101,81,126782,8640,2875,2907,9553883,2011
NE,highways,2103,7922642,8,20152,877,2108,2111,7942794,2011
NE,air transportation,25,107749,0,0,0,25,25,107749,2011
NE,water transport and terminals,0,0,0,0,0,0,0,0,2011
NE,public welfare,2256,6749373,238,346385,21522,2378,2494,7095758,2011
NE,health,649,2650217,17,28512,1797,659,666,2678729,2011
NE,hospitals,3200,12436885,749,1830497,113915,3844,3949,14267382,2011
NE,social insurance administration,259,987815,7,8763,632,262,266,996578,2011
NE,solid waste management,0,0,0,0,0,0,0,0,2011
NE,sewerage,0,0,0,0,0,0,0,0,2011
NE,parks and recreation,209,714949,160,129721,13275,284,369,844670,2011
NE,housing and community development,0,0,0,0,0,0,0,0,2011
NE,natural resources,1520,5751630,755,1616268,110995,2146,2275,7367898,2011
NE,water transport and terminals,0,0,0,0,0,0,0,0,2011
NE,electric power,0,0,0,0,0,0,0,0,2011
NE,gas supply,0,0,0,0,0,0,0,0,2011
NE,transit,0,0,0,0,0,0,0,0,2011
NE,education - elementary and secondary instructional,0,0,0,0,0,0,0,0,2011
NE,education - elementary and secondary other,0,0,0,0,0,0,0,0,2011
NE,education - higher education instructional,2766,19501732,1149,2234512,101313,3338,3915,21736244,2011
NE,education - higher education other,5990,23128548,6853,5289063,560885,9159,12843,28417611,2011
NE,education - other,548,2358831,30,36695,2469,562,578,2395526,2011
NE,libraries,0,0,0,0,0,0,0,0,2011
NE,liquor stores,0,0,0,0,0,0,0,0,2011
NE,other and unallocable,1798,7117892,175,132555,7755,1844,1973,7250447,2011
NV,total,24963,121220709,9862,10819440,559496,28121,34825,132040149,2011
NV,financial administration,1379,5392312,17,33279,980,1385,1396,5425591,2011
NV,other government administration,1150,5944029,14,26191,1107,1157,1164,5970220,2011
NV,judicial and legal,738,4896804,17,36217,668,741,755,4933021,2011
NV,police protection - officers,569,3524466,0,0,0,569,569,3524466,2011
NV,police protection - other,424,1918561,0,0,0,424,424,1918561,2011
NV,corrections,3511,15626645,43,123734,1992,3523,3554,15750379,2011
NV,highways,1777,7848951,5,8637,660,1781,1782,7857588,2011
NV,air transportation,0,0,0,0,0,0,0,0,2011
NV,water transport and terminals,0,0,0,0,0,0,0,0,2011
NV,public welfare,1681,6328212,9,14776,498,1684,1690,6342988,2011
NV,health,1433,6364603,27,69174,2562,1448,1460,6433777,2011
NV,hospitals,1312,6117909,70,249064,8856,1362,1382,6366973,2011
NV,social insurance administration,733,2466524,1,1003,40,733,734,2467527,2011
NV,solid waste management,0,0,0,0,0,0,0,0,2011
NV,sewerage,0,0,0,0,0,0,0,0,2011
NV,parks and recreation,130,502644,52,74236,3708,151,182,576880,2011
NV,housing and community development,0,0,0,0,0,0,0,0,2011
NV,natural resources,924,4307389,142,187646,9771,979,1066,4495035,2011
NV,water transport and terminals,18,106710,0,0,0,18,18,106710,2011
NV,electric power,18,106710,0,0,0,18,18,106710,2011
NV,gas supply,0,0,0,0,0,0,0,0,2011
NV,transit,0,0,0,0,0,0,0,0,2011
NV,education - elementary and secondary instructional,0,0,0,0,0,0,0,0,2011
NV,education - elementary and secondary other,0,0,0,0,0,0,0,0,2011
NV,education - higher education instructional,2142,17310241,3896,3976534,129967,2876,6038,21286775,2011
NV,education - higher education other,4812,22018671,5497,5873441,393292,7034,10309,27892112,2011
NV,education - other,135,665090,2,4751,102,136,137,669841,2011
NV,libraries,0,0,0,0,0,0,0,0,2011
NV,liquor stores,0,0,0,0,0,0,0,0,2011
NV,other and unallocable,2077,9774238,70,140757,5293,2102,2147,9914995,2011
NH,total,15548,72302184,10684,12433024,634267,19394,26232,84735208,2011
NH,financial administration,741,3506487,29,50706,2903,759,770,3557193,2011
NH,other government administration,323,1435683,95,120896,8152,372,418,1556579,2011
NH,judicial and legal,926,3634232,8,16485,698,930,934,3650717,2011
NH,police protection - officers,327,1871928,0,0,0,327,327,1871928,2011
NH,police protection - other,163,623976,23,33980,2635,179,186,657956,2011
NH,corrections,1091,4783661,58,85048,4915,1121,1149,4868709,2011
NH,highways,1661,6865990,279,376072,36635,1882,1940,7242062,2011
NH,air transportation,27,111749,19,39144,2511,41,46,150893,2011
NH,water transport and terminals,8,42438,8,5659,436,10,16,48097,2011
NH,public welfare,1511,5879712,131,221606,10105,1571,1642,6101318,2011
NH,health,844,3985726,66,107042,6033,881,910,4092768,2011
NH,hospitals,663,2666836,85,138497,2119,676,748,2805333,2011
NH,social insurance administration,375,1363359,76,115701,5982,411,451,1479060,2011
NH,solid waste management,0,0,0,0,0,0,0,0,2011
NH,sewerage,0,0,0,0,0,0,0,0,2011
NH,parks and recreation,74,282769,248,207459,19864,194,322,490228,2011
NH,housing and community development,0,0,0,0,0,0,0,0,2011
NH,natural resources,347,1647460,84,81206,5753,381,431,1728666,2011
NH,water transport and terminals,28,141209,3,10678,263,30,31,151887,2011
NH,electric power,0,0,0,0,0,0,0,0,2011
NH,gas supply,0,0,0,0,0,0,0,0,2011
NH,transit,0,0,0,0,0,0,0,0,2011
NH,education - elementary and secondary instructional,0,0,0,0,0,0,0,0,2011
NH,education - elementary and secondary other,0,0,0,0,0,0,0,0,2011
NH,education - higher education instructional,1488,11178420,2711,5289337,155416,2438,4199,16467757,2011
NH,education - higher education other,2654,12484144,5845,4666321,297360,4460,8499,17150465,2011
NH,education - other,311,1342062,24,41803,2262,324,335,1383865,2011
NH,libraries,0,0,0,0,0,0,0,0,2011
NH,liquor stores,293,1153647,505,440898,41439,543,798,1594545,2011
NH,other and unallocable,1693,7300696,387,384486,28786,1864,2080,7685182,2011
NJ,total,134410,797041595,37287,50763803,1985593,146801,171697,847805398,2011
NJ,financial administration,5371,27939784,437,826336,48856,5686,5808,28766120,2011
NJ,other government administration,1153,6858828,33,50148,2517,1169,1186,6908976,2011
NJ,judicial and legal,13040,79969116,186,314503,15042,13137,13226,80283619,2011
NJ,police protection - officers,2846,23258393,0,0,0,2846,2846,23258393,2011
NJ,police protection - other,1284,6354443,35,78256,2586,1301,1319,6432699,2011
NJ,corrections,9175,55687205,10,23333,764,9180,9185,55710538,2011
NJ,highways,5673,29298804,504,714560,39507,5897,6177,30013364,2011
NJ,air transportation,0,0,0,0,0,0,0,0,2011
NJ,water transport and terminals,79,414656,3,3313,213,80,82,417969,2011
NJ,public welfare,8804,48392711,193,347858,15973,8908,8997,48740569,2011
NJ,health,4242,24849588,633,1834451,27416,4419,4875,26684039,2011
NJ,hospitals,16167,76116138,2286,4800025,229251,17646,18453,80916163,2011
NJ,social insurance administration,1684,8417942,241,636873,31873,1890,1925,9054815,2011
NJ,solid waste management,548,3918707,6,6755,618,552,554,3925462,2011
NJ,sewerage,0,0,0,0,0,0,0,0,2011
NJ,parks and recreation,1388,6822876,2362,1366675,101550,1969,3750,8189551,2011
NJ,housing and community development,0,0,0,0,0,0,0,0,2011
NJ,natural resources,1827,11036000,327,487839,23167,1971,2154,11523839,2011
NJ,water transport and terminals,114,627698,0,0,0,114,114,627698,2011
NJ,electric power,0,0,0,0,0,0,0,0,2011
NJ,gas supply,0,0,0,0,0,0,0,0,2011
NJ,transit,11111,53039114,1007,1653165,84431,11588,12118,54692279,2011
NJ,education - elementary and secondary instructional,10517,79068908,810,1743397,49782,10857,11327,80812305,2011
NJ,education - elementary and secondary other,4427,18161867,2155,3188673,101116,5074,6582,21350540,2011
NJ,education - higher education instructional,7742,83572295,8605,17669504,331986,9822,16347,101241799,2011
NJ,education - higher education other,18558,99971237,16787,14106933,818733,23645,35345,114078170,2011
NJ,education - other,2502,15165698,544,691023,50526,2828,3046,15856721,2011
NJ,libraries,0,0,0,0,0,0,0,0,2011
NJ,liquor stores,0,0,0,0,0,0,0,0,2011
NJ,other and unallocable,6158,38099587,123,220183,9686,6222,6281,38319770,2011
NM,total,41240,163335726,13776,15059833,982400,46794,55016,178395559,2011
NM,financial administration,952,3883937,9,12702,1018,958,961,3896639,2011
NM,other government administration,188,936579,8,32782,883,193,196,969361,2011
NM,judicial and legal,3094,13060751,118,177406,10577,3156,3212,13238157,2011
NM,police protection - officers,504,2800210,0,0,0,504,504,2800210,2011
NM,police protection - other,0,0,0,0,0,0,0,0,2011
NM,corrections,3748,12724027,39,81810,4455,3773,3787,12805837,2011
NM,highways,2059,7256598,0,0,0,2059,2059,7256598,2011
NM,air transportation,3,13764,0,0,0,3,3,13764,2011
NM,water transport and terminals,0,0,0,0,0,0,0,0,2011
NM,public welfare,1714,5807971,4,10846,704,1718,1718,5818817,2011
NM,health,2298,9075427,75,226296,12217,2368,2373,9301723,2011
NM,hospitals,6769,27801736,1042,2274622,126868,7486,7811,30076358,2011
NM,social insurance administration,714,2490427,2,1320,173,715,716,2491747,2011
NM,solid waste management,0,0,0,0,0,0,0,0,2011
NM,sewerage,0,0,0,0,0,0,0,0,2011
NM,parks and recreation,653,2386852,27,51785,3963,675,680,2438637,2011
NM,housing and community development,0,0,0,0,0,0,0,0,2011
NM,natural resources,966,3825035,31,44178,2779,982,997,3869213,2011
NM,water transport and terminals,0,0,0,0,0,0,0,0,2011
NM,electric power,0,0,0,0,0,0,0,0,2011
NM,gas supply,0,0,0,0,0,0,0,0,2011
NM,transit,0,0,0,0,0,0,0,0,2011
NM,education - elementary and secondary instructional,0,0,0,0,0,0,0,0,2011
NM,education - elementary and secondary other,0,0,0,0,0,0,0,0,2011
NM,education - higher education instructional,3398,16157932,3780,5312046,199846,4526,7178,21469978,2011
NM,education - higher education other,10990,42447078,8552,6723060,612212,14449,19542,49170138,2011
NM,education - other,903,3588620,72,79895,4965,931,975,3668515,2011
NM,libraries,0,0,0,0,0,0,0,0,2011
NM,liquor stores,0,0,0,0,0,0,0,0,2011
NM,other and unallocable,2287,9078782,17,31085,1740,2298,2304,9109867,2011
NY,total,226662,1287164706,52343,78270149,2857982,243647,279005,1365434855,2011
NY,financial administration,12249,63809418,144,355056,11718,12316,12393,64164474,2011
NY,other government administration,4033,17190292,526,634205,38387,4251,4559,17824497,2011
NY,judicial and legal,18965,130554261,668,2386168,78230,19411,19633,132940429,2011
NY,police protection - officers,4651,42982012,0,0,0,4651,4651,42982012,2011
NY,police protection - other,1380,6720960,121,184123,19291,1489,1501,6905083,2011
NY,corrections,31567,171999653,404,1276166,40802,31800,31971,173275819,2011
NY,highways,10996,60052744,1025,1215269,82388,11463,12021,61268013,2011
NY,air transportation,178,806182,0,0,0,178,178,806182,2011
NY,water transport and terminals,625,3720568,28,33049,1754,635,653,3753617,2011
NY,public welfare,4408,22021949,436,1141698,54841,4717,4844,23163647,2011
NY,health,8834,51577999,393,1345194,41207,9070,9227,52923193,2011
NY,hospitals,40617,209026295,5255,16517034,558211,43779,45872,225543329,2011
NY,social insurance administration,8598,45213111,72,231580,9303,8651,8670,45444691,2011
NY,solid waste management,0,0,0,0,0,0,0,0,2011
NY,sewerage,0,0,0,0,0,0,0,0,2011
NY,parks and recreation,2004,9772541,413,890237,57027,2326,2417,10662778,2011
NY,housing and community development,0,0,0,0,0,0,0,0,2011
NY,natural resources,3052,16403876,68,113508,4126,3076,3120,16517384,2011
NY,water transport and terminals,0,0,0,0,0,0,0,0,2011
NY,electric power,1666,13098582,20,63650,2019,1677,1686,13162232,2011
NY,gas supply,0,0,0,0,0,0,0,0,2011
NY,transit,15579,109256118,248,498304,31291,15756,15827,109754422,2011
NY,education - elementary and secondary instructional,0,0,0,0,0,0,0,0,2011
NY,education - elementary and secondary other,0,0,0,0,0,0,0,0,2011
NY,education - higher education instructional,14716,106922139,21438,29765694,743002,19276,36154,136687833,2011
NY,education - higher education other,26625,114771970,20485,19829652,1032482,32903,47110,134601622,2011
NY,education - other,3938,20608401,150,364338,14653,4021,4088,20972739,2011
NY,libraries,0,0,0,0,0,0,0,0,2011
NY,liquor stores,0,0,0,0,0,0,0,0,2011
NY,other and unallocable,11981,70655635,449,1425224,37250,12201,12430,72080859,2011
NC,total,135171,535727977,43317,52800681,3397271,154364,178488,588528658,2011
NC,financial administration,4970,21536496,125,89257,1510,4978,5095,21625753,2011
NC,other government administration,743,4057311,418,834234,39266,964,1161,4891545,2011
NC,judicial and legal,6517,30573197,459,369891,5177,6546,6976,30943088,2011
NC,police protection - officers,2223,10520315,0,0,0,2223,2223,10520315,2011
NC,police protection - other,1198,4783277,7,12201,129,1199,1205,4795478,2011
NC,corrections,21169,66465853,49,81393,946,21175,21218,66547246,2011
NC,highways,10956,36494060,80,45858,5000,10984,11036,36539918,2011
NC,air transportation,0,0,0,0,0,0,0,0,2011
NC,water transport and terminals,238,1038818,0,0,0,238,238,1038818,2011
NC,public welfare,1251,4476734,54,69442,2438,1265,1305,4546176,2011
NC,health,2697,10711955,168,315229,13890,2775,2865,11027184,2011
NC,hospitals,19508,77266168,1933,4509925,94281,20040,21441,81776093,2011
NC,social insurance administration,2323,8569915,52,54788,855,2328,2375,8624703,2011
NC,solid waste management,305,1506996,0,0,0,305,305,1506996,2011
NC,sewerage,0,0,0,0,0,0,0,0,2011
NC,parks and recreation,1507,4867179,349,402698,43274,1752,1856,5269877,2011
NC,housing and community development,0,0,0,0,0,0,0,0,2011
NC,natural resources,4432,17902706,283,519126,39353,4655,4715,18421832,2011
NC,water transport and terminals,0,0,0,0,0,0,0,0,2011
NC,electric power,0,0,0,0,0,0,0,0,2011
NC,gas supply,0,0,0,0,0,0,0,0,2011
NC,transit,0,0,0,0,0,0,0,0,2011
NC,education - elementary and secondary instructional,0,0,0,0,0,0,0,0,2011
NC,education - elementary and secondary other,0,0,0,0,0,0,0,0,2011
NC,education - higher education instructional,15356,94303394,13709,23699830,1107439,21612,29065,118003224,2011
NC,education - higher education other,32561,108522463,25170,21261102,2012458,43931,57731,129783565,2011
NC,education - other,2895,12307090,195,153289,1543,2904,3090,12460379,2011
NC,libraries,0,0,0,0,0,0,0,0,2011
NC,liquor stores,0,0,0,0,0,0,0,0,2011
NC,other and unallocable,4322,19824050,266,382418,29712,4490,4588,20206468,2011
ND,total,15843,67415860,8917,8457621,486296,18592,24760,75873481,2011
ND,financial administration,622,2450317,41,44037,2251,635,663,2494354,2011
ND,other government administration,203,815557,240,991665,28703,365,443,1807222,2011
ND,judicial and legal,561,2747953,46,33326,1875,571,607,2781279,2011
ND,police protection - officers,135,734416,0,0,0,135,135,734416,2011
ND,police protection - other,50,166810,4,3023,232,51,54,169833,2011
ND,corrections,734,2582356,85,173864,6610,772,819,2756220,2011
ND,highways,1092,4821305,8,10961,651,1096,1100,4832266,2011
ND,air transportation,0,0,0,0,0,0,0,0,2011
ND,water transport and terminals,0,0,0,0,0,0,0,0,2011
ND,public welfare,481,1553960,92,131626,8421,529,573,1685586,2011
ND,health,1257,4540414,266,272833,20870,1375,1523,4813247,2011
ND,hospitals,877,2536287,146,203844,7751,921,1023,2740131,2011
ND,social insurance administration,348,1300346,117,114660,6229,383,465,1415006,2011
ND,solid waste management,0,0,0,0,0,0,0,0,2011
ND,sewerage,0,0,0,0,0,0,0,0,2011
ND,parks and recreation,169,479991,12,21926,1319,177,181,501917,2011
ND,housing and community development,0,0,0,0,0,0,0,0,2011
ND,natural resources,605,2532827,592,368079,32425,789,1197,2900906,2011
ND,water transport and terminals,0,0,0,0,0,0,0,0,2011
ND,electric power,0,0,0,0,0,0,0,0,2011
ND,gas supply,0,0,0,0,0,0,0,0,2011
ND,transit,0,0,0,0,0,0,0,0,2011
ND,education - elementary and secondary instructional,0,0,0,0,0,0,0,0,2011
ND,education - elementary and secondary other,0,0,0,0,0,0,0,0,2011
ND,education - higher education instructional,2134,14518283,2546,3379469,135540,2900,4680,17897752,2011
ND,education - higher education other,4879,18319849,4552,2510338,222718,6137,9431,20830187,2011
ND,education - other,257,958994,41,60773,2835,273,298,1019767,2011
ND,libraries,0,0,0,0,0,0,0,0,2011
ND,liquor stores,0,0,0,0,0,0,0,0,2011
ND,other and unallocable,1439,6356195,129,137197,7866,1483,1568,6493392,2011
OH,total,113917,575118974,72171,78297099,4364766,139049,186088,653416073,2011
OH,financial administration,6795,35348680,388,575429,30712,7006,7183,35924109,2011
OH,other government administration,837,3888780,153,118744,10403,910,990,4007524,2011
OH,judicial and legal,2585,15110124,567,1376748,38738,2857,3152,16486872,2011
OH,police protection - officers,1382,7973352,0,0,0,1382,1382,7973352,2011
OH,police protection - other,1131,4682761,11,31977,1718,1141,1142,4714738,2011
OH,corrections,15202,64546982,86,262545,8409,15261,15288,64809527,2011
OH,highways,6443,30046413,652,1406404,86142,6930,7095,31452817,2011
OH,air transportation,0,0,0,0,0,0,0,0,2011
OH,water transport and terminals,0,0,0,0,0,0,0,0,2011
OH,public welfare,2532,13904214,337,609665,46587,2795,2869,14513879,2011
OH,health,3341,18330542,258,541758,27940,3519,3599,18872300,2011
OH,hospitals,14209,70887429,3192,6079698,239265,15759,17401,76967127,2011
OH,social insurance administration,1899,8336073,357,888261,46838,2163,2256,9224334,2011
OH,solid waste management,0,0,0,0,0,0,0,0,2011
OH,sewerage,0,0,0,0,0,0,0,0,2011
OH,parks and recreation,398,1710215,815,359115,22279,555,1213,2069330,2011
OH,housing and community development,0,0,0,0,0,0,0,0,2011
OH,natural resources,2548,10846897,302,276077,17914,2669,2850,11122974,2011
OH,water transport and terminals,0,0,0,0,0,0,0,0,2011
OH,electric power,0,0,0,0,0,0,0,0,2011
OH,gas supply,0,0,0,0,0,0,0,0,2011
OH,transit,0,0,0,0,0,0,0,0,2011
OH,education - elementary and secondary instructional,0,0,0,0,0,0,0,0,2011
OH,education - elementary and secondary other,0,0,0,0,0,0,0,0,2011
OH,education - higher education instructional,15849,115826084,19715,27785197,1049470,21797,35564,143611281,2011
OH,education - higher education other,31911,138432122,44511,37070606,2694556,47147,76422,175502728,2011
OH,education - other,2182,11083419,281,366941,17331,2304,2463,11450360,2011
OH,libraries,0,0,0,0,0,0,0,0,2011
OH,liquor stores,0,0,0,0,0,0,0,0,2011
OH,other and unallocable,4673,24164887,546,547934,26464,4854,5219,24712821,2011
OK,total,59833,234154668,27060,27135937,1503730,68339,86893,261290605,2011
OK,financial administration,1505,5750563,25,19327,1260,1512,1530,5769890,2011
OK,other government administration,661,2490193,114,222478,14526,743,775,2712671,2011
OK,judicial and legal,2728,11954270,102,128351,8143,2774,2830,12082621,2011
OK,police protection - officers,979,5103256,4,6350,288,981,983,5109606,2011
OK,police protection - other,870,3000883,67,73241,5996,904,937,3074124,2011
OK,corrections,4843,15216353,48,112770,3776,4864,4891,15329123,2011
OK,highways,2956,9977920,0,0,0,2956,2956,9977920,2011
OK,air transportation,9,40832,0,0,0,9,9,40832,2011
OK,water transport and terminals,0,0,0,0,0,0,0,0,2011
OK,public welfare,6295,18337125,5,14148,449,6298,6300,18351273,2011
OK,health,5124,19143088,275,580070,25861,5270,5399,19723158,2011
OK,hospitals,1874,6257533,60,120701,6183,1908,1934,6378234,2011
OK,social insurance administration,1420,4913433,123,189701,13448,1496,1543,5103134,2011
OK,solid waste management,77,356931,12,10950,985,83,89,367881,2011
OK,sewerage,0,0,0,0,0,0,0,0,2011
OK,parks and recreation,627,1686882,246,234561,23669,761,873,1921443,2011
OK,housing and community development,0,0,0,0,0,0,0,0,2011
OK,natural resources,1680,5791726,885,775297,47200,1946,2565,6567023,2011
OK,water transport and terminals,0,0,0,0,0,0,0,0,2011
OK,electric power,538,3011952,7,19488,933,543,545,3031440,2011
OK,gas supply,0,0,0,0,0,0,0,0,2011
OK,transit,0,0,0,0,0,0,0,0,2011
OK,education - elementary and secondary instructional,0,0,0,0,0,0,0,0,2011
OK,education - elementary and secondary other,0,0,0,0,0,0,0,0,2011
OK,education - higher education instructional,6434,42274943,7313,10409044,362036,8484,13747,52683987,2011
OK,education - higher education other,16267,60906315,17529,13916170,975067,21786,33796,74822485,2011
OK,education - other,1801,6319480,58,52727,3369,1818,1859,6372207,2011
OK,libraries,0,0,0,0,0,0,0,0,2011
OK,liquor stores,0,0,0,0,0,0,0,0,2011
OK,other and unallocable,3145,11620990,187,250563,10541,3203,3332,11871553,2011
OR,total,58091,268522511,24557,32189791,1320263,65542,82648,300712302,2011
OR,financial administration,3951,16437301,206,302588,18615,4055,4157,16739889,2011
OR,other government administration,987,4441803,202,361136,17779,1086,1189,4802939,2011
OR,judicial and legal,2956,13608885,168,526805,19118,3063,3124,14135690,2011
OR,police protection - officers,693,3951424,11,16082,748,697,704,3967506,2011
OR,police protection - other,608,2551926,138,143807,5996,642,746,2695733,2011
OR,corrections,5094,22057487,102,191782,7447,5136,5196,22249269,2011
OR,highways,3715,17537070,301,729941,34779,3911,4016,18267011,2011
OR,air transportation,14,52104,0,0,0,14,14,52104,2011
OR,water transport and terminals,0,0,0,0,0,0,0,0,2011
OR,public welfare,7450,27617128,301,557696,24291,7587,7751,28174824,2011
OR,health,1570,6503739,130,298136,11854,1636,1700,6801875,2011
OR,hospitals,5375,27693715,3313,9730984,201463,6513,8688,37424699,2011
OR,social insurance administration,2158,10971671,81,272498,8673,2207,2239,11244169,2011
OR,solid waste management,0,0,0,0,0,0,0,0,2011
OR,sewerage,0,0,0,0,0,0,0,0,2011
OR,parks and recreation,446,1681214,25,46378,2454,460,471,1727592,2011
OR,housing and community development,0,0,0,0,0,0,0,0,2011
OR,natural resources,2389,9528327,294,445309,24487,2526,2683,9973636,2011
OR,water transport and terminals,0,0,0,0,0,0,0,0,2011
OR,electric power,0,0,0,0,0,0,0,0,2011
OR,gas supply,0,0,0,0,0,0,0,0,2011
OR,transit,0,0,0,0,0,0,0,0,2011
OR,education - elementary and secondary instructional,0,0,0,0,0,0,0,0,2011
OR,education - elementary and secondary other,0,0,0,0,0,0,0,0,2011
OR,education - higher education instructional,10079,62773625,3428,6346776,196800,11191,13507,69120401,2011
OR,education - higher education other,8157,30447817,15647,11983212,734638,12308,23804,42431029,2011
OR,education - other,660,2914766,54,53053,2497,674,714,2967819,2011
OR,libraries,0,0,0,0,0,0,0,0,2011
OR,liquor stores,211,902058,11,15180,1107,217,222,917238,2011
OR,other and unallocable,1578,6850451,145,168428,7517,1619,1723,7018879,2011
PA,total,142206,666474607,66664,110254029,4458987,168548,208870,776728636,2011
PA,financial administration,6678,28750328,1169,2540582,130203,7464,7847,31290910,2011
PA,other government administration,3001,12301709,566,2443214,61897,3381,3567,14744923,2011
PA,judicial and legal,2928,21258193,117,807087,12409,3008,3045,22065280,2011
PA,police protection - officers,5065,29853806,6,11909,682,5069,5071,29865715,2011
PA,police protection - other,1335,7883768,287,785038,35845,1551,1622,8668806,2011
PA,corrections,18259,80620120,768,2663130,67538,18666,19027,83283250,2011
PA,highways,12517,48472242,3593,8049960,370114,14739,16110,56522202,2011
PA,air transportation,40,187426,39,86009,2409,55,79,273435,2011
PA,water transport and terminals,185,823763,49,6376,542,188,234,830139,2011
PA,public welfare,11053,42827333,1663,3495124,119035,11771,12716,46322457,2011
PA,health,1762,8448463,302,586491,15844,1858,2064,9034954,2011
PA,hospitals,10962,37768572,1713,2973571,101215,11562,12675,40742143,2011
PA,social insurance administration,3859,15882851,1207,2783281,87840,4388,5066,18666132,2011
PA,solid waste management,0,0,0,0,0,0,0,0,2011
PA,sewerage,0,0,0,0,0,0,0,0,2011
PA,parks and recreation,1589,6632750,1445,3549576,149939,2492,3034,10182326,2011
PA,housing and community development,0,0,0,0,0,0,0,0,2011
PA,natural resources,5261,24252211,2712,5287248,183842,6333,7973,29539459,2011
PA,water transport and terminals,0,0,0,0,0,0,0,0,2011
PA,electric power,0,0,0,0,0,0,0,0,2011
PA,gas supply,0,0,0,0,0,0,0,0,2011
PA,transit,0,0,0,0,0,0,0,0,2011
PA,education - elementary and secondary instructional,0,0,0,0,0,0,0,0,2011
PA,education - elementary and secondary other,0,0,0,0,0,0,0,0,2011
PA,education - higher education instructional,14953,123142461,12321,35232724,713631,19042,27274,158375185,2011
PA,education - higher education other,29672,122620973,34917,32031551,2070381,41875,64589,154652524,2011
PA,education - other,4033,16739299,499,972812,31534,4220,4532,17712111,2011
PA,libraries,0,0,0,0,0,0,0,0,2011
PA,liquor stores,3112,10769427,2296,4565585,248265,4608,5408,15335012,2011
PA,other and unallocable,5942,27238912,995,1382761,55822,6278,6937,28621673,2011
RI,total,17056,93517744,6727,6774656,286224,18900,23783,100292400,2011
RI,financial administration,843,4378085,4,15392,492,846,847,4393477,2011
RI,other government administration,537,2763468,387,236367,5576,573,924,2999835,2011
RI,judicial and legal,1148,6582894,16,43680,1628,1159,1164,6626574,2011
RI,police protection - officers,226,1648392,0,0,0,226,226,1648392,2011
RI,police protection - other,77,425675,2,4982,120,78,79,430657,2011
RI,corrections,1538,10227766,1,4776,77,1538,1539,10232542,2011
RI,highways,736,3693649,43,47880,2712,752,779,3741529,2011
RI,air transportation,153,940115,3,4131,146,154,156,944246,2011
RI,water transport and terminals,0,0,0,0,0,0,0,0,2011
RI,public welfare,1250,6931144,16,62811,2464,1266,1266,6993955,2011
RI,health,946,5340759,81,55711,2876,965,1027,5396470,2011
RI,hospitals,772,4202803,2,10443,283,774,774,4213246,2011
RI,social insurance administration,447,2068965,26,90453,3230,468,473,2159418,2011
RI,solid waste management,97,553625,3,2214,58,97,100,555839,2011
RI,sewerage,248,1132120,0,0,0,248,248,1132120,2011
RI,parks and recreation,55,198941,0,0,0,55,55,198941,2011
RI,housing and community development,0,0,0,0,0,0,0,0,2011
RI,natural resources,407,2275339,29,48112,1778,418,436,2323451,2011
RI,water transport and terminals,0,0,0,0,0,0,0,0,2011
RI,electric power,0,0,0,0,0,0,0,0,2011
RI,gas supply,0,0,0,0,0,0,0,0,2011
RI,transit,709,3596193,46,123565,7312,750,755,3719758,2011
RI,education - elementary and secondary instructional,425,2334656,48,73372,1864,439,473,2408028,2011
RI,education - elementary and secondary other,161,346327,66,40257,3332,186,227,386584,2011
RI,education - higher education instructional,1837,11641500,2629,3869790,106637,2525,4466,15511290,2011
RI,education - higher education other,2256,10070067,3281,1945403,141887,3171,5537,12015470,2011
RI,education - other,489,2849987,15,44598,1498,498,504,2894585,2011
RI,libraries,0,0,0,0,0,0,0,0,2011
RI,liquor stores,0,0,0,0,0,0,0,0,2011
RI,other and unallocable,1699,9315274,29,50719,2254,1714,1728,9365993,2011
SC,total,70147,266510201,19938,20973986,1207383,77342,90085,287484187,2011
SC,financial administration,3396,11247710,126,254284,14406,3483,3522,11501994,2011
SC,other government administration,633,2384916,514,595202,35211,844,1147,2980118,2011
SC,judicial and legal,754,3651798,26,43082,2366,768,780,3694880,2011
SC,police protection - officers,1306,4842774,1,3798,50,1306,1307,4846572,2011
SC,police protection - other,624,2012184,1,2828,60,624,625,2015012,2011
SC,corrections,7450,21095364,14,22944,1266,7458,7464,21118308,2011
SC,highways,4627,14442976,7,13916,410,4629,4634,14456892,2011
SC,air transportation,11,51128,0,0,0,11,11,51128,2011
SC,water transport and terminals,465,2522567,3,1678,55,465,468,2524245,2011
SC,public welfare,4920,13329348,9,24130,944,4926,4929,13353478,2011
SC,health,5682,19008195,410,879843,22261,5816,6092,19888038,2011
SC,hospitals,6830,20327575,150,555073,19177,6941,6980,20882648,2011
SC,social insurance administration,1397,4236360,142,237842,16274,1495,1539,4474202,2011
SC,solid waste management,0,0,0,0,0,0,0,0,2011
SC,sewerage,0,0,0,0,0,0,0,0,2011
SC,parks and recreation,679,1493334,32,24774,2466,694,711,1518108,2011
SC,housing and community development,0,0,0,0,0,0,0,0,2011
SC,natural resources,1866,5876774,201,230328,19535,1983,2067,6107102,2011
SC,water transport and terminals,11,60650,0,0,0,11,11,60650,2011
SC,electric power,1829,11014958,15,43005,1789,1839,1844,11057963,2011
SC,gas supply,0,0,0,0,0,0,0,0,2011
SC,transit,0,0,0,0,0,0,0,0,2011
SC,education - elementary and secondary instructional,0,0,0,0,0,0,0,0,2011
SC,education - elementary and secondary other,0,0,0,0,0,0,0,0,2011
SC,education - higher education instructional,8332,53124417,7862,9341780,406290,10753,16194,62466197,2011
SC,education - higher education other,14799,59928645,10165,8262918,643353,18630,24964,68191563,2011
SC,education - other,2952,10358126,189,329150,15838,3047,3141,10687276,2011
SC,libraries,0,0,0,0,0,0,0,0,2011
SC,liquor stores,0,0,0,0,0,0,0,0,2011
SC,other and unallocable,1584,5500402,71,107411,5632,1619,1655,5607813,2011
SD,total,12594,50009013,6237,5014161,329670,14458,18831,55023174,2011
SD,financial administration,431,1893341,10,17185,1330,438,441,1910526,2011
SD,other government administration,309,1223987,72,68271,4964,337,381,1292258,2011
SD,judicial and legal,577,2491734,88,125310,8117,623,665,2617044,2011
SD,police protection - officers,189,819426,3,9144,320,191,192,828570,2011
SD,police protection - other,126,362884,10,12936,888,131,136,375820,2011
SD,corrections,837,2641081,25,36553,2650,852,862,2677634,2011
SD,highways,951,3631522,58,87426,5511,982,1009,3718948,2011
SD,air transportation,0,0,0,0,0,0,0,0,2011
SD,water transport and terminals,0,0,0,0,0,0,0,0,2011
SD,public welfare,1030,3422149,37,66588,4850,1057,1067,3488737,2011
SD,health,584,2431958,135,391180,18007,687,719,2823138,2011
SD,hospitals,864,2910577,155,234194,15658,953,1019,3144771,2011
SD,social insurance administration,284,869177,6,9737,755,288,290,878914,2011
SD,solid waste management,0,0,0,0,0,0,0,0,2011
SD,sewerage,0,0,0,0,0,0,0,0,2011
SD,parks and recreation,127,427929,25,23962,2409,141,152,451891,2011
SD,housing and community development,0,0,0,0,0,0,0,0,2011
SD,natural resources,967,3908319,330,400965,24182,1104,1297,4309284,2011
SD,water transport and terminals,0,0,0,0,0,0,0,0,2011
SD,electric power,0,0,0,0,0,0,0,0,2011
SD,gas supply,0,0,0,0,0,0,0,0,2011
SD,transit,0,0,0,0,0,0,0,0,2011
SD,education - elementary and secondary instructional,0,0,0,0,0,0,0,0,2011
SD,education - elementary and secondary other,0,0,0,0,0,0,0,0,2011
SD,education - higher education instructional,1456,9370911,1095,1679349,68675,1844,2551,11050260,2011
SD,education - higher education other,2683,9010049,4116,1771887,165000,3616,6799,10781936,2011
SD,education - other,363,1312634,29,27661,2342,376,392,1340295,2011
SD,libraries,0,0,0,0,0,0,0,0,2011
SD,liquor stores,0,0,0,0,0,0,0,0,2011
SD,other and unallocable,816,3281335,43,51813,4012,838,859,3333148,2011
TN,total,76872,285837032,26995,26361823,1584417,86215,103867,312198855,2011
TN,financial administration,3305,13329371,49,92941,6618,3345,3354,13422312,2011
TN,other government administration,826,3306550,7,7169,588,830,833,3313719,2011
TN,judicial and legal,2453,12593910,8,12187,771,2457,2461,12606097,2011
TN,police protection - officers,1074,5030356,0,0,0,1074,1074,5030356,2011
TN,police protection - other,623,2048898,10,32481,1405,632,633,2081379,2011
TN,corrections,6925,19589726,35,77268,4922,6953,6960,19666994,2011
TN,highways,4009,12583398,0,0,0,4009,4009,12583398,2011
TN,air transportation,0,0,0,0,0,0,0,0,2011
TN,water transport and terminals,0,0,0,0,0,0,0,0,2011
TN,public welfare,7798,24689376,0,0,0,7798,7798,24689376,2011
TN,health,9460,31159952,119,362836,15057,9546,9579,31522788,2011
TN,hospitals,3379,12233047,118,478317,20112,3492,3497,12711364,2011
TN,social insurance administration,1332,4198358,307,528638,39958,1573,1639,4726996,2011
TN,solid waste management,0,0,0,0,0,0,0,0,2011
TN,sewerage,0,0,0,0,0,0,0,0,2011
TN,parks and recreation,946,2411732,194,154672,17286,1050,1140,2566404,2011
TN,housing and community development,0,0,0,0,0,0,0,0,2011
TN,natural resources,3463,13362476,555,821987,64890,3841,4018,14184463,2011
TN,water transport and terminals,0,0,0,0,0,0,0,0,2011
TN,electric power,0,0,0,0,0,0,0,0,2011
TN,gas supply,0,0,0,0,0,0,0,0,2011
TN,transit,0,0,0,0,0,0,0,0,2011
TN,education - elementary and secondary instructional,0,0,0,0,0,0,0,0,2011
TN,education - elementary and secondary other,0,0,0,0,0,0,0,0,2011
TN,education - higher education instructional,8435,50014387,10529,12876554,596218,11984,18964,62890941,2011
TN,education - higher education other,18068,62117898,14770,10565421,798965,22748,32838,72683319,2011
TN,education - other,2054,7368588,245,280450,14707,2142,2299,7649038,2011
TN,libraries,0,0,0,0,0,0,0,0,2011
TN,liquor stores,0,0,0,0,0,0,0,0,2011
TN,other and unallocable,2722,9799009,49,70902,2920,2741,2771,9869911,2011
TX,total,284729,1250543845,78804,114428182,5953504,318370,363533,1364972027,2011
TX,financial administration,6710,29741263,131,156630,6505,6747,6841,29897893,2011
TX,other government administration,2313,9789101,478,494018,29048,2477,2791,10283119,2011
TX,judicial and legal,5537,27758336,208,1182558,29903,5706,5745,28940894,2011
TX,police protection - officers,3541,20193198,0,0,0,3541,3541,20193198,2011
TX,police protection - other,3015,10285236,91,98532,8352,3062,3106,10383768,2011
TX,corrections,43112,127175835,627,862572,51594,43403,43739,128038407,2011
TX,highways,13228,55092737,558,1217525,30777,13403,13786,56310262,2011
TX,air transportation,0,0,0,0,0,0,0,0,2011
TX,water transport and terminals,0,0,0,0,0,0,0,0,2011
TX,public welfare,22917,70728229,247,429663,23413,23049,23164,71157892,2011
TX,health,29593,106552708,778,2037083,61093,29938,30371,108589791,2011
TX,hospitals,23888,105419533,2271,9621225,271209,25421,26159,115040758,2011
TX,social insurance administration,4617,16067939,37,66379,3551,4637,4654,16134318,2011
TX,solid waste management,0,0,0,0,0,0,0,0,2011
TX,sewerage,0,0,0,0,0,0,0,0,2011
TX,parks and recreation,1136,3475234,157,175130,16511,1229,1293,3650364,2011
TX,housing and community development,0,0,0,0,0,0,0,0,2011
TX,natural resources,10372,45378055,1492,3459449,130981,11111,11864,48837504,2011
TX,water transport and terminals,0,0,0,0,0,0,0,0,2011
TX,electric power,0,0,0,0,0,0,0,0,2011
TX,gas supply,0,0,0,0,0,0,0,0,2011
TX,transit,0,0,0,0,0,0,0,0,2011
TX,education - elementary and secondary instructional,0,0,0,0,0,0,0,0,2011
TX,education - elementary and secondary other,0,0,0,0,0,0,0,0,2011
TX,education - higher education instructional,25401,247149641,26647,48417805,2111902,37334,52048,295567446,2011
TX,education - higher education other,77103,322494496,44519,44797706,3121641,94742,121622,367292202,2011
TX,education - other,4631,20453262,322,951125,36352,4836,4953,21404387,2011
TX,libraries,0,0,0,0,0,0,0,0,2011
TX,liquor stores,0,0,0,0,0,0,0,0,2011
TX,other and unallocable,7615,32789042,241,460782,20672,7734,7856,33249824,2011
UT,total,44529,197597973,25727,29035801,1588034,53501,70256,226633774,2011
UT,financial administration,2345,10558183,200,154701,11676,2411,2545,10712884,2011
UT,other government administration,326,1695537,70,68636,1725,336,396,1764173,2011
UT,judicial and legal,1587,7247613,68,228786,6488,1624,1655,7476399,2011
UT,police protection - officers,426,1891834,0,0,0,426,426,1891834,2011
UT,police protection - other,357,1265583,81,87907,5643,388,438,1353490,2011
UT,corrections,2994,10626158,215,172482,13162,3068,3209,10798640,2011
UT,highways,1600,6740182,4,4968,363,1602,1604,6745150,2011
UT,air transportation,0,0,0,0,0,0,0,0,2011
UT,water transport and terminals,0,0,0,0,0,0,0,0,2011
UT,public welfare,2788,9798916,142,226707,13016,2862,2930,10025623,2011
UT,health,1684,6730867,212,287622,14195,1764,1896,7018489,2011
UT,hospitals,6610,25575414,1193,1797469,73991,7028,7803,27372883,2011
UT,social insurance administration,878,3070462,0,0,0,878,878,3070462,2011
UT,solid waste management,0,0,0,0,0,0,0,0,2011
UT,sewerage,0,0,0,0,0,0,0,0,2011
UT,parks and recreation,274,892375,61,60464,5256,304,335,952839,2011
UT,housing and community development,0,0,0,0,0,0,0,0,2011
UT,natural resources,1259,4698826,164,170784,13698,1336,1423,4869610,2011
UT,water transport and terminals,0,0,0,0,0,0,0,0,2011
UT,electric power,0,0,0,0,0,0,0,0,2011
UT,gas supply,0,0,0,0,0,0,0,0,2011
UT,transit,0,0,0,0,0,0,0,0,2011
UT,education - elementary and secondary instructional,0,0,0,0,0,0,0,0,2011
UT,education - elementary and secondary other,0,0,0,0,0,0,0,0,2011
UT,education - higher education instructional,6785,50453218,8635,12924644,487730,9540,15420,63377862,2011
UT,education - higher education other,11927,45694146,13863,12014343,886352,16936,25790,57708489,2011
UT,education - other,903,4016924,435,617686,36662,1110,1338,4634610,2011
UT,libraries,0,0,0,0,0,0,0,0,2011
UT,liquor stores,263,727131,310,181780,16946,359,573,908911,2011
UT,other and unallocable,1523,5914604,74,36822,1131,1529,1597,5951426,2011
VT,total,13236,61000379,2610,5639131,197477,14419,15846,66639510,2011
VT,financial administration,574,2559087,12,8137,514,577,586,2567224,2011
VT,other government administration,465,1827404,216,499750,1730,474,681,2327154,2011
VT,judicial and legal,666,2855233,18,11460,569,669,684,2866693,2011
VT,police protection - officers,308,1855024,17,10007,680,312,325,1865031,2011
VT,police protection - other,115,475481,34,45595,4244,139,149,521076,2011
VT,corrections,1058,4360854,4,2590,155,1059,1062,4363444,2011
VT,highways,1010,4599209,2,434,35,1010,1012,4599643,2011
VT,air transportation,0,0,0,0,0,0,0,0,2011
VT,water transport and terminals,0,0,0,0,0,0,0,0,2011
VT,public welfare,1313,5528009,31,25840,1023,1319,1344,5553849,2011
VT,health,456,1992542,2,2123,80,456,458,1994665,2011
VT,hospitals,285,1264976,12,23953,496,288,297,1288929,2011
VT,social insurance administration,278,1095908,2,695,40,278,280,1096603,2011
VT,solid waste management,0,0,0,0,0,0,0,0,2011
VT,sewerage,0,0,0,0,0,0,0,0,2011
VT,parks and recreation,108,461550,2,848,53,108,110,462398,2011
VT,housing and community development,0,0,0,0,0,0,0,0,2011
VT,natural resources,554,2634131,7,10283,336,556,561,2644414,2011
VT,water transport and terminals,0,0,0,0,0,0,0,0,2011
VT,electric power,0,0,0,0,0,0,0,0,2011
VT,gas supply,0,0,0,0,0,0,0,0,2011
VT,transit,0,0,0,0,0,0,0,0,2011
VT,education - elementary and secondary instructional,0,0,0,0,0,0,0,0,2011
VT,education - elementary and secondary other,0,0,0,0,0,0,0,0,2011
VT,education - higher education instructional,1057,8802197,1149,2076072,59485,1415,2206,10878269,2011
VT,education - higher education other,3349,13392857,990,2784259,121438,4081,4339,16177116,2011
VT,education - other,479,2161827,29,55127,2548,495,508,2216954,2011
VT,libraries,0,0,0,0,0,0,0,0,2011
VT,liquor stores,54,230218,0,0,0,54,54,230218,2011
VT,other and unallocable,1107,4903872,83,81958,4051,1129,1190,4985830,2011
VA,total,105953,463376208,54075,68024828,3357897,124930,160028,531401036,2011
VA,financial administration,3901,16171520,506,782792,56838,4223,4407,16954312,2011
VA,other government administration,498,2450874,246,572284,25469,644,744,3023158,2011
VA,judicial and legal,3553,16681890,346,426162,14718,3635,3899,17108052,2011
VA,police protection - officers,2113,10639006,30,67028,2846,2129,2143,10706034,2011
VA,police protection - other,731,2530556,117,230680,13102,805,848,2761236,2011
VA,corrections,13754,42570398,294,485574,31048,13929,14048,43055972,2011
VA,highways,6971,28585918,244,192731,10136,7028,7215,28778649,2011
VA,air transportation,0,0,0,0,0,0,0,0,2011
VA,water transport and terminals,125,662535,2,3611,255,126,127,666146,2011
VA,public welfare,2594,10207648,318,583532,32652,2779,2912,10791180,2011
VA,health,5035,19693392,746,1256996,74706,5457,5781,20950388,2011
VA,hospitals,13636,52422458,2377,4626065,171166,14606,16013,57048523,2011
VA,social insurance administration,1310,4845718,899,1571428,75861,1738,2209,6417146,2011
VA,solid waste management,0,0,0,0,0,0,0,0,2011
VA,sewerage,0,0,0,0,0,0,0,0,2011
VA,parks and recreation,711,2523292,876,852224,72686,1121,1587,3375516,2011
VA,housing and community development,0,0,0,0,0,0,0,0,2011
VA,natural resources,2363,11659396,773,1045668,69493,2757,3136,12705064,2011
VA,water transport and terminals,0,0,0,0,0,0,0,0,2011
VA,electric power,0,0,0,0,0,0,0,0,2011
VA,gas supply,0,0,0,0,0,0,0,0,2011
VA,transit,0,0,0,0,0,0,0,0,2011
VA,education - elementary and secondary instructional,0,0,0,0,0,0,0,0,2011
VA,education - elementary and secondary other,0,0,0,0,0,0,0,0,2011
VA,education - higher education instructional,14400,107668678,15479,28381220,788920,18857,29879,136049898,2011
VA,education - higher education other,27278,102657898,28230,23248226,1657590,36642,55508,125906124,2011
VA,education - other,2521,11307216,616,1104358,55124,2832,3137,12411574,2011
VA,libraries,0,0,0,0,0,0,0,0,2011
VA,liquor stores,844,2885232,1466,1753210,160022,1748,2310,4638442,2011
VA,other and unallocable,3615,17212583,510,841039,45265,3874,4125,18053622,2011
WA,total,100371,510451127,54414,80178800,3664844,121136,154785,590629927,2011
WA,financial administration,2833,13459778,97,313130,11324,2898,2930,13772908,2011
WA,other government administration,1230,6241953,197,547595,19158,1339,1427,6789548,2011
WA,judicial and legal,1861,10561335,96,362162,11476,1925,1957,10923497,2011
WA,police protection - officers,1057,6810790,0,0,0,1057,1057,6810790,2011
WA,police protection - other,1166,5078522,32,73194,3336,1185,1198,5151716,2011
WA,corrections,8721,40140190,480,1360592,62156,9072,9201,41500782,2011
WA,highways,7257,37803686,325,391982,15382,7344,7582,38195668,2011
WA,air transportation,0,0,0,0,0,0,0,0,2011
WA,water transport and terminals,0,0,0,0,0,0,0,0,2011
WA,public welfare,8915,39288352,809,2021159,84570,9393,9724,41309511,2011
WA,health,4736,30016730,766,760512,29840,4904,5502,30777242,2011
WA,hospitals,8972,46859464,3306,12577268,270807,10502,12278,59436732,2011
WA,social insurance administration,2987,13016592,193,535082,28492,3148,3180,13551674,2011
WA,solid waste management,148,777394,18,58154,1914,159,166,835548,2011
WA,sewerage,0,0,0,0,0,0,0,0,2011
WA,parks and recreation,620,2801228,48,80952,4086,644,668,2882180,2011
WA,housing and community development,0,0,0,0,0,0,0,0,2011
WA,natural resources,4576,19989980,898,1429047,80103,5027,5474,21419027,2011
WA,water transport and terminals,0,0,0,0,0,0,0,0,2011
WA,electric power,0,0,0,0,0,0,0,0,2011
WA,gas supply,0,0,0,0,0,0,0,0,2011
WA,transit,0,0,0,0,0,0,0,0,2011
WA,education - elementary and secondary instructional,0,0,0,0,0,0,0,0,2011
WA,education - elementary and secondary other,0,0,0,0,0,0,0,0,2011
WA,education - higher education instructional,12415,89187576,13238,29496705,645906,16072,25653,118684281,2011
WA,education - higher education other,25729,115143038,32332,27743494,2264341,38570,58061,142886532,2011
WA,education - other,1811,8182515,773,1048926,41499,2050,2584,9231441,2011
WA,libraries,0,0,0,0,0,0,0,0,2011
WA,liquor stores,545,2182244,607,991490,73894,962,1152,3173734,2011
WA,other and unallocable,4792,22909760,199,387356,16560,4885,4991,23297116,2011
WV,total,36210,131021491,12124,10837857,613419,39882,48334,141859348,2011
WV,financial administration,1901,5633300,44,60342,2928,1917,1945,5693642,2011
WV,other government administration,209,761964,323,835210,27385,380,532,1597174,2011
WV,judicial and legal,1517,6505288,46,99834,4868,1545,1563,6605122,2011
WV,police protection - officers,624,3036338,0,0,0,624,624,3036338,2011
WV,police protection - other,398,990406,23,16238,1358,406,421,1006644,2011
WV,corrections,3421,9080348,10,11656,1062,3427,3431,9092004,2011
WV,highways,5175,15772798,25,44980,3790,5196,5200,15817778,2011
WV,air transportation,3,11670,0,0,0,3,3,11670,2011
WV,water transport and terminals,2,5912,0,0,0,2,2,5912,2011
WV,public welfare,3340,8695404,46,64102,4732,3367,3386,8759506,2011
WV,health,751,2413398,63,77180,3750,772,814,2490578,2011
WV,hospitals,1756,4561506,65,85960,5262,1787,1821,4647466,2011
WV,social insurance administration,612,1865292,89,148578,9672,670,701,2013870,2011
WV,solid waste management,10,37350,2,600,12,10,12,37950,2011
WV,sewerage,0,0,0,0,0,0,0,0,2011
WV,parks and recreation,375,788100,365,258144,33958,567,740,1046244,2011
WV,housing and community development,0,0,0,0,0,0,0,0,2011
WV,natural resources,1857,6244394,196,148350,14876,1943,2053,6392744,2011
WV,water transport and terminals,0,0,0,0,0,0,0,0,2011
WV,electric power,0,0,0,0,0,0,0,0,2011
WV,gas supply,0,0,0,0,0,0,0,0,2011
WV,transit,7,25714,0,0,0,7,7,25714,2011
WV,education - elementary and secondary instructional,0,0,0,0,0,0,0,0,2011
WV,education - elementary and secondary other,0,0,0,0,0,0,0,0,2011
WV,education - higher education instructional,3678,23951322,4520,5383198,172177,4715,8198,29334520,2011
WV,education - higher education other,6908,27120469,6011,3253598,315283,8807,12919,30374067,2011
WV,education - other,1277,5411296,190,260660,7196,1319,1467,5671956,2011
WV,libraries,0,0,0,0,0,0,0,0,2011
WV,liquor stores,49,132668,2,3240,270,51,51,135908,2011
WV,other and unallocable,2340,7976554,104,85987,4840,2367,2444,8062541,2011
WI,total,56068,280520376,47421,48137298,2623593,70891,103489,328657674,2011
WI,financial administration,2150,10722589,170,358176,14661,2232,2320,11080765,2011
WI,other government administration,790,3624412,297,685557,26676,941,1087,4309969,2011
WI,judicial and legal,2007,12426945,271,796801,30408,2178,2278,13223746,2011
WI,police protection - officers,586,3818417,0,0,0,586,586,3818417,2011
WI,police protection - other,303,1221476,25,34045,1760,313,328,1255521,2011
WI,corrections,9437,40066662,621,2171109,57776,9764,10058,42237771,2011
WI,highways,1361,7127920,57,139143,5619,1393,1418,7267063,2011
WI,air transportation,0,0,0,0,0,0,0,0,2011
WI,water transport and terminals,0,0,0,0,0,0,0,0,2011
WI,public welfare,1693,7263728,288,715363,45325,1949,1981,7979091,2011
WI,health,1257,6560658,423,1252657,44721,1510,1680,7813315,2011
WI,hospitals,2857,11360087,494,1439399,49384,3135,3351,12799486,2011
WI,social insurance administration,938,3882503,33,72930,4140,962,971,3955433,2011
WI,solid waste management,0,0,0,0,0,0,0,0,2011
WI,sewerage,0,0,0,0,0,0,0,0,2011
WI,parks and recreation,104,428511,73,123371,6498,141,177,551882,2011
WI,housing and community development,0,0,0,0,0,0,0,0,2011
WI,natural resources,1852,8470690,722,1023202,48579,2126,2574,9493892,2011
WI,water transport and terminals,0,0,0,0,0,0,0,0,2011
WI,electric power,0,0,0,0,0,0,0,0,2011
WI,gas supply,0,0,0,0,0,0,0,0,2011
WI,transit,0,0,0,0,0,0,0,0,2011
WI,education - elementary and secondary instructional,0,0,0,0,0,0,0,0,2011
WI,education - elementary and secondary other,0,0,0,0,0,0,0,0,2011
WI,education - higher education instructional,8664,57629544,11807,13936363,692185,12575,20471,71565907,2011
WI,education - higher education other,17091,80657503,31464,23457493,1521663,25688,48555,104114996,2011
WI,education - other,832,4053581,219,781757,27985,990,1051,4835338,2011
WI,libraries,0,0,0,0,0,0,0,0,2011
WI,liquor stores,0,0,0,0,0,0,0,0,2011
WI,other and unallocable,4146,21205150,457,1149932,46213,4408,4603,22355082,2011
WY,total,12522,53190381,3446,3015603,159028,13416,15968,56205984,2011
WY,financial administration,576,2779958,7,12860,560,578,583,2792818,2011
WY,other government administration,138,728352,93,48227,2623,151,231,776579,2011
WY,judicial and legal,544,2863362,49,137255,3920,566,593,3000617,2011
WY,police protection - officers,202,872087,0,0,0,202,202,872087,2011
WY,police protection - other,97,503774,0,0,0,97,97,503774,2011
WY,corrections,1391,4836738,5,5599,400,1393,1396,4842337,2011
WY,highways,1783,7475705,83,174016,11561,1848,1866,7649721,2011
WY,air transportation,0,0,0,0,0,0,0,0,2011
WY,water transport and terminals,0,0,0,0,0,0,0,0,2011
WY,public welfare,759,3072483,37,49420,2968,776,796,3121903,2011
WY,health,748,3171926,81,136523,6373,784,829,3308449,2011
WY,hospitals,725,2398988,29,52848,2320,738,754,2451836,2011
WY,social insurance administration,124,434153,9,10205,720,128,133,444358,2011
WY,solid waste management,0,0,0,0,0,0,0,0,2011
WY,sewerage,0,0,0,0,0,0,0,0,2011
WY,parks and recreation,156,625113,53,56249,2485,170,209,681362,2011
WY,housing and community development,0,0,0,0,0,0,0,0,2011
WY,natural resources,991,4206663,29,43253,2323,1005,1020,4249916,2011
WY,water transport and terminals,0,0,0,0,0,0,0,0,2011
WY,electric power,0,0,0,0,0,0,0,0,2011
WY,gas supply,0,0,0,0,0,0,0,0,2011
WY,transit,0,0,0,0,0,0,0,0,2011
WY,education - elementary and secondary instructional,0,0,0,0,0,0,0,0,2011
WY,education - elementary and secondary other,0,0,0,0,0,0,0,0,2011
WY,education - higher education instructional,1038,6661686,760,976532,36126,1242,1798,7638218,2011
WY,education - higher education other,2003,7217878,2160,1249246,82601,2470,4163,8467124,2011
WY,education - other,235,1157568,7,10904,560,238,242,1168472,2011
WY,libraries,0,0,0,0,0,0,0,0,2011
WY,liquor stores,40,143926,0,0,0,40,40,143926,2011
WY,other and unallocable,972,4040021,44,52466,3488,990,1016,4092487,2011
