state,government_function,full_time_employees,full_time_pay,part_time_employees,part_time_pay,part_time_hours,full_time_equivalent_employees,total_march_pay,year
US,total,3467022,10291267990,1265586,1121820162,90690179,3986680,11413088152,1997
US,financial administration,159075,448528384,13175,15155724,1357527,166925,463684108,1997
US,other government administration,47901,140361418,12301,16524508,1156647,54570,156885926,1997
US,judicial and legal,129887,453410151,8787,13506621,884903,134980,466916772,1997
US,police arrest,55864,201828953,547,683439,27783,56023,202512392,1997
US,police other,35248,102185903,2286,1969086,169783,36223,104154989,1997
US,corrections,427934,1163739035,30254,19465898,1354791,435655,1183204933,1997
US,streets and highways,242441,665499090,9230,11786743,921849,247717,677285833,1997
US,air transportation,2772,8809989,57,123787,6892,2812,8933776,1997
US,water transportation,4812,14181479,142,196213,13457,4888,14377692,1997
US,public welfare,214058,545499741,10494,15230544,1186014,220862,560730285,1997
US,health,153962,439146582,15667,21427411,1520977,162605,460573993,1997
US,hospitals,430520,1132043098,64353,107416359,6686762,468654,1239459457,1997
US,social insurance administration,87132,245121591,9098,13832373,976860,92777,258953964,1997
US,solid waste management,1420,5378723,60,126908,6835,1459,5505631,1997
US,sewage disposal,1381,3960122,14,26939,1559,1389,3987061,1997
US,parks and recreation,26697,63852893,12890,11207851,1326824,34305,75060744,1997
US,housing and community development,0,0,0,0,0,0,0,1997
US,natural resources,132804,377417638,32628,32038831,3019692,150053,409456469,1997
US,water transport and terminals,924,2569993,8,13805,925,930,2583798,1997
US,electric power,5646,27277018,147,227584,15438,5732,27504602,1997
US,gas supply,0,0,0,0,0,0,0,1997
US,transit,18434,78709315,665,704143,65255,18803,79413458,1997
US,elem and sec instruction,26890,89205222,7531,4467988,284259,28616,93673210,1997
US,elem and sec admin/cler,3212,7734630,197,187079,15258,3305,7921709,1997
US,elem and sec oper/maint,2454,5166734,2271,928634,90275,3001,6095368,1997
US,elem and sec cafeteria,2609,4310432,426,223470,26292,2786,4533902,1997
US,elem and sec bus transit,179,337520,58,54654,7126,225,392174,1997
US,elem and sec health/rec,196,645976,211,379515,29875,376,1025491,1997
US,elem and sec student,0,0,514,78513,11758,72,78513,1997
US,elem and sec unalloc,2228,4663738,1471,243120,14296,2315,4906858,1997
US,instructional staff,327547,1561993321,306720,387415828,22118801,454449,1949409149,1997
US,auxiliary enterprises,641311,1630433215,689041,414143488,44797625,897798,2044576703,1997
US,education - other,85565,246668521,13741,12690437,973483,91169,259358958,1997
US,libraries,541,1235119,227,111680,12460,616,1346799,1997
US,liquor stores,5793,14067068,3570,2020393,239865,7167,16087461,1997
US,other and unallocable,189585,605285378,16805,17210596,1368033,197423,622495974,1997
AL,total,72581,184228791,22909,14634631,1465598,81089,198863422,1997
AL,financial administration,2442,6681259,140,90830,12091,2511,6772089,1997
AL,other government administration,472,1325207,46,92553,3808,494,1417760,1997
AL,judicial and legal,2760,8042658,132,148422,14407,2841,8191080,1997
AL,police arrest,789,2882858,0,0,0,789,2882858,1997
AL,police other,450,1160107,37,11277,1456,458,1171384,1997
AL,corrections,4187,10183158,18,15501,1788,4197,10198659,1997
AL,streets and highways,3920,9117028,68,48256,6022,3954,9165284,1997
AL,air transportation,0,0,0,0,0,0,0,1997
AL,water transportation,471,1135510,1,1400,116,472,1136910,1997
AL,public welfare,4000,9856584,37,48502,4118,4023,9905086,1997
AL,health,6610,14511648,605,494850,72612,7020,15006498,1997
AL,hospitals,11187,22464510,1114,1573146,91354,11703,24037656,1997
AL,social insurance administration,1421,3306113,60,27635,4393,1446,3333748,1997
AL,solid waste management,0,0,0,0,0,0,0,1997
AL,sewage disposal,0,0,0,0,0,0,0,1997
AL,parks and recreation,455,846756,486,337484,63726,815,1184240,1997
AL,housing and community development,0,0,0,0,0,0,0,1997
AL,natural resources,2267,6124426,443,253570,37229,2478,6377996,1997
AL,water transport and terminals,0,0,0,0,0,0,0,1997
AL,electric power,0,0,0,0,0,0,0,1997
AL,gas supply,0,0,0,0,0,0,0,1997
AL,transit,0,0,0,0,0,0,0,1997
AL,elem and sec instruction,0,0,0,0,0,0,0,1997
AL,elem and sec admin/cler,0,0,0,0,0,0,0,1997
AL,elem and sec oper/maint,0,0,0,0,0,0,0,1997
AL,elem and sec cafeteria,0,0,0,0,0,0,0,1997
AL,elem and sec bus transit,0,0,0,0,0,0,0,1997
AL,elem and sec health/rec,0,0,0,0,0,0,0,1997
AL,elem and sec student,0,0,0,0,0,0,0,1997
AL,elem and sec unalloc,0,0,0,0,0,0,0,1997
AL,instructional staff,8512,35352220,6173,5145424,335963,10497,40497644,1997
AL,auxiliary enterprises,16610,35423649,12260,5541863,736346,20908,40965512,1997
AL,education - other,3232,9217027,793,463376,33551,3423,9680403,1997
AL,libraries,0,0,0,0,0,0,0,1997
AL,liquor stores,653,1263930,0,0,0,653,1263930,1997
AL,other and unallocable,2143,5334143,496,340542,46618,2407,5674685,1997
AK,total,20517,76578016,4727,4218078,318324,22358,80796094,1997
AK,financial administration,990,3721202,23,32912,1771,1002,3754114,1997
AK,other government administration,525,1761314,48,61446,3864,548,1822760,1997
AK,judicial and legal,1144,4658866,86,113427,5631,1178,4772293,1997
AK,police arrest,261,1487112,0,0,0,261,1487112,1997
AK,police other,165,497100,1,1732,100,166,498832,1997
AK,corrections,1270,5133455,4,6370,331,1272,5139825,1997
AK,streets and highways,2658,10442488,17,21357,1506,2667,10463845,1997
AK,water transportation,0,0,0,0,0,0,0,1997
AK,air transportation,0,0,0,0,0,0,0,1997
AK,public welfare,1750,5666078,157,197187,20139,1871,5863265,1997
AK,health,580,2149826,24,41138,2132,592,2190964,1997
AK,hospitals,318,1048928,9,6774,591,322,1055702,1997
AK,social insurance administration,380,1326137,2,1901,132,381,1328038,1997
AK,solid waste management,0,0,0,0,0,0,0,1997
AK,sewage disposal,0,0,0,0,0,0,0,1997
AK,parks and recreation,87,280074,0,0,0,87,280074,1997
AK,housing and community development,0,0,0,0,0,0,0,1997
AK,natural resources,2071,7695636,62,86075,4931,2100,7781711,1997
AK,water transport and terminals,0,0,0,0,0,0,0,1997
AK,electric power,0,0,0,0,0,0,0,1997
AK,gas supply,0,0,0,0,0,0,0,1997
AK,transit,0,0,0,0,0,0,0,1997
AK,elem and sec instruction,1829,7062312,432,391232,32863,2028,7453544,1997
AK,elem and sec admin/cler,314,1028492,107,87625,6717,354,1116117,1997
AK,elem and sec oper/maint,253,713711,153,158069,12590,330,871780,1997
AK,elem and sec cafeteria,95,181227,106,99235,7648,142,280462,1997
AK,elem and sec bus transit,5,7117,15,9174,1141,12,16291,1997
AK,elem and sec health/rec,15,16119,12,4345,503,17,20464,1997
AK,elem and sec student,0,0,25,1467,292,1,1467,1997
AK,elem and sec unalloc,52,139472,5,4597,464,55,144069,1997
AK,instructional staff,1002,5499483,1130,1151265,54540,1310,6650748,1997
AK,auxiliary enterprises,2075,5799384,2161,1618235,152350,2936,7417619,1997
AK,education - other,479,1701032,34,27656,2074,491,1728688,1997
AK,libraries,0,0,0,0,0,0,0,1997
AK,liquor stores,0,0,0,0,0,0,0,1997
AK,other and unallocable,2199,8561451,114,94859,6014,2235,8656310,1997
AZ,total,52717,138719429,21993,15514037,1506603,61232,154233466,1997
AZ,financial administration,3762,8499583,22,23033,1402,3770,8522616,1997
AZ,other government administration,627,1607650,76,99082,3790,649,1706732,1997
AZ,judicial and legal,1146,4110806,93,124831,7899,1190,4235637,1997
AZ,police arrest,956,3465835,0,0,0,956,3465835,1997
AZ,police other,749,2082613,13,5560,525,752,2088173,1997
AZ,corrections,8140,18426367,32,24899,2889,8156,18451266,1997
AZ,streets and highways,2996,7575788,0,0,0,2996,7575788,1997
AZ,air transportation,0,0,0,0,0,0,0,1997
AZ,water transportation,0,0,0,0,0,0,0,1997
AZ,public welfare,5839,11119685,119,87102,7448,5881,11206787,1997
AZ,health,2067,4870649,39,46882,4063,2090,4917531,1997
AZ,hospitals,648,1457647,38,52594,3436,667,1510241,1997
AZ,social insurance administration,2004,4048354,49,19437,2227,2017,4067791,1997
AZ,solid waste management,0,0,0,0,0,0,0,1997
AZ,sewage disposal,0,0,0,0,0,0,0,1997
AZ,parks and recreation,261,610420,228,113830,16524,354,724250,1997
AZ,housing and community development,0,0,0,0,0,0,0,1997
AZ,natural resources,2012,5245528,687,523402,55942,2328,5768930,1997
AZ,water transport and terminals,0,0,0,0,0,0,0,1997
AZ,electric power,8,26182,4,120,32,8,26302,1997
AZ,gas supply,0,0,0,0,0,0,0,1997
AZ,transit,0,0,0,0,0,0,0,1997
AZ,elem and sec instruction,0,0,0,0,0,0,0,1997
AZ,elem and sec admin/cler,0,0,0,0,0,0,0,1997
AZ,elem and sec oper/maint,0,0,0,0,0,0,0,1997
AZ,elem and sec cafeteria,0,0,0,0,0,0,0,1997
AZ,elem and sec bus transit,0,0,0,0,0,0,0,1997
AZ,elem and sec health/rec,0,0,0,0,0,0,0,1997
AZ,elem and sec student,0,0,0,0,0,0,0,1997
AZ,elem and sec unalloc,0,0,0,0,0,0,0,1997
AZ,instructional staff,4611,23389958,5569,6028330,433663,7062,29418288,1997
AZ,auxiliary enterprises,11055,28978739,14534,7671714,935473,16341,36650453,1997
AZ,education - other,2588,5515890,384,611686,25136,2731,6127576,1997
AZ,libraries,0,0,0,0,0,0,0,1997
AZ,liquor stores,0,0,0,0,0,0,0,1997
AZ,other and unallocable,3248,7687735,106,81535,6154,3284,7769270,1997
AR,total,44126,107375958,10680,7048574,783004,48561,114424532,1997
AR,financial administration,1773,3905593,135,134872,13597,1850,4040465,1997
AR,other government administration,578,1444262,72,141182,12041,646,1585444,1997
AR,judicial and legal,375,1702217,15,15368,1261,382,1717585,1997
AR,police arrest,525,1577311,0,0,0,525,1577311,1997
AR,police other,407,879131,0,0,0,407,879131,1997
AR,corrections,3595,6283431,6,5935,1049,3601,6289366,1997
AR,streets and highways,3620,9300919,58,32809,5181,3649,9333728,1997
AR,air transportation,0,0,0,0,0,0,0,1997
AR,water transportation,0,0,0,0,0,0,0,1997
AR,public welfare,3663,7092131,0,0,0,3663,7092131,1997
AR,health,4509,9845597,148,156589,18142,4611,10002186,1997
AR,hospitals,4776,9283916,171,163227,14387,4857,9447143,1997
AR,social insurance administration,867,2390177,193,173609,21899,991,2563786,1997
AR,solid waste management,0,0,0,0,0,0,0,1997
AR,sewage disposal,0,0,0,0,0,0,0,1997
AR,parks and recreation,578,1056680,374,190862,38172,794,1247542,1997
AR,housing and community development,0,0,0,0,0,0,0,1997
AR,natural resources,2069,4965128,246,174687,26369,2219,5139815,1997
AR,water transport and terminals,0,0,0,0,0,0,0,1997
AR,electric power,0,0,0,0,0,0,0,1997
AR,gas supply,0,0,0,0,0,0,0,1997
AR,transit,0,0,0,0,0,0,0,1997
AR,elem and sec instruction,0,0,0,0,0,0,0,1997
AR,elem and sec admin/cler,0,0,0,0,0,0,0,1997
AR,elem and sec oper/maint,0,0,0,0,0,0,0,1997
AR,elem and sec cafeteria,0,0,0,0,0,0,0,1997
AR,elem and sec bus transit,0,0,0,0,0,0,0,1997
AR,elem and sec health/rec,0,0,0,0,0,0,0,1997
AR,elem and sec student,0,0,0,0,0,0,0,1997
AR,elem and sec unalloc,0,0,0,0,0,0,0,1997
AR,instructional staff,4313,19369739,3454,3191481,201432,5454,22561220,1997
AR,auxiliary enterprises,7907,16788716,5089,2149835,376559,10040,18938551,1997
AR,education - other,2480,6178301,621,439243,45545,2740,6617544,1997
AR,libraries,0,0,0,0,0,0,0,1997
AR,liquor stores,0,0,0,0,0,0,0,1997
AR,other and unallocable,2091,5312709,98,78875,7370,2132,5391584,1997
CA,total,284389,1099991579,122165,133005394,9032185,335430,1232996973,1997
CA,financial administration,16402,55629617,2374,1981239,178541,17410,57610856,1997
CA,other government administration,3235,11514607,559,1034652,56568,3573,12549259,1997
CA,judicial and legal,2631,12750209,272,517591,21126,2750,13267800,1997
CA,police arrest,6847,27346918,411,473809,12820,6919,27820727,1997
CA,police other,5165,19924752,815,743882,44892,5418,20668634,1997
CA,corrections,41235,159864663,3973,8630080,523668,44193,168494743,1997
CA,streets and highways,16048,61495936,572,1265684,68012,16432,62761620,1997
CA,air transportation,0,0,0,0,0,0,0,1997
CA,water transportation,53,206007,6,8721,670,57,214728,1997
CA,public welfare,3500,11887635,312,429671,29206,3666,12317306,1997
CA,health,10470,40133270,1360,2342270,124710,11174,42475540,1997
CA,hospitals,27820,107026537,7289,13694203,723148,31905,120720740,1997
CA,social insurance administration,16190,54122449,3020,5426856,316018,17976,59549305,1997
CA,solid waste management,359,1483617,40,105550,4769,386,1589167,1997
CA,sewage disposal,0,0,0,0,0,0,0,1997
CA,parks and recreation,1858,6281364,1592,1892121,191555,2941,8173485,1997
CA,housing and community development,0,0,0,0,0,0,0,1997
CA,natural resources,14695,48649136,1957,2566487,221784,15946,51215623,1997
CA,water transport and terminals,0,0,0,0,0,0,0,1997
CA,electric power,0,0,0,0,0,0,0,1997
CA,gas supply,0,0,0,0,0,0,0,1997
CA,transit,0,0,0,0,0,0,0,1997
CA,elem and sec instruction,0,0,0,0,0,0,0,1997
CA,elem and sec admin/cler,0,0,0,0,0,0,0,1997
CA,elem and sec oper/maint,0,0,0,0,0,0,0,1997
CA,elem and sec cafeteria,0,0,0,0,0,0,0,1997
CA,elem and sec bus transit,0,0,0,0,0,0,0,1997
CA,elem and sec health/rec,0,0,0,0,0,0,0,1997
CA,elem and sec student,0,0,0,0,0,0,0,1997
CA,elem and sec unalloc,0,0,0,0,0,0,0,1997
CA,instructional staff,18822,107918346,25055,33609159,2153743,30990,141527505,1997
CA,auxiliary enterprises,60103,211362968,70004,54842187,4145367,83523,266205155,1997
CA,education - other,4295,15032945,769,1060452,75160,4720,16093397,1997
CA,libraries,0,0,0,0,0,0,0,1997
CA,liquor stores,0,0,0,0,0,0,0,1997
CA,other and unallocable,34661,147360603,1785,2380780,140428,35451,149741383,1997
CO,total,42236,144018221,34149,56676395,3043645,59432,200694616,1997
CO,financial administration,1948,6399303,139,194599,10285,2007,6593902,1997
CO,other government administration,454,1260115,119,254759,12670,526,1514874,1997
CO,judicial and legal,2643,9091017,649,1120771,59598,2980,10211788,1997
CO,police arrest,748,2338978,0,0,0,748,2338978,1997
CO,police other,375,969857,14,16500,462,378,986357,1997
CO,corrections,4501,13120476,83,151791,8805,4551,13272267,1997
CO,streets and highways,2965,9449254,203,347499,19306,3074,9796753,1997
CO,air transportation,0,0,0,0,0,0,0,1997
CO,water transportation,0,0,0,0,0,0,0,1997
CO,public welfare,1397,4695430,160,251875,14607,1480,4947305,1997
CO,health,999,3877902,139,237396,16305,1091,4115298,1997
CO,hospitals,3362,9385338,974,2588087,109538,3980,11973425,1997
CO,social insurance administration,695,2441557,303,641996,33789,886,3083553,1997
CO,solid waste management,0,0,0,0,0,0,0,1997
CO,sewage disposal,0,0,0,0,0,0,0,1997
CO,parks and recreation,180,682801,93,147147,10304,238,829948,1997
CO,housing and community development,0,0,0,0,0,0,0,1997
CO,natural resources,1256,4713861,196,243873,15494,1343,4957734,1997
CO,water transport and terminals,0,0,0,0,0,0,0,1997
CO,electric power,0,0,0,0,0,0,0,1997
CO,gas supply,0,0,0,0,0,0,0,1997
CO,transit,0,0,0,0,0,0,0,1997
CO,elem and sec instruction,0,0,0,0,0,0,0,1997
CO,elem and sec admin/cler,0,0,0,0,0,0,0,1997
CO,elem and sec oper/maint,0,0,0,0,0,0,0,1997
CO,elem and sec cafeteria,0,0,0,0,0,0,0,1997
CO,elem and sec bus transit,0,0,0,0,0,0,0,1997
CO,elem and sec health/rec,0,0,0,0,0,0,0,1997
CO,elem and sec student,0,0,0,0,0,0,0,1997
CO,elem and sec unalloc,0,0,0,0,0,0,0,1997
CO,instructional staff,8625,40302918,9230,21736636,759356,12916,62039554,1997
CO,auxiliary enterprises,9542,26748358,21069,27691403,1906299,20311,54439761,1997
CO,education - other,1041,3262949,638,806029,53858,1346,4068978,1997
CO,libraries,0,0,0,0,0,0,0,1997
CO,liquor stores,0,0,0,0,0,0,0,1997
CO,other and unallocable,1505,5278107,140,246034,12969,1577,5524141,1997
CT,total,54509,189990572,14861,13474400,842012,59774,203464972,1997
CT,financial administration,2530,7512246,75,130728,9152,2590,7642974,1997
CT,other government administration,947,3320033,54,104486,5863,984,3424519,1997
CT,judicial and legal,3479,11093139,89,202970,10796,3549,11296109,1997
CT,police arrest,1056,4462561,0,0,0,1056,4462561,1997
CT,police other,602,1824952,39,72652,4999,634,1897604,1997
CT,corrections,8076,25483985,82,182031,8644,8131,25666016,1997
CT,streets and highways,3842,13866725,20,36673,2389,3857,13903398,1997
CT,air transportation,118,482189,0,0,0,118,482189,1997
CT,water transportation,0,0,0,0,0,0,0,1997
CT,public welfare,4711,15114114,153,354519,18288,4828,15468633,1997
CT,health,1999,7102921,74,139670,7043,2041,7242591,1997
CT,hospitals,9522,34205702,1931,3595235,195877,10733,37800937,1997
CT,social insurance administration,1050,3275560,0,0,0,1050,3275560,1997
CT,solid waste management,56,211145,1,906,80,56,212051,1997
CT,sewage disposal,0,0,0,0,0,0,0,1997
CT,parks and recreation,373,1303386,35,57949,6438,415,1361335,1997
CT,housing and community development,0,0,0,0,0,0,0,1997
CT,natural resources,514,1764293,37,67419,5447,549,1831712,1997
CT,water transport and terminals,0,0,0,0,0,0,0,1997
CT,electric power,0,0,0,0,0,0,0,1997
CT,gas supply,0,0,0,0,0,0,0,1997
CT,transit,0,0,0,0,0,0,0,1997
CT,elem and sec instruction,0,0,0,0,0,0,0,1997
CT,elem and sec admin/cler,0,0,0,0,0,0,0,1997
CT,elem and sec oper/maint,0,0,0,0,0,0,0,1997
CT,elem and sec cafeteria,0,0,0,0,0,0,0,1997
CT,elem and sec bus transit,0,0,0,0,0,0,0,1997
CT,elem and sec health/rec,0,0,0,0,0,0,0,1997
CT,elem and sec student,0,0,0,0,0,0,0,1997
CT,elem and sec unalloc,0,0,0,0,0,0,0,1997
CT,instructional staff,3875,18813481,3344,3603366,190656,5049,22416847,1997
CT,auxiliary enterprises,6281,22960886,8553,4344040,339248,8414,27304926,1997
CT,education - other,2762,8378822,227,334745,21750,2903,8713567,1997
CT,libraries,0,0,0,0,0,0,0,1997
CT,liquor stores,0,0,0,0,0,0,0,1997
CT,other and unallocable,2716,8814432,147,247011,15342,2817,9061443,1997
DE,total,19293,54031464,6889,5256034,428896,21876,59287498,1997
DE,financial administration,729,1755228,59,45680,5216,760,1800908,1997
DE,other government administration,200,611984,106,181436,8918,252,793420,1997
DE,judicial and legal,1316,3586602,17,20132,1262,1323,3606734,1997
DE,police arrest,564,2331304,0,0,0,564,2331304,1997
DE,police other,258,657828,26,33580,3206,276,691408,1997
DE,corrections,1941,5071818,159,162886,13810,2022,5234704,1997
DE,streets and highways,1431,3207794,70,82386,11894,1503,3290180,1997
DE,air transportation,0,0,0,0,0,0,0,1997
DE,water transportation,0,0,0,0,0,0,0,1997
DE,public welfare,1338,3340572,82,107492,8440,1388,3448064,1997
DE,health,1531,4141373,233,216594,19837,1651,4357967,1997
DE,hospitals,2188,4539404,147,153504,12200,2261,4692908,1997
DE,social insurance administration,295,652798,9,8564,704,300,661362,1997
DE,solid waste management,82,223202,13,10995,1406,90,234197,1997
DE,sewage disposal,0,0,0,0,0,0,0,1997
DE,parks and recreation,162,385714,74,37722,4844,191,423436,1997
DE,housing and community development,0,0,0,0,0,0,0,1997
DE,natural resources,425,1132054,108,76558,8360,475,1208612,1997
DE,water transport and terminals,0,0,0,0,0,0,0,1997
DE,electric power,0,0,0,0,0,0,0,1997
DE,gas supply,0,0,0,0,0,0,0,1997
DE,transit,447,1281775,35,39241,4420,472,1321016,1997
DE,elem and sec instruction,0,0,0,0,0,0,0,1997
DE,elem and sec admin/cler,0,0,0,0,0,0,0,1997
DE,elem and sec oper/maint,0,0,0,0,0,0,0,1997
DE,elem and sec cafeteria,0,0,0,0,0,0,0,1997
DE,elem and sec bus transit,0,0,0,0,0,0,0,1997
DE,elem and sec health/rec,0,0,0,0,0,0,0,1997
DE,elem and sec student,0,0,0,0,0,0,0,1997
DE,elem and sec unalloc,0,0,0,0,0,0,0,1997
DE,instructional staff,1533,7221170,2134,2175558,149045,2431,9396728,1997
DE,auxiliary enterprises,3375,9624162,3391,1802012,166736,4386,11426174,1997
DE,education - other,264,920192,5,6314,480,268,926506,1997
DE,libraries,0,0,0,0,0,0,0,1997
DE,liquor stores,0,0,0,0,0,0,0,1997
DE,other and unallocable,1214,3346490,221,95380,8118,1263,3441870,1997
FL,total,170065,465024779,56819,31622053,3078136,187457,496646832,1997
FL,financial administration,6839,18887920,342,242258,33887,7030,19130178,1997
FL,other government administration,3123,9085185,376,706201,47682,3394,9791386,1997
FL,judicial and legal,13594,43441930,493,764722,60841,13941,44206652,1997
FL,police arrest,2251,7798833,0,0,0,2251,7798833,1997
FL,police other,1682,3068600,78,52189,7019,1722,3120789,1997
FL,corrections,37246,105381146,18664,440414,76272,37676,105821560,1997
FL,streets and highways,11406,25640086,427,333959,26710,11557,25974045,1997
FL,water transportation,1,3531,5,5000,250,2,8531,1997
FL,air transportation,0,0,0,0,0,0,0,1997
FL,public welfare,9068,17768059,66,52410,5628,9100,17820469,1997
FL,health,13635,30405547,866,1118517,111448,14264,31524064,1997
FL,hospitals,15516,35787151,3402,2261526,265592,17016,38048677,1997
FL,social insurance administration,4783,12824681,25,24447,2100,4795,12849128,1997
FL,solid waste management,0,0,0,0,0,0,0,1997
FL,sewage disposal,0,0,0,0,0,0,0,1997
FL,parks and recreation,1075,2082768,11,6884,924,1080,2089652,1997
FL,housing and community development,0,0,0,0,0,0,0,1997
FL,natural resources,6533,16755842,1969,1757158,191858,7617,18513000,1997
FL,water transport and terminals,0,0,0,0,0,0,0,1997
FL,electric power,0,0,0,0,0,0,0,1997
FL,gas supply,0,0,0,0,0,0,0,1997
FL,transit,470,1113900,0,0,0,470,1113900,1997
FL,elem and sec instruction,0,0,0,0,0,0,0,1997
FL,elem and sec admin/cler,0,0,0,0,0,0,0,1997
FL,elem and sec oper/maint,0,0,0,0,0,0,0,1997
FL,elem and sec cafeteria,0,0,0,0,0,0,0,1997
FL,elem and sec bus transit,0,0,0,0,0,0,0,1997
FL,elem and sec health/rec,0,0,0,0,0,0,0,1997
FL,elem and sec student,0,0,0,0,0,0,0,1997
FL,elem and sec unalloc,0,0,0,0,0,0,0,1997
FL,instructional staff,11824,52440549,10806,11613030,790203,16289,64053579,1997
FL,auxiliary enterprises,19881,51726274,17786,11246615,1352284,27520,62972889,1997
FL,education - other,1918,5490521,241,60454,4928,1945,5550975,1997
FL,libraries,0,0,0,0,0,0,0,1997
FL,liquor stores,0,0,0,0,0,0,0,1997
FL,other and unallocable,9220,25322256,1262,936269,100510,9788,26258525,1997
GA,total,98764,250834266,32476,25821493,2247597,111465,276655759,1997
GA,financial administration,2940,8332881,413,376189,53063,3240,8709070,1997
GA,other government administration,658,2096082,380,588285,46571,921,2684367,1997
GA,judicial and legal,1156,4946940,55,100855,4789,1184,5047795,1997
GA,police arrest,1123,3440783,0,0,0,1123,3440783,1997
GA,police other,1059,2654317,42,37391,4870,1087,2691708,1997
GA,corrections,17053,37300843,316,336313,30035,17223,37637156,1997
GA,streets and highways,5936,9231527,9,11483,961,5941,9243010,1997
GA,air transportation,0,0,0,0,0,0,0,1997
GA,water transportation,682,1729657,0,0,0,682,1729657,1997
GA,public welfare,7368,15837036,255,296146,39114,7589,16133182,1997
GA,health,4684,13149848,209,312700,25386,4827,13462548,1997
GA,hospitals,11998,26604788,1433,2020065,152286,12859,28624853,1997
GA,social insurance administration,1813,4695679,85,85313,10102,1870,4780992,1997
GA,solid waste management,0,0,0,0,0,0,0,1997
GA,sewage disposal,0,0,0,0,0,0,0,1997
GA,parks and recreation,1588,3103701,2081,1394793,197248,2702,4498494,1997
GA,housing and community development,0,0,0,0,0,0,0,1997
GA,natural resources,4707,11766572,1125,797385,95512,5246,12563957,1997
GA,water transport and terminals,0,0,0,0,0,0,0,1997
GA,electric power,0,0,0,0,0,0,0,1997
GA,gas supply,0,0,0,0,0,0,0,1997
GA,transit,0,0,0,0,0,0,0,1997
GA,elem and sec instruction,0,0,0,0,0,0,0,1997
GA,elem and sec admin/cler,0,0,0,0,0,0,0,1997
GA,elem and sec oper/maint,0,0,0,0,0,0,0,1997
GA,elem and sec cafeteria,0,0,0,0,0,0,0,1997
GA,elem and sec bus transit,0,0,0,0,0,0,0,1997
GA,elem and sec health/rec,0,0,0,0,0,0,0,1997
GA,elem and sec student,0,0,0,0,0,0,0,1997
GA,elem and sec unalloc,0,0,0,0,0,0,0,1997
GA,instructional staff,9529,46004523,9183,9707080,491102,12304,55711603,1997
GA,auxiliary enterprises,18304,36311007,14007,8089496,936936,23598,44400503,1997
GA,education - other,4810,14560232,2193,1380132,121347,5497,15940364,1997
GA,libraries,0,0,0,0,0,0,0,1997
GA,liquor stores,0,0,0,0,0,0,0,1997
GA,other and unallocable,3356,9067850,690,287867,38275,3572,9355717,1997
HI,total,47499,126013904,18866,11269256,714147,51676,137283160,1997
HI,financial administration,954,2581408,4,1518,238,955,2582926,1997
HI,other government administration,993,2396174,39,29430,2743,1009,2425604,1997
HI,judicial and legal,2041,6321386,49,72274,3516,2061,6393660,1997
HI,police arrest,0,0,0,0,0,0,0,1997
HI,police other,0,0,0,0,0,0,0,1997
HI,corrections,2144,5219914,24,38648,2080,2156,5258562,1997
HI,streets and highways,826,2166048,17,9390,974,832,2175438,1997
HI,air transportation,972,2161216,12,4692,766,976,2165908,1997
HI,water transportation,210,524162,9,3248,462,213,527410,1997
HI,public welfare,1074,3121388,45,21284,3204,1092,3142672,1997
HI,health,2735,7017186,115,138752,9922,2791,7155938,1997
HI,hospitals,3212,7714070,226,362030,17610,3311,8076100,1997
HI,social insurance administration,341,983522,46,70588,5936,375,1054110,1997
HI,solid waste management,0,0,0,0,0,0,0,1997
HI,sewage disposal,0,0,0,0,0,0,0,1997
HI,parks and recreation,163,360098,206,83392,9364,216,443490,1997
HI,housing and community development,0,0,0,0,0,0,0,1997
HI,natural resources,1316,4193080,350,380378,17470,1413,4573458,1997
HI,water transport and terminals,0,0,0,0,0,0,0,1997
HI,electric power,0,0,0,0,0,0,0,1997
HI,gas supply,0,0,0,0,0,0,0,1997
HI,transit,0,0,0,0,0,0,0,1997
HI,elem and sec instruction,16455,42150414,6685,3767674,235480,17874,45918088,1997
HI,elem and sec admin/cler,1583,3569482,79,82084,7462,1628,3651566,1997
HI,elem and sec oper/maint,929,1393270,2099,749082,75400,1383,2142352,1997
HI,elem and sec cafeteria,1639,2665814,0,0,0,1639,2665814,1997
HI,elem and sec bus transit,0,0,0,0,0,0,0,1997
HI,elem and sec health/rec,55,218914,190,367028,28586,227,585942,1997
HI,elem and sec student,0,0,445,66260,9466,57,66260,1997
HI,elem and sec unalloc,14,12340,1450,231894,12884,92,244234,1997
HI,instructional staff,2012,9559610,1434,2035740,76994,2447,11595350,1997
HI,auxiliary enterprises,3434,10347382,4757,2434220,154692,4308,12781602,1997
HI,education - other,132,364680,3,3484,240,133,368164,1997
HI,libraries,494,1130268,222,107520,11946,566,1237788,1997
HI,liquor stores,0,0,0,0,0,0,0,1997
HI,other and unallocable,3771,9842078,360,208646,26712,3922,10050724,1997
ID,total,19263,44795015,7346,6750206,580171,22537,51545221,1997
ID,financial administration,1076,2769555,171,98749,12019,1144,2868304,1997
ID,other government administration,158,446079,135,138377,7988,203,584456,1997
ID,judicial and legal,419,1702063,20,28875,2389,432,1730938,1997
ID,police arrest,243,791401,0,0,0,243,791401,1997
ID,police other,165,447804,28,23980,2347,178,471784,1997
ID,corrections,1526,3602204,95,105150,12257,1594,3707354,1997
ID,streets and highways,1541,4305650,159,222737,21172,1661,4528387,1997
ID,water transportation,0,0,0,0,0,0,0,1997
ID,air transportation,0,0,0,0,0,0,0,1997
ID,public welfare,1749,4246782,171,238169,19643,1860,4484951,1997
ID,health,1171,2928444,157,208886,15927,1260,3137330,1997
ID,hospitals,819,2053496,124,153882,11225,882,2207378,1997
ID,social insurance administration,444,1257346,162,240611,30075,614,1497957,1997
ID,solid waste management,0,0,0,0,0,0,0,1997
ID,sewage disposal,0,0,0,0,0,0,0,1997
ID,parks and recreation,155,342408,85,38754,4844,182,381162,1997
ID,housing and community development,0,0,0,0,0,0,0,1997
ID,natural resources,1487,3858504,774,1259647,87200,1979,5118151,1997
ID,water transport and terminals,0,0,0,0,0,0,0,1997
ID,electric power,0,0,0,0,0,0,0,1997
ID,gas supply,0,0,0,0,0,0,0,1997
ID,transit,0,0,0,0,0,0,0,1997
ID,elem and sec instruction,0,0,0,0,0,0,0,1997
ID,elem and sec admin/cler,0,0,0,0,0,0,0,1997
ID,elem and sec oper/maint,0,0,0,0,0,0,0,1997
ID,elem and sec cafeteria,0,0,0,0,0,0,0,1997
ID,elem and sec bus transit,0,0,0,0,0,0,0,1997
ID,elem and sec health/rec,0,0,0,0,0,0,0,1997
ID,elem and sec student,0,0,0,0,0,0,0,1997
ID,elem and sec unalloc,0,0,0,0,0,0,0,1997
ID,instructional staff,2181,5836438,1255,1808186,89052,2685,7644624,1997
ID,auxiliary enterprises,4682,6921675,3258,1818745,219961,5925,8740420,1997
ID,education - other,402,1060554,463,165715,20715,520,1226269,1997
ID,libraries,0,0,0,0,0,0,0,1997
ID,liquor stores,92,230615,135,83461,10432,151,314076,1997
ID,other and unallocable,953,1993997,154,116282,12925,1024,2110279,1997
IL,total,121216,391243749,44765,30084131,3292468,141027,421327880,1997
IL,financial administration,6177,16805983,257,273059,25461,6331,17079042,1997
IL,other government administration,2268,6994892,21,27952,1638,2279,7022844,1997
IL,judicial and legal,2922,14004156,154,223765,9315,2977,14227921,1997
IL,police arrest,2202,9333710,0,0,0,2202,9333710,1997
IL,police other,1886,5971520,1,904,100,1887,5972424,1997
IL,corrections,14344,43390018,28,63878,3040,14362,43453896,1997
IL,streets and highways,7556,27402264,886,1391346,70325,7953,28793610,1997
IL,air transportation,0,0,0,0,0,0,0,1997
IL,water transportation,105,360650,2,4700,210,106,365350,1997
IL,public welfare,13089,40638202,319,426462,34716,13298,41064664,1997
IL,health,3101,10639772,38,55800,3538,3123,10695572,1997
IL,hospitals,14676,40908491,945,1745848,86465,15197,42654339,1997
IL,social insurance administration,3149,9037528,516,1067967,56526,3489,10105495,1997
IL,solid waste management,0,0,0,0,0,0,0,1997
IL,sewage disposal,0,0,0,0,0,0,0,1997
IL,parks and recreation,657,1895324,71,110548,8474,709,2005872,1997
IL,housing and community development,0,0,0,0,0,0,0,1997
IL,natural resources,3127,9489225,1134,975004,144008,3994,10464229,1997
IL,water transport and terminals,0,0,0,0,0,0,0,1997
IL,electric power,0,0,0,0,0,0,0,1997
IL,gas supply,0,0,0,0,0,0,0,1997
IL,transit,0,0,0,0,0,0,0,1997
IL,elem and sec instruction,0,0,0,0,0,0,0,1997
IL,elem and sec admin/cler,0,0,0,0,0,0,0,1997
IL,elem and sec oper/maint,0,0,0,0,0,0,0,1997
IL,elem and sec cafeteria,0,0,0,0,0,0,0,1997
IL,elem and sec bus transit,0,0,0,0,0,0,0,1997
IL,elem and sec health/rec,0,0,0,0,0,0,0,1997
IL,elem and sec student,0,0,0,0,0,0,0,1997
IL,elem and sec unalloc,0,0,0,0,0,0,0,1997
IL,instructional staff,12867,60274669,12647,10817982,747919,17374,71092651,1997
IL,auxiliary enterprises,22877,62379819,27468,12464808,2075997,35386,74844627,1997
IL,education - other,2984,9287912,41,52436,3578,3004,9340348,1997
IL,libraries,0,0,0,0,0,0,0,1997
IL,liquor stores,0,0,0,0,0,0,0,1997
IL,other and unallocable,7229,22429614,237,381672,21158,7356,22811286,1997
IN,total,71220,184244875,35558,36923041,2703372,86638,221167916,1997
IN,financial administration,3492,7252924,324,253618,38958,3726,7506542,1997
IN,other government administration,368,890136,102,6288,398,371,896424,1997
IN,judicial and legal,917,3465613,160,396879,22791,1047,3862492,1997
IN,police arrest,1235,4632574,0,0,0,1235,4632574,1997
IN,police other,758,1559101,4,2975,367,761,1562076,1997
IN,corrections,6190,14114990,15,26491,1537,6199,14141481,1997
IN,streets and highways,4308,8938310,1,715,82,4308,8939025,1997
IN,air transportation,0,0,0,0,0,0,0,1997
IN,water transportation,30,94660,3,2652,224,31,97312,1997
IN,public welfare,5090,10202931,61,49737,4825,5119,10252668,1997
IN,health,1670,4591154,7,10721,631,1674,4601875,1997
IN,hospitals,5756,10835992,121,112651,10602,5819,10948643,1997
IN,social insurance administration,1399,3158236,143,134399,17121,1502,3292635,1997
IN,solid waste management,0,0,0,0,0,0,0,1997
IN,sewage disposal,0,0,0,0,0,0,0,1997
IN,parks and recreation,91,184320,62,47619,4206,117,231939,1997
IN,housing and community development,0,0,0,0,0,0,0,1997
IN,natural resources,2293,5269794,2048,1813369,205702,3517,7083163,1997
IN,water transport and terminals,0,0,0,0,0,0,0,1997
IN,electric power,0,0,0,0,0,0,0,1997
IN,gas supply,0,0,0,0,0,0,0,1997
IN,transit,0,0,0,0,0,0,0,1997
IN,elem and sec instruction,0,0,0,0,0,0,0,1997
IN,elem and sec admin/cler,0,0,0,0,0,0,0,1997
IN,elem and sec oper/maint,0,0,0,0,0,0,0,1997
IN,elem and sec cafeteria,0,0,0,0,0,0,0,1997
IN,elem and sec bus transit,0,0,0,0,0,0,0,1997
IN,elem and sec health/rec,0,0,0,0,0,0,0,1997
IN,elem and sec student,0,0,0,0,0,0,0,1997
IN,elem and sec unalloc,0,0,0,0,0,0,0,1997
IN,instructional staff,11912,53750610,11249,20183687,927717,17174,73934297,1997
IN,auxiliary enterprises,22203,46856937,21197,13798898,1462700,30497,60655835,1997
IN,education - other,1136,2939210,42,57876,3914,1159,2997086,1997
IN,libraries,0,0,0,0,0,0,0,1997
IN,liquor stores,0,0,0,0,0,0,0,1997
IN,other and unallocable,2372,5507383,19,24466,1597,2382,5531849,1997
IA,total,40368,129180624,22269,36008904,2743045,55864,165189528,1997
IA,financial administration,1251,3126416,163,179744,20442,1366,3306160,1997
IA,other government administration,622,1786479,260,395783,41941,858,2182262,1997
IA,judicial and legal,2063,6687544,285,425825,35406,2263,7113369,1997
IA,police arrest,634,2104095,0,0,0,634,2104095,1997
IA,police other,328,924119,4,2829,248,329,926948,1997
IA,corrections,2340,6896210,93,181657,10311,2399,7077867,1997
IA,streets and highways,2975,8134513,0,0,0,2975,8134513,1997
IA,air transportation,0,0,0,0,0,0,0,1997
IA,water transportation,0,0,0,0,0,0,0,1997
IA,public welfare,3183,8724070,86,151426,10337,3242,8875496,1997
IA,health,322,1036713,9,10782,1027,328,1047495,1997
IA,hospitals,5839,17323347,1957,4495116,340205,7761,21818463,1997
IA,social insurance administration,407,1285668,14,19979,1240,414,1305647,1997
IA,solid waste management,0,0,0,0,0,0,0,1997
IA,sewage disposal,0,0,0,0,0,0,0,1997
IA,parks and recreation,118,347290,9,6461,739,122,353751,1997
IA,housing and community development,0,0,0,0,0,0,0,1997
IA,natural resources,2137,6273870,1389,1939802,135282,2901,8213672,1997
IA,water transport and terminals,0,0,0,0,0,0,0,1997
IA,electric power,0,0,0,0,0,0,0,1997
IA,gas supply,0,0,0,0,0,0,0,1997
IA,transit,0,0,0,0,0,0,0,1997
IA,elem and sec instruction,0,0,0,0,0,0,0,1997
IA,elem and sec admin/cler,0,0,0,0,0,0,0,1997
IA,elem and sec oper/maint,0,0,0,0,0,0,0,1997
IA,elem and sec cafeteria,0,0,0,0,0,0,0,1997
IA,elem and sec bus transit,0,0,0,0,0,0,0,1997
IA,elem and sec health/rec,0,0,0,0,0,0,0,1997
IA,elem and sec student,0,0,0,0,0,0,0,1997
IA,elem and sec unalloc,0,0,0,0,0,0,0,1997
IA,instructional staff,4325,24516594,3398,8884222,552650,7447,33400816,1997
IA,auxiliary enterprises,10020,28691235,14323,18919524,1563670,18854,47610759,1997
IA,education - other,1134,3155197,70,91167,7467,1177,3246364,1997
IA,libraries,0,0,0,0,0,0,0,1997
IA,liquor stores,0,0,0,0,0,0,0,1997
IA,other and unallocable,2670,8167264,209,304587,22080,2794,8471851,1997
KS,total,37415,101139320,17840,12050895,1249644,44474,113190215,1997
KS,financial administration,2233,4657389,41,38647,3670,2254,4696036,1997
KS,other government administration,287,840413,305,344796,43356,533,1185209,1997
KS,judicial and legal,1936,5200650,242,151136,19248,2044,5351786,1997
KS,police arrest,614,1875082,0,0,0,614,1875082,1997
KS,police other,356,757950,17,8331,1090,362,766281,1997
KS,corrections,3499,9140822,10,6357,687,3504,9147179,1997
KS,streets and highways,3735,9323690,82,77651,8021,3780,9401341,1997
KS,air transportation,0,0,0,0,0,0,0,1997
KS,water transportation,0,0,0,0,0,0,0,1997
KS,public welfare,1670,3881096,108,84901,6313,1705,3965997,1997
KS,health,892,2604254,77,22694,1658,901,2626948,1997
KS,hospitals,5211,12350150,963,1320453,76802,5646,13670603,1997
KS,social insurance administration,103,232161,15,10160,1088,109,242321,1997
KS,solid waste management,0,0,0,0,0,0,0,1997
KS,sewage disposal,0,0,0,0,0,0,0,1997
KS,parks and recreation,400,922042,190,96380,16981,496,1018422,1997
KS,housing and community development,0,0,0,0,0,0,0,1997
KS,natural resources,1300,3811920,521,586344,49451,1580,4398264,1997
KS,water transport and terminals,0,0,0,0,0,0,0,1997
KS,electric power,0,0,0,0,0,0,0,1997
KS,gas supply,0,0,0,0,0,0,0,1997
KS,transit,0,0,0,0,0,0,0,1997
KS,elem and sec instruction,0,0,0,0,0,0,0,1997
KS,elem and sec admin/cler,0,0,0,0,0,0,0,1997
KS,elem and sec oper/maint,0,0,0,0,0,0,0,1997
KS,elem and sec cafeteria,0,0,0,0,0,0,0,1997
KS,elem and sec bus transit,0,0,0,0,0,0,0,1997
KS,elem and sec health/rec,0,0,0,0,0,0,0,1997
KS,elem and sec student,0,0,0,0,0,0,0,1997
KS,elem and sec unalloc,0,0,0,0,0,0,0,1997
KS,instructional staff,3826,17245655,2632,3401820,176508,4823,20647475,1997
KS,auxiliary enterprises,8444,20563873,12248,5633871,808477,13011,26197744,1997
KS,education - other,649,1624977,110,68835,10870,709,1693812,1997
KS,libraries,0,0,0,0,0,0,0,1997
KS,liquor stores,0,0,0,0,0,0,0,1997
KS,other and unallocable,2260,6107196,279,198519,25424,2403,6305715,1997
KY,total,61453,166806417,23673,16749248,1735345,71616,183555665,1997
KY,financial administration,3230,7346162,139,118840,12550,3308,7465002,1997
KY,other government administration,984,3065502,207,307766,22732,1122,3373268,1997
KY,judicial and legal,3318,8633140,783,999294,86362,3839,9632434,1997
KY,police arrest,938,2930614,40,113418,6936,980,3044032,1997
KY,police other,821,1867358,25,44380,3136,840,1911738,1997
KY,corrections,4941,10612462,285,353756,26314,5100,10966218,1997
KY,streets and highways,5501,12862198,70,129390,9838,5561,12991588,1997
KY,water transportation,0,0,0,0,0,0,0,1997
KY,air transportation,0,0,0,0,0,0,0,1997
KY,public welfare,4521,10314964,166,247242,23824,4664,10562206,1997
KY,health,1864,6138003,51,84924,6546,1903,6222927,1997
KY,hospitals,4607,10709273,666,1047268,101000,5192,11756541,1997
KY,social insurance administration,1235,3107056,47,71358,6126,1272,3178414,1997
KY,solid waste management,0,0,0,0,0,0,0,1997
KY,sewage disposal,0,0,0,0,0,0,0,1997
KY,parks and recreation,1300,2234972,241,278658,38356,1531,2513630,1997
KY,housing and community development,0,0,0,0,0,0,0,1997
KY,natural resources,3132,7739395,701,662299,67374,3534,8401694,1997
KY,water transport and terminals,0,0,0,0,0,0,0,1997
KY,electric power,0,0,0,0,0,0,0,1997
KY,gas supply,0,0,0,0,0,0,0,1997
KY,transit,0,0,0,0,0,0,0,1997
KY,elem and sec instruction,0,0,0,0,0,0,0,1997
KY,elem and sec admin/cler,0,0,0,0,0,0,0,1997
KY,elem and sec oper/maint,0,0,0,0,0,0,0,1997
KY,elem and sec cafeteria,0,0,0,0,0,0,0,1997
KY,elem and sec bus transit,0,0,0,0,0,0,0,1997
KY,elem and sec health/rec,0,0,0,0,0,0,0,1997
KY,elem and sec student,0,0,0,0,0,0,0,1997
KY,elem and sec unalloc,0,0,0,0,0,0,0,1997
KY,instructional staff,6627,32155954,4852,5063474,316278,8469,37219428,1997
KY,auxiliary enterprises,11726,28179238,13957,5901649,905913,16980,34080887,1997
KY,education - other,3602,10100396,1061,906742,67612,4010,11007138,1997
KY,libraries,0,0,0,0,0,0,0,1997
KY,liquor stores,0,0,0,0,0,0,0,1997
KY,other and unallocable,3106,8809730,382,418790,34448,3311,9228520,1997
LA,total,85707,221181536,24945,18475888,1555217,94491,239657424,1997
LA,financial administration,2723,5358583,23,16308,2331,2736,5374891,1997
LA,other government administration,1135,3359700,538,586572,57730,1461,3946272,1997
LA,judicial and legal,1702,5501842,92,35022,4586,1728,5536864,1997
LA,police arrest,678,1746521,0,0,0,678,1746521,1997
LA,police other,412,780382,7,4776,527,415,785158,1997
LA,corrections,6751,13001164,92,34408,6801,6789,13035572,1997
LA,streets and highways,5717,12049729,46,33476,6366,5753,12083205,1997
LA,air transportation,0,0,0,0,0,0,0,1997
LA,water transportation,546,1278659,20,16132,1412,554,1294791,1997
LA,public welfare,5966,13907048,10,10778,1178,5973,13917826,1997
LA,health,5600,15112116,417,407338,29790,5769,15519454,1997
LA,hospitals,19356,40228342,2589,3484324,311617,21116,43712666,1997
LA,social insurance administration,982,2514860,64,39728,3664,1003,2554588,1997
LA,solid waste management,0,0,0,0,0,0,0,1997
LA,sewage disposal,0,0,0,0,0,0,0,1997
LA,parks and recreation,836,1710506,537,591632,72920,1248,2302138,1997
LA,housing and community development,0,0,0,0,0,0,0,1997
LA,natural resources,4404,10311553,966,556605,78456,4847,10868158,1997
LA,water transport and terminals,0,0,0,0,0,0,0,1997
LA,electric power,0,0,0,0,0,0,0,1997
LA,gas supply,0,0,0,0,0,0,0,1997
LA,transit,0,0,0,0,0,0,0,1997
LA,elem and sec instruction,0,0,0,0,0,0,0,1997
LA,elem and sec admin/cler,0,0,0,0,0,0,0,1997
LA,elem and sec oper/maint,0,0,0,0,0,0,0,1997
LA,elem and sec cafeteria,0,0,0,0,0,0,0,1997
LA,elem and sec bus transit,0,0,0,0,0,0,0,1997
LA,elem and sec health/rec,0,0,0,0,0,0,0,1997
LA,elem and sec student,0,0,0,0,0,0,0,1997
LA,elem and sec unalloc,0,0,0,0,0,0,0,1997
LA,instructional staff,8027,46916914,4930,6972446,317933,9824,53889360,1997
LA,auxiliary enterprises,14685,32380475,13749,4989650,594017,18039,37370125,1997
LA,education - other,3675,9010346,520,430469,31417,3851,9440815,1997
LA,libraries,0,0,0,0,0,0,0,1997
LA,liquor stores,0,0,0,0,0,0,0,1997
LA,other and unallocable,2512,6012796,345,266224,34472,2707,6279020,1997
ME,total,18052,49120774,6723,3725977,359052,20127,52846751,1997
ME,financial administration,1049,2666120,16,20768,1502,1058,2686888,1997
ME,other government administration,320,959255,213,232746,15581,427,1192001,1997
ME,judicial and legal,548,1801164,49,61148,4946,577,1862312,1997
ME,police arrest,335,1078700,0,0,0,335,1078700,1997
ME,police other,58,111174,0,0,0,58,111174,1997
ME,corrections,1129,2939996,11,12029,685,1152,2952025,1997
ME,streets and highways,2612,6474403,164,323065,27974,2770,6797468,1997
ME,air transportation,3,9018,0,0,0,3,9018,1997
ME,water transportation,52,135977,20,13350,1401,60,149327,1997
ME,public welfare,2246,5406167,62,98600,6013,2280,5504767,1997
ME,health,1133,3229628,57,100711,4571,1159,3330339,1997
ME,hospitals,518,1347881,10,12868,1344,526,1360749,1997
ME,social insurance administration,526,1255114,9,12168,934,531,1267282,1997
ME,solid waste management,0,0,0,0,0,0,0,1997
ME,sewage disposal,0,0,0,0,0,0,0,1997
ME,parks and recreation,112,253636,11,18704,974,118,272340,1997
ME,housing and community development,0,0,0,0,0,0,0,1997
ME,natural resources,1179,3198538,235,172865,15878,1270,3371403,1997
ME,water transport and terminals,0,0,0,0,0,0,0,1997
ME,electric power,0,0,0,0,0,0,0,1997
ME,gas supply,0,0,0,0,0,0,0,1997
ME,transit,0,0,0,0,0,0,0,1997
ME,elem and sec instruction,27,78090,9,12660,1395,36,90750,1997
ME,elem and sec admin/cler,1,1731,2,1946,177,2,3677,1997
ME,elem and sec oper/maint,0,0,2,1455,142,1,1455,1997
ME,elem and sec cafeteria,0,0,6,8759,875,6,8759,1997
ME,elem and sec bus transit,5,9268,16,19984,2480,21,29252,1997
ME,elem and sec health/rec,0,0,0,0,0,0,0,1997
ME,elem and sec student,0,0,0,0,0,0,0,1997
ME,elem and sec unalloc,0,0,0,0,0,0,0,1997
ME,instructional staff,1058,4353807,295,319872,19754,1170,4673679,1997
ME,auxiliary enterprises,2934,7690385,5073,2020953,228042,4223,9711338,1997
ME,education - other,832,2196274,399,192311,18939,938,2388585,1997
ME,libraries,0,0,0,0,0,0,0,1997
ME,liquor stores,123,279504,17,11108,1198,130,290612,1997
ME,other and unallocable,1252,3644944,47,57907,4247,1276,3702851,1997
MD,total,68587,202436549,23923,32203713,2031635,80068,234640262,1997
MD,financial administration,3675,10659273,197,340707,29625,3842,10999980,1997
MD,other government administration,1262,3618734,361,499213,38252,1479,4117947,1997
MD,judicial and legal,3326,9861782,508,904242,75959,3756,10766024,1997
MD,police arrest,1552,5632296,0,0,0,1552,5632296,1997
MD,police other,740,1960776,13,20515,1355,748,1981291,1997
MD,corrections,10282,28641936,578,1077551,90719,10796,29719487,1997
MD,streets and highways,4700,13339452,0,0,0,4700,13339452,1997
MD,air transportation,445,1354693,0,0,0,445,1354693,1997
MD,water transportation,594,1352639,0,0,0,594,1352639,1997
MD,public welfare,6125,14833490,1282,2139910,202233,7268,16973400,1997
MD,health,5102,14462689,1149,1596670,138921,5886,16059359,1997
MD,hospitals,5766,14483306,567,542956,50220,6050,15026262,1997
MD,social insurance administration,732,1959244,196,328077,28665,894,2287321,1997
MD,solid waste management,0,0,0,0,0,0,0,1997
MD,sewage disposal,0,0,0,0,0,0,0,1997
MD,parks and recreation,460,963384,187,262950,29059,624,1226334,1997
MD,housing and community development,0,0,0,0,0,0,0,1997
MD,natural resources,1747,5268886,401,588795,46358,2009,5857681,1997
MD,water transport and terminals,0,0,0,0,0,0,0,1997
MD,electric power,0,0,0,0,0,0,0,1997
MD,gas supply,0,0,0,0,0,0,0,1997
MD,transit,2097,7187775,199,233231,21605,2219,7421006,1997
MD,elem and sec instruction,0,0,0,0,0,0,0,1997
MD,elem and sec admin/cler,0,0,0,0,0,0,0,1997
MD,elem and sec oper/maint,0,0,0,0,0,0,0,1997
MD,elem and sec cafeteria,0,0,0,0,0,0,0,1997
MD,elem and sec bus transit,0,0,0,0,0,0,0,1997
MD,elem and sec health/rec,0,0,0,0,0,0,0,1997
MD,elem and sec student,0,0,0,0,0,0,0,1997
MD,elem and sec unalloc,0,0,0,0,0,0,0,1997
MD,instructional staff,4277,21396236,5956,9988534,360393,6313,31384770,1997
MD,auxiliary enterprises,7242,21010807,10997,11615975,756055,11513,32626782,1997
MD,education - other,1847,5602714,253,398850,25768,1993,6001564,1997
MD,libraries,0,0,0,0,0,0,0,1997
MD,liquor stores,0,0,0,0,0,0,0,1997
MD,other and unallocable,6616,18846437,1079,1665537,136448,7387,20511974,1997
MA,total,78576,245956638,28703,26538371,1894638,89748,272495009,1997
MA,financial administration,4456,14520231,311,464012,27450,4611,14984243,1997
MA,other government administration,1599,3795724,248,973745,31738,1790,4769469,1997
MA,judicial and legal,6425,20115585,261,229945,13289,6502,20345530,1997
MA,police arrest,1598,6042228,0,0,0,1598,6042228,1997
MA,police other,433,1219574,12,25572,1537,442,1245146,1997
MA,corrections,6078,20461685,70,107677,6427,6114,20569362,1997
MA,streets and highways,4310,14856238,149,322458,18570,4415,15178696,1997
MA,air transportation,1019,4136464,25,65120,2816,1035,4201584,1997
MA,water transportation,97,393171,6,13708,593,100,406879,1997
MA,public welfare,7002,21644647,637,1180126,66800,7381,22824773,1997
MA,health,4051,14257707,2390,3803219,231393,5360,18060926,1997
MA,hospitals,16457,40687796,2572,4110822,244799,17840,44798618,1997
MA,social insurance administration,1892,5651152,273,336427,23231,2026,5987579,1997
MA,solid waste management,4,17291,1,4265,133,5,21556,1997
MA,sewage disposal,1122,3200643,13,25400,1493,1130,3226043,1997
MA,parks and recreation,842,2195310,205,396652,33155,1074,2591962,1997
MA,housing and community development,0,0,0,0,0,0,0,1997
MA,natural resources,1273,4480463,93,206749,10546,1336,4687212,1997
MA,water transport and terminals,793,2165617,8,13805,925,799,2179422,1997
MA,electric power,0,0,0,0,0,0,0,1997
MA,gas supply,0,0,0,0,0,0,0,1997
MA,transit,0,0,0,0,0,0,0,1997
MA,elem and sec instruction,0,0,0,0,0,0,0,1997
MA,elem and sec admin/cler,0,0,0,0,0,0,0,1997
MA,elem and sec oper/maint,0,0,0,0,0,0,0,1997
MA,elem and sec cafeteria,0,0,0,0,0,0,0,1997
MA,elem and sec bus transit,0,0,0,0,0,0,0,1997
MA,elem and sec health/rec,0,0,0,0,0,0,0,1997
MA,elem and sec student,0,0,0,0,0,0,0,1997
MA,elem and sec unalloc,0,0,0,0,0,0,0,1997
MA,instructional staff,5393,24172035,7696,7939542,479793,8272,32111577,1997
MA,auxiliary enterprises,9515,27336725,13430,5731874,670728,13526,33068599,1997
MA,education - other,675,2205497,107,161387,8915,729,2366884,1997
MA,libraries,0,0,0,0,0,0,0,1997
MA,liquor stores,0,0,0,0,0,0,0,1997
MA,other and unallocable,3542,12400855,196,425866,20307,3663,12826721,1997
MI,total,109222,377774015,64871,76681398,5061872,137942,454455413,1997
MI,financial administration,2239,7671902,1118,2036051,123207,2936,9707953,1997
MI,other government administration,1485,4666069,26,29556,1797,1495,4695625,1997
MI,judicial and legal,2678,9147978,47,51602,4047,2701,9199580,1997
MI,police arrest,2009,8034367,0,0,0,2009,8034367,1997
MI,police other,927,2217029,167,102223,10153,984,2319252,1997
MI,corrections,16593,55376284,218,428721,19114,16701,55805005,1997
MI,streets and highways,3275,11551888,194,291422,17719,3375,11843310,1997
MI,air transportation,0,0,0,0,0,0,0,1997
MI,water transportation,0,0,0,0,0,0,0,1997
MI,public welfare,13366,42684855,351,551624,31043,13542,43236479,1997
MI,health,1989,6965535,200,209496,13924,2068,7175031,1997
MI,hospitals,11157,36740513,4017,16612140,570603,14381,53352653,1997
MI,social insurance administration,2037,6470240,129,227655,13981,2116,6697895,1997
MI,solid waste management,0,0,0,0,0,0,0,1997
MI,sewage disposal,0,0,0,0,0,0,0,1997
MI,parks and recreation,325,895822,75,110305,7820,369,1006127,1997
MI,housing and community development,0,0,0,0,0,0,0,1997
MI,natural resources,4117,14390670,1093,893817,91859,4636,15284487,1997
MI,water transport and terminals,0,0,0,0,0,0,0,1997
MI,electric power,0,0,0,0,0,0,0,1997
MI,gas supply,0,0,0,0,0,0,0,1997
MI,transit,0,0,0,0,0,0,0,1997
MI,elem and sec instruction,7,16162,1,221,44,7,16383,1997
MI,elem and sec admin/cler,1,4683,1,744,106,2,5427,1997
MI,elem and sec oper/maint,0,0,0,0,0,0,0,1997
MI,elem and sec cafeteria,0,0,0,0,0,0,0,1997
MI,elem and sec bus transit,0,0,0,0,0,0,0,1997
MI,elem and sec health/rec,0,0,0,0,0,0,0,1997
MI,elem and sec student,0,0,0,0,0,0,0,1997
MI,elem and sec unalloc,0,0,0,0,0,0,0,1997
MI,instructional staff,12870,74482356,14371,28979064,1214264,19785,103461420,1997
MI,auxiliary enterprises,27113,71037478,41618,25533065,2899003,43557,96570543,1997
MI,education - other,518,1969315,64,79697,4054,541,2049012,1997
MI,libraries,0,0,0,0,0,0,0,1997
MI,liquor stores,0,0,0,0,0,0,0,1997
MI,other and unallocable,6516,23450869,1181,543995,39134,6737,23994864,1997
MN,total,52759,182255859,33683,37914469,3298188,71399,220170328,1997
MN,financial administration,2359,7706208,188,324251,24952,2501,8030459,1997
MN,other government administration,1057,3411254,451,869008,57566,1385,4280262,1997
MN,judicial and legal,1688,6657923,340,888290,51409,1978,7546213,1997
MN,police arrest,508,2376047,0,0,0,508,2376047,1997
MN,police other,331,1002526,23,27967,2229,344,1030493,1997
MN,corrections,3435,10807327,109,204518,14756,3518,11011845,1997
MN,streets and highways,4820,16843029,213,319416,28202,4979,17162445,1997
MN,air transportation,0,0,0,0,0,0,0,1997
MN,water transportation,0,0,0,0,0,0,0,1997
MN,public welfare,1647,5254783,826,1334874,123654,2346,6589657,1997
MN,health,2009,6691101,138,254480,16047,2101,6945581,1997
MN,hospitals,3603,11829716,1548,2298023,188217,4666,14127739,1997
MN,social insurance administration,1211,3993691,3,4641,275,1213,3998332,1997
MN,solid waste management,0,0,0,0,0,0,0,1997
MN,sewage disposal,0,0,0,0,0,0,0,1997
MN,parks and recreation,474,1552813,112,142163,11433,538,1694976,1997
MN,housing and community development,0,0,0,0,0,0,0,1997
MN,natural resources,2628,8657612,469,662449,58347,2958,9320061,1997
MN,water transport and terminals,0,0,0,0,0,0,0,1997
MN,electric power,0,0,0,0,0,0,0,1997
MN,gas supply,0,0,0,0,0,0,0,1997
MN,transit,0,0,0,0,0,0,0,1997
MN,elem and sec instruction,0,0,0,0,0,0,0,1997
MN,elem and sec admin/cler,0,0,0,0,0,0,0,1997
MN,elem and sec oper/maint,0,0,0,0,0,0,0,1997
MN,elem and sec cafeteria,0,0,0,0,0,0,0,1997
MN,elem and sec bus transit,0,0,0,0,0,0,0,1997
MN,elem and sec health/rec,0,0,0,0,0,0,0,1997
MN,elem and sec student,0,0,0,0,0,0,0,1997
MN,elem and sec unalloc,0,0,0,0,0,0,0,1997
MN,instructional staff,8058,40123767,8979,10648565,643607,11693,50772332,1997
MN,auxiliary enterprises,14346,39814425,19938,19402620,2035330,25846,59217045,1997
MN,education - other,1473,5218491,138,230815,19218,1583,5449306,1997
MN,libraries,0,0,0,0,0,0,0,1997
MN,liquor stores,0,0,0,0,0,0,0,1997
MN,other and unallocable,3112,10315146,208,302389,22946,3242,10617535,1997
MS,total,47626,112857733,10369,6332453,656436,51335,119190186,1997
MS,financial administration,1210,2941582,1,1422,96,1211,2943004,1997
MS,other government administration,392,1059964,80,92479,7524,435,1152443,1997
MS,judicial and legal,412,1798859,6,6503,462,415,1805362,1997
MS,police arrest,590,1622880,0,0,0,590,1622880,1997
MS,police other,389,721386,0,0,0,389,721386,1997
MS,corrections,4108,7323436,12,6811,981,4114,7330247,1997
MS,streets and highways,3334,6736227,2,1888,173,3335,6738115,1997
MS,air transportation,0,0,0,0,0,0,0,1997
MS,water transportation,50,136728,2,2073,359,52,138801,1997
MS,public welfare,3201,6012818,0,0,0,3201,6012818,1997
MS,health,3223,7371935,91,150939,10466,3282,7522874,1997
MS,hospitals,9102,20198306,391,739055,50589,9387,20937361,1997
MS,social insurance administration,847,2015848,240,407922,41280,1080,2423770,1997
MS,solid waste management,0,0,0,0,0,0,0,1997
MS,sewage disposal,0,0,0,0,0,0,0,1997
MS,parks and recreation,301,483058,224,83998,13180,375,567056,1997
MS,housing and community development,0,0,0,0,0,0,0,1997
MS,natural resources,3295,7633640,769,417036,57625,3621,8050676,1997
MS,water transport and terminals,0,0,0,0,0,0,0,1997
MS,electric power,0,0,0,0,0,0,0,1997
MS,gas supply,0,0,0,0,0,0,0,1997
MS,transit,0,0,0,0,0,0,0,1997
MS,elem and sec instruction,0,0,0,0,0,0,0,1997
MS,elem and sec admin/cler,0,0,0,0,0,0,0,1997
MS,elem and sec oper/maint,0,0,0,0,0,0,0,1997
MS,elem and sec cafeteria,0,0,0,0,0,0,0,1997
MS,elem and sec bus transit,0,0,0,0,0,0,0,1997
MS,elem and sec health/rec,0,0,0,0,0,0,0,1997
MS,elem and sec student,0,0,0,0,0,0,0,1997
MS,elem and sec unalloc,0,0,0,0,0,0,0,1997
MS,instructional staff,5418,21423883,2323,1849773,139177,6204,23273656,1997
MS,auxiliary enterprises,7234,15141618,6075,2467138,321541,9050,17608756,1997
MS,education - other,1760,4229110,57,45561,5912,1794,4274671,1997
MS,libraries,0,0,0,0,0,0,0,1997
MS,liquor stores,123,227121,0,0,0,123,227121,1997
MS,other and unallocable,2637,5779334,96,59855,7071,2677,5839189,1997
MO,total,80351,190197646,27052,13231476,1500629,88845,203429122,1997
MO,financial administration,2761,4984830,25,17979,2217,2773,5002809,1997
MO,other government administration,853,1890207,298,484488,35367,1052,2374695,1997
MO,judicial and legal,3292,9070973,179,122980,14465,3374,9193953,1997
MO,police arrest,1208,3810012,0,0,0,1208,3810012,1997
MO,police other,1076,2414760,39,24858,3471,1096,2439618,1997
MO,corrections,8924,16967176,643,123360,20048,9038,17090536,1997
MO,streets and highways,6416,16227906,176,174502,20742,6533,16402408,1997
MO,water transportation,0,0,0,0,0,0,0,1997
MO,air transportation,0,0,0,0,0,0,0,1997
MO,public welfare,7278,13806461,367,317883,31403,7455,14124344,1997
MO,health,4143,8524398,642,335978,30872,4318,8860376,1997
MO,hospitals,13059,26254751,1901,1643564,103304,13642,27898315,1997
MO,social insurance administration,1238,2862159,14,17836,1734,1248,2879995,1997
MO,solid waste management,0,0,0,0,0,0,0,1997
MO,sewage disposal,0,0,0,0,0,0,0,1997
MO,parks and recreation,538,1108622,247,15762,3152,556,1124384,1997
MO,housing and community development,0,0,0,0,0,0,0,1997
MO,natural resources,2470,5869163,703,402095,58916,2804,6271258,1997
MO,water transport and terminals,0,0,0,0,0,0,0,1997
MO,electric power,0,0,0,0,0,0,0,1997
MO,gas supply,0,0,0,0,0,0,0,1997
MO,transit,0,0,0,0,0,0,0,1997
MO,elem and sec instruction,0,0,0,0,0,0,0,1997
MO,elem and sec admin/cler,0,0,0,0,0,0,0,1997
MO,elem and sec oper/maint,0,0,0,0,0,0,0,1997
MO,elem and sec cafeteria,0,0,0,0,0,0,0,1997
MO,elem and sec bus transit,0,0,0,0,0,0,0,1997
MO,elem and sec health/rec,0,0,0,0,0,0,0,1997
MO,elem and sec student,0,0,0,0,0,0,0,1997
MO,elem and sec unalloc,0,0,0,0,0,0,0,1997
MO,instructional staff,7633,31691303,6161,4728869,323546,9463,36420172,1997
MO,auxiliary enterprises,13391,30354637,15045,4448593,816764,18017,34803230,1997
MO,education - other,2055,4589164,274,152888,12346,2125,4742052,1997
MO,libraries,0,0,0,0,0,0,0,1997
MO,liquor stores,0,0,0,0,0,0,0,1997
MO,other and unallocable,4016,9771124,338,219841,22282,4143,9990965,1997
MT,total,14907,38189383,8710,5673644,590875,18248,43863027,1997
MT,financial administration,847,1829892,115,109376,12989,922,1939268,1997
MT,other government administration,300,812372,291,365748,19994,413,1178120,1997
MT,judicial and legal,155,585010,80,256558,7685,199,841568,1997
MT,police arrest,217,545778,3,2318,248,218,548096,1997
MT,police other,200,498506,14,17068,1318,208,515574,1997
MT,corrections,792,1819426,75,65136,6219,827,1884562,1997
MT,streets and highways,1771,4499023,87,101879,9686,1826,4600902,1997
MT,air transportation,0,0,0,0,0,0,0,1997
MT,water transportation,0,0,0,0,0,0,0,1997
MT,public welfare,1352,3240623,192,219027,21195,1471,3459650,1997
MT,health,339,900028,91,109870,7076,380,1009898,1997
MT,hospitals,1106,2332367,321,220809,27155,1259,2553176,1997
MT,social insurance administration,674,1560385,43,49441,4617,700,1609826,1997
MT,solid waste management,0,0,0,0,0,0,0,1997
MT,sewage disposal,0,0,0,0,0,0,0,1997
MT,parks and recreation,52,128056,31,13007,1625,61,141063,1997
MT,housing and community development,0,0,0,0,0,0,0,1997
MT,natural resources,1056,2664127,406,350601,34851,1253,3014728,1997
MT,water transport and terminals,0,0,0,0,0,0,0,1997
MT,electric power,0,0,0,0,0,0,0,1997
MT,gas supply,0,0,0,0,0,0,0,1997
MT,transit,0,0,0,0,0,0,0,1997
MT,elem and sec instruction,0,0,0,0,0,0,0,1997
MT,elem and sec admin/cler,0,0,0,0,0,0,0,1997
MT,elem and sec oper/maint,0,0,0,0,0,0,0,1997
MT,elem and sec cafeteria,0,0,0,0,0,0,0,1997
MT,elem and sec bus transit,0,0,0,0,0,0,0,1997
MT,elem and sec health/rec,0,0,0,0,0,0,0,1997
MT,elem and sec student,0,0,0,0,0,0,0,1997
MT,elem and sec unalloc,0,0,0,0,0,0,0,1997
MT,instructional staff,1683,6955398,1379,1502935,118071,2350,8458333,1997
MT,auxiliary enterprises,2679,5465742,4970,1758317,277361,4247,7224059,1997
MT,education - other,674,1696594,503,399192,28428,834,2095786,1997
MT,libraries,0,0,0,0,0,0,0,1997
MT,liquor stores,73,215927,2,2340,175,74,218267,1997
MT,other and unallocable,937,2440129,107,130022,12182,1006,2570151,1997
NE,total,26079,61229703,9439,5287009,644855,29724,66516712,1997
NE,financial administration,667,1577967,65,35947,5142,696,1613914,1997
NE,other government administration,368,921553,60,38802,6195,403,960355,1997
NE,judicial and legal,701,2563336,64,39637,4060,724,2602973,1997
NE,police arrest,469,1268098,0,0,0,469,1268098,1997
NE,police other,182,422905,6,7065,717,186,429970,1997
NE,corrections,1929,4263708,69,59927,5241,1958,4323635,1997
NE,streets and highways,2307,5494827,10,10926,987,2313,5505753,1997
NE,air transportation,31,82086,0,0,0,31,82086,1997
NE,water transportation,0,0,0,0,0,0,0,1997
NE,public welfare,2730,5853969,127,39513,9296,2783,5893482,1997
NE,health,711,1869775,80,92479,8167,757,1962254,1997
NE,hospitals,3962,8285366,944,1222550,117592,4626,9507916,1997
NE,social insurance administration,457,1175644,16,17759,1577,466,1193403,1997
NE,solid waste management,0,0,0,0,0,0,0,1997
NE,sewage disposal,0,0,0,0,0,0,0,1997
NE,parks and recreation,235,521948,133,83060,14562,317,605008,1997
NE,housing and community development,0,0,0,0,0,0,0,1997
NE,natural resources,1390,2887967,661,362467,53774,1693,3250434,1997
NE,water transport and terminals,0,0,0,0,0,0,0,1997
NE,electric power,0,0,0,0,0,0,0,1997
NE,gas supply,0,0,0,0,0,0,0,1997
NE,transit,0,0,0,0,0,0,0,1997
NE,elem and sec instruction,0,0,0,0,0,0,0,1997
NE,elem and sec admin/cler,0,0,0,0,0,0,0,1997
NE,elem and sec oper/maint,0,0,0,0,0,0,0,1997
NE,elem and sec cafeteria,0,0,0,0,0,0,0,1997
NE,elem and sec bus transit,0,0,0,0,0,0,0,1997
NE,elem and sec health/rec,0,0,0,0,0,0,0,1997
NE,elem and sec student,0,0,0,0,0,0,0,1997
NE,elem and sec unalloc,0,0,0,0,0,0,0,1997
NE,instructional staff,2493,8250557,1253,999599,78897,2938,9250156,1997
NE,auxiliary enterprises,5284,9973234,5718,2105639,324557,7117,12078873,1997
NE,education - other,656,1829289,52,41472,3438,676,1870761,1997
NE,libraries,0,0,0,0,0,0,0,1997
NE,liquor stores,0,0,0,0,0,0,0,1997
NE,other and unallocable,1507,3987474,181,130167,10653,1571,4117641,1997
NV,total,19781,61564738,5659,6353176,564263,22970,67917914,1997
NV,financial administration,1048,2773925,32,29261,2905,1066,2803186,1997
NV,other government administration,827,2980890,89,62849,5549,858,3043739,1997
NV,judicial and legal,441,1843644,11,25365,1191,448,1869009,1997
NV,police arrest,375,1317607,0,0,0,375,1317607,1997
NV,police other,258,551353,0,0,0,258,551353,1997
NV,corrections,2971,8995863,74,132191,7665,3014,9128054,1997
NV,streets and highways,1509,4678879,6,1251,164,1510,4680130,1997
NV,air transportation,0,0,0,0,0,0,0,1997
NV,water transportation,0,0,0,0,0,0,0,1997
NV,public welfare,1074,2917627,33,36199,3480,1094,2953826,1997
NV,health,703,2224602,42,56346,4160,726,2280948,1997
NV,hospitals,1672,4962191,209,300648,22749,1800,5262839,1997
NV,social insurance administration,1412,4259679,18,29458,1997,1423,4289137,1997
NV,solid waste management,0,0,0,0,0,0,0,1997
NV,sewage disposal,0,0,0,0,0,0,0,1997
NV,parks and recreation,193,488790,12,16049,1255,200,504839,1997
NV,housing and community development,0,0,0,0,0,0,0,1997
NV,natural resources,798,2342947,346,311979,33967,990,2654926,1997
NV,water transport and terminals,12,38725,0,0,0,12,38725,1997
NV,electric power,11,33542,0,0,0,11,33542,1997
NV,gas supply,0,0,0,0,0,0,0,1997
NV,transit,0,0,0,0,0,0,0,1997
NV,elem and sec instruction,0,0,0,0,0,0,0,1997
NV,elem and sec admin/cler,0,0,0,0,0,0,0,1997
NV,elem and sec oper/maint,0,0,0,0,0,0,0,1997
NV,elem and sec cafeteria,0,0,0,0,0,0,0,1997
NV,elem and sec bus transit,0,0,0,0,0,0,0,1997
NV,elem and sec health/rec,0,0,0,0,0,0,0,1997
NV,elem and sec student,0,0,0,0,0,0,0,1997
NV,elem and sec unalloc,0,0,0,0,0,0,0,1997
NV,instructional staff,1606,8234090,1447,2602344,139900,2396,10836434,1997
NV,auxiliary enterprises,2980,7037233,3234,2612444,329580,4842,9649677,1997
NV,education - other,74,254767,24,80087,3985,97,334854,1997
NV,libraries,0,0,0,0,0,0,0,1997
NV,liquor stores,0,0,0,0,0,0,0,1997
NV,other and unallocable,1817,5628384,82,56705,5716,1850,5685089,1997
NH,total,14733,38444599,7529,4554138,400528,17029,42998737,1997
NH,financial administration,448,1093436,32,23967,3125,468,1117403,1997
NH,other government administration,289,786586,42,48144,4597,316,834730,1997
NH,judicial and legal,884,2542772,32,25838,1920,896,2568610,1997
NH,police arrest,296,1080662,0,0,0,296,1080662,1997
NH,police other,108,266175,18,11214,1667,117,277389,1997
NH,corrections,1116,2908591,57,52113,5362,1147,2960704,1997
NH,streets and highways,1830,4818485,179,158766,14663,1918,4977251,1997
NH,air transportation,0,0,0,0,0,0,0,1997
NH,water transportation,5,14424,6,3941,492,8,18365,1997
NH,public welfare,1279,3014687,54,42927,4572,1307,3057614,1997
NH,health,846,2355239,76,80502,7080,888,2435741,1997
NH,hospitals,840,1861102,105,141237,4589,866,2002339,1997
NH,social insurance administration,403,969608,61,51839,4794,431,1021447,1997
NH,solid waste management,0,0,0,0,0,0,0,1997
NH,sewage disposal,0,0,0,0,0,0,0,1997
NH,parks and recreation,90,202165,387,233865,31552,268,436030,1997
NH,housing and community development,0,0,0,0,0,0,0,1997
NH,natural resources,400,962204,123,72823,9810,456,1035027,1997
NH,water transport and terminals,0,0,0,0,0,0,0,1997
NH,electric power,0,0,0,0,0,0,0,1997
NH,gas supply,0,0,0,0,0,0,0,1997
NH,transit,0,0,0,0,0,0,0,1997
NH,elem and sec instruction,0,0,0,0,0,0,0,1997
NH,elem and sec admin/cler,0,0,0,0,0,0,0,1997
NH,elem and sec oper/maint,0,0,0,0,0,0,0,1997
NH,elem and sec cafeteria,0,0,0,0,0,0,0,1997
NH,elem and sec bus transit,0,0,0,0,0,0,0,1997
NH,elem and sec health/rec,0,0,0,0,0,0,0,1997
NH,elem and sec student,0,0,0,0,0,0,0,1997
NH,elem and sec unalloc,0,0,0,0,0,0,0,1997
NH,instructional staff,1529,5308013,1508,1421804,61173,1885,6729817,1997
NH,auxiliary enterprises,2164,4532304,4248,1795381,196295,3273,6327685,1997
NH,education - other,304,775150,25,31222,2351,318,806372,1997
NH,libraries,47,104851,5,4160,514,50,109011,1997
NH,liquor stores,296,695780,340,176967,27852,453,872747,1997
NH,other and unallocable,1559,4152365,231,177428,18120,1668,4329793,1997
NJ,total,113514,415329484,23645,20033261,1507776,122919,435362745,1997
NJ,financial administration,4732,15871941,759,987978,99294,5373,16859919,1997
NJ,other government administration,1422,5650551,30,43150,3033,1440,5693701,1997
NJ,judicial and legal,12330,41359712,135,171750,12994,12414,41531462,1997
NJ,police arrest,1099,3298240,10,10791,1085,1106,3309031,1997
NJ,police other,2444,13338402,0,0,0,2444,13338402,1997
NJ,corrections,8346,31337414,29,42945,2657,8363,31380359,1997
NJ,streets and highways,7320,26790322,923,1254895,75686,7748,28045217,1997
NJ,air transportation,0,0,0,0,0,0,0,1997
NJ,water transportation,112,394181,4,4252,531,115,398433,1997
NJ,public welfare,5208,17777127,209,299118,30062,5402,18076245,1997
NJ,health,2530,9524236,369,204465,20548,2662,9728701,1997
NJ,hospitals,15306,45023510,1932,2052692,182385,16475,47076202,1997
NJ,social insurance administration,1654,5251701,587,963936,70565,2109,6215637,1997
NJ,solid waste management,674,2825042,3,1543,155,675,2826585,1997
NJ,sewage disposal,0,0,0,0,0,0,0,1997
NJ,parks and recreation,1593,5115423,1012,752505,67218,1982,5867928,1997
NJ,housing and community development,0,0,0,0,0,0,0,1997
NJ,natural resources,2354,8667532,490,476602,23400,2497,9144134,1997
NJ,water transport and terminals,119,365651,0,0,0,119,365651,1997
NJ,electric power,0,0,0,0,0,0,0,1997
NJ,gas supply,0,0,0,0,0,0,0,1997
NJ,transit,489,1783725,14,21905,1229,496,1805630,1997
NJ,elem and sec instruction,8283,38669702,345,258156,10000,8353,38927858,1997
NJ,elem and sec admin/cler,1284,3051802,3,4256,380,1287,3056058,1997
NJ,elem and sec oper/maint,1246,2993176,14,16796,1680,1258,3009972,1997
NJ,elem and sec cafeteria,875,1463391,289,105750,16000,988,1569141,1997
NJ,elem and sec bus transit,163,310067,8,5856,700,168,315923,1997
NJ,elem and sec health/rec,121,388252,8,7524,700,126,395776,1997
NJ,elem and sec student,0,0,44,10786,2000,14,10786,1997
NJ,elem and sec unalloc,2162,4511926,0,0,0,2162,4511926,1997
NJ,instructional staff,6440,41832277,4456,5626466,271123,8098,47458743,1997
NJ,auxiliary enterprises,15354,50381099,11512,5955436,560321,18844,56336535,1997
NJ,education - other,3347,12688036,274,350698,31879,3553,13038734,1997
NJ,libraries,0,0,0,0,0,0,0,1997
NJ,liquor stores,0,0,0,0,0,0,0,1997
NJ,other and unallocable,6507,24665046,186,403010,22151,6648,25068056,1997
NM,total,36827,89130416,13212,7798556,745279,41039,96928972,1997
NM,financial administration,1679,4405244,7,12193,815,1684,4417437,1997
NM,other government administration,221,622874,8,12805,879,226,635679,1997
NM,judicial and legal,1991,5612304,83,87732,8185,2037,5700036,1997
NM,police arrest,418,1111114,0,0,0,418,1111114,1997
NM,police other,149,237621,0,0,0,149,237621,1997
NM,corrections,3936,8829103,20,43208,3286,3955,8872311,1997
NM,streets and highways,2412,5915564,0,0,0,2412,5915564,1997
NM,air transportation,7,20099,0,0,0,7,20099,1997
NM,water transportation,0,0,0,0,0,0,0,1997
NM,public welfare,1390,3152273,9,13868,903,1395,3166141,1997
NM,health,2617,5374114,181,197758,14390,2698,5571872,1997
NM,hospitals,4662,9048293,1434,2461508,129032,5390,11509801,1997
NM,social insurance administration,474,1134040,1,1900,155,475,1135940,1997
NM,solid waste management,0,0,0,0,0,0,0,1997
NM,sewage disposal,0,0,0,0,0,0,0,1997
NM,parks and recreation,642,1442802,28,47563,3976,664,1490365,1997
NM,housing and community development,0,0,0,0,0,0,0,1997
NM,natural resources,1560,4193568,138,134083,19670,1671,4327651,1997
NM,water transport and terminals,0,0,0,0,0,0,0,1997
NM,electric power,0,0,0,0,0,0,0,1997
NM,gas supply,0,0,0,0,0,0,0,1997
NM,transit,0,0,0,0,0,0,0,1997
NM,elem and sec instruction,0,0,0,0,0,0,0,1997
NM,elem and sec admin/cler,0,0,0,0,0,0,0,1997
NM,elem and sec oper/maint,0,0,0,0,0,0,0,1997
NM,elem and sec cafeteria,0,0,0,0,0,0,0,1997
NM,elem and sec bus transit,0,0,0,0,0,0,0,1997
NM,elem and sec health/rec,0,0,0,0,0,0,0,1997
NM,elem and sec student,0,0,0,0,0,0,0,1997
NM,elem and sec unalloc,0,0,0,0,0,0,0,1997
NM,instructional staff,3153,9934164,2977,2225207,154289,4025,12159371,1997
NM,auxiliary enterprises,8911,21850812,8215,2496500,401517,11180,24347312,1997
NM,education - other,878,2188701,108,62079,7995,924,2250780,1997
NM,libraries,0,0,0,0,0,0,0,1997
NM,liquor stores,0,0,0,0,0,0,0,1997
NM,other and unallocable,1727,4057726,3,2152,187,1729,4059878,1997
NY,total,229945,815131983,45751,46725236,3397363,250078,861857219,1997
NY,financial administration,17639,53142513,1221,1693009,101872,18218,54835522,1997
NY,other government administration,4573,14105495,1242,885089,105473,5169,14990584,1997
NY,judicial and legal,16199,74699527,840,1438169,74670,16621,76137696,1997
NY,police arrest,3955,16646774,0,0,0,3955,16646774,1997
NY,police other,1374,3817420,153,130305,13452,1450,3947725,1997
NY,corrections,33713,113740399,1028,1766497,85060,34197,115506896,1997
NY,streets and highways,13571,40891308,1090,1030866,101640,14146,41922174,1997
NY,air transportation,82,281780,6,17070,985,88,298850,1997
NY,water transportation,858,3213382,53,101603,6201,893,3314985,1997
NY,public welfare,6839,21635429,704,1231120,65658,7216,22866549,1997
NY,health,8229,30914754,966,1914126,104029,8819,32828880,1997
NY,hospitals,46457,146012557,6723,10698559,614632,49959,156711116,1997
NY,social insurance administration,4538,13731000,11,30356,1479,4547,13761356,1997
NY,solid waste management,0,0,0,0,0,0,0,1997
NY,sewage disposal,0,0,0,0,0,0,0,1997
NY,parks and recreation,1789,5220288,960,1087528,127278,2508,6307816,1997
NY,housing and community development,0,0,0,0,0,0,0,1997
NY,natural resources,2879,10525623,470,673494,40751,3108,11199117,1997
NY,water transport and terminals,0,0,0,0,0,0,0,1997
NY,electric power,3375,19408484,127,212706,13497,3451,19621190,1997
NY,gas supply,0,0,0,0,0,0,0,1997
NY,transit,14428,65787388,408,397152,36903,14637,66184540,1997
NY,elem and sec instruction,0,0,0,0,0,0,0,1997
NY,elem and sec admin/cler,0,0,0,0,0,0,0,1997
NY,elem and sec oper/maint,0,0,0,0,0,0,0,1997
NY,elem and sec cafeteria,0,0,0,0,0,0,0,1997
NY,elem and sec bus transit,0,0,0,0,0,0,0,1997
NY,elem and sec health/rec,0,0,0,0,0,0,0,1997
NY,elem and sec student,0,0,0,0,0,0,0,1997
NY,elem and sec unalloc,0,0,0,0,0,0,0,1997
NY,instructional staff,12802,64059233,12226,12384587,694007,17052,76443820,1997
NY,auxiliary enterprises,21641,63892077,15840,8662562,1055750,28162,72554639,1997
NY,education - other,4436,15062412,543,943219,60132,4778,16005631,1997
NY,libraries,0,0,0,0,0,0,0,1997
NY,liquor stores,0,0,0,0,0,0,0,1997
NY,other and unallocable,10568,38344140,1140,1427219,93894,11104,39771359,1997
NC,total,107977,294043283,31312,26576388,2535902,122298,320619671,1997
NC,financial administration,3415,8615052,192,262332,30353,3587,8877384,1997
NC,other government administration,684,2362892,508,896622,73622,1100,3259514,1997
NC,judicial and legal,5438,16761878,221,282165,28294,5598,17044043,1997
NC,police arrest,2245,8137298,3,4437,531,2248,8141735,1997
NC,police other,1032,2578917,11,13330,1375,1040,2592247,1997
NC,corrections,19181,46435142,95,126335,11791,19248,46561477,1997
NC,streets and highways,12314,27205798,12,22450,3188,12332,27228248,1997
NC,air transportation,0,0,0,0,0,0,0,1997
NC,water transportation,304,960580,3,1832,204,305,962412,1997
NC,public welfare,1320,3488183,91,53677,7036,1360,3541860,1997
NC,health,2193,7140709,185,160412,20460,2308,7301121,1997
NC,hospitals,15341,39049594,1409,1337159,82834,15808,40386753,1997
NC,social insurance administration,2317,5856648,240,282529,24534,2455,6139177,1997
NC,solid waste management,160,280896,0,0,0,160,280896,1997
NC,sewage disposal,0,0,0,0,0,0,0,1997
NC,parks and recreation,756,1524710,14,14613,1164,762,1539323,1997
NC,housing and community development,0,0,0,0,0,0,0,1997
NC,natural resources,3484,9026419,1028,2334306,136746,4257,11360725,1997
NC,water transport and terminals,0,0,0,0,0,0,0,1997
NC,electric power,0,0,0,0,0,0,0,1997
NC,gas supply,0,0,0,0,0,0,0,1997
NC,transit,0,0,0,0,0,0,0,1997
NC,elem and sec instruction,0,0,0,0,0,0,0,1997
NC,elem and sec admin/cler,0,0,0,0,0,0,0,1997
NC,elem and sec oper/maint,0,0,0,0,0,0,0,1997
NC,elem and sec cafeteria,0,0,0,0,0,0,0,1997
NC,elem and sec bus transit,0,0,0,0,0,0,0,1997
NC,elem and sec health/rec,0,0,0,0,0,0,0,1997
NC,elem and sec student,0,0,0,0,0,0,0,1997
NC,elem and sec unalloc,0,0,0,0,0,0,0,1997
NC,instructional staff,10725,47627013,9816,12119221,1136370,17144,59746234,1997
NC,auxiliary enterprises,20117,47514813,17202,8325608,943316,25444,55840421,1997
NC,education - other,2818,8306802,124,114249,14130,2897,8421051,1997
NC,libraries,0,0,0,0,0,0,0,1997
NC,liquor stores,0,0,0,0,0,0,0,1997
NC,other and unallocable,4133,11169939,158,225111,19954,4245,11395050,1997
ND,total,12947,32377048,8075,4653386,431465,15384,37030434,1997
ND,financial administration,589,1247487,58,42791,6804,629,1290278,1997
ND,other government administration,166,389532,268,841692,23698,301,1231224,1997
ND,judicial and legal,382,1195120,52,20797,2594,397,1215917,1997
ND,police arrest,131,354436,0,0,0,131,354436,1997
ND,police other,92,186385,3,4447,344,94,190832,1997
ND,corrections,400,884074,45,30110,4145,424,914184,1997
ND,streets and highways,913,2217343,27,20176,2865,929,2237519,1997
ND,air transportation,0,0,0,0,0,0,0,1997
ND,water transportation,0,0,0,0,0,0,0,1997
ND,public welfare,265,547251,43,20304,3316,283,567555,1997
ND,health,1174,2701200,175,155015,13084,1248,2856215,1997
ND,hospitals,1122,2138903,182,42215,7226,1163,2181118,1997
ND,social insurance administration,392,917054,31,22607,2432,405,939661,1997
ND,solid waste management,0,0,0,0,0,0,0,1997
ND,sewage disposal,0,0,0,0,0,0,0,1997
ND,parks and recreation,91,202314,31,21028,2730,107,223342,1997
ND,housing and community development,0,0,0,0,0,0,0,1997
ND,natural resources,874,2339832,633,363772,63423,1232,2703604,1997
ND,water transport and terminals,0,0,0,0,0,0,0,1997
ND,electric power,0,0,0,0,0,0,0,1997
ND,gas supply,0,0,0,0,0,0,0,1997
ND,transit,0,0,0,0,0,0,0,1997
ND,elem and sec instruction,0,0,0,0,0,0,0,1997
ND,elem and sec admin/cler,0,0,0,0,0,0,0,1997
ND,elem and sec oper/maint,0,0,0,0,0,0,0,1997
ND,elem and sec cafeteria,0,0,0,0,0,0,0,1997
ND,elem and sec bus transit,0,0,0,0,0,0,0,1997
ND,elem and sec health/rec,0,0,0,0,0,0,0,1997
ND,elem and sec student,0,0,0,0,0,0,0,1997
ND,elem and sec unalloc,0,0,0,0,0,0,0,1997
ND,instructional staff,1863,7200010,1962,1790091,101063,2432,8990101,1997
ND,auxiliary enterprises,3183,6655623,4303,1089747,181206,4206,7745370,1997
ND,education - other,307,684528,55,31538,3771,329,716066,1997
ND,libraries,0,0,0,0,0,0,0,1997
ND,liquor stores,0,0,0,0,0,0,0,1997
ND,other and unallocable,1003,2515956,207,157056,12764,1074,2673012,1997
OH,total,117668,359909121,61454,46325701,3967958,140137,406234822,1997
OH,financial administration,8240,27122509,522,652532,58776,8573,27775041,1997
OH,other government administration,894,2545180,162,87188,13004,968,2632368,1997
OH,judicial and legal,2302,8134083,70,105898,5949,2336,8239981,1997
OH,police arrest,1307,5565531,0,0,0,1307,5565531,1997
OH,police other,1121,3118769,14,20779,1840,1132,3139548,1997
OH,corrections,16229,47771093,96,135665,10683,16290,47906758,1997
OH,streets and highways,7666,25828145,375,396565,33801,7857,26224710,1997
OH,air transportation,0,0,0,0,0,0,0,1997
OH,water transportation,0,0,0,0,0,0,0,1997
OH,public welfare,2119,7329584,128,107217,14309,2201,7436801,1997
OH,health,3641,13041394,317,241352,25133,3784,13282746,1997
OH,hospitals,14264,34025217,3100,5319733,299007,15954,39344950,1997
OH,social insurance administration,2885,9033634,93,150025,11674,2951,9183659,1997
OH,solid waste management,0,0,0,0,0,0,0,1997
OH,sewage disposal,0,0,0,0,0,0,0,1997
OH,parks and recreation,618,1842621,197,192974,18691,724,2035595,1997
OH,housing and community development,0,0,0,0,0,0,0,1997
OH,natural resources,3330,9483763,827,1060574,84730,3807,10544337,1997
OH,water transport and terminals,0,0,0,0,0,0,0,1997
OH,electric power,0,0,0,0,0,0,0,1997
OH,gas supply,0,0,0,0,0,0,0,1997
OH,transit,0,0,0,0,0,0,0,1997
OH,elem and sec instruction,0,0,0,0,0,0,0,1997
OH,elem and sec admin/cler,0,0,0,0,0,0,0,1997
OH,elem and sec oper/maint,0,0,0,0,0,0,0,1997
OH,elem and sec cafeteria,0,0,0,0,0,0,0,1997
OH,elem and sec bus transit,0,0,0,0,0,0,0,1997
OH,elem and sec health/rec,0,0,0,0,0,0,0,1997
OH,elem and sec student,0,0,0,0,0,0,0,1997
OH,elem and sec unalloc,0,0,0,0,0,0,0,1997
OH,instructional staff,15362,68552361,17229,17972708,1103563,21616,86525069,1997
OH,auxiliary enterprises,30173,70640818,37901,19405246,2252225,42926,90046064,1997
OH,education - other,2175,7595009,122,172759,8907,2225,7767768,1997
OH,libraries,0,0,0,0,0,0,0,1997
OH,liquor stores,2,3897,0,0,0,2,3897,1997
OH,other and unallocable,5340,18275513,301,304486,25666,5484,18579999,1997
OK,total,64342,132334065,20190,11649380,1358022,72088,143983445,1997
OK,financial administration,1929,3804131,16,15477,1061,1934,3819608,1997
OK,other government administration,1126,2376271,175,184442,14753,1210,2560713,1997
OK,judicial and legal,2071,5843846,97,54028,3502,2090,5897874,1997
OK,police arrest,933,2435251,0,0,0,933,2435251,1997
OK,police other,733,1667453,31,17433,2153,745,1684886,1997
OK,corrections,10469,14178399,161,159207,21185,10590,14337606,1997
OK,streets and highways,4175,6775911,0,0,0,4175,6775911,1997
OK,water transportation,0,0,0,0,0,0,0,1997
OK,air transportation,0,0,0,0,0,0,0,1997
OK,public welfare,5776,10079597,159,97491,12561,5847,10177088,1997
OK,health,4007,8591451,188,118069,14613,4089,8709520,1997
OK,hospitals,5666,12984493,284,393114,28418,5827,13377607,1997
OK,social insurance administration,1754,3635496,115,122317,6981,1794,3757813,1997
OK,solid waste management,0,0,0,0,0,0,0,1997
OK,sewage disposal,0,0,0,0,0,0,0,1997
OK,parks and recreation,1505,2256093,541,253922,43937,1754,2510015,1997
OK,housing and community development,0,0,0,0,0,0,0,1997
OK,natural resources,1493,3071075,138,67756,9984,1551,3138831,1997
OK,water transport and terminals,0,0,0,0,0,0,0,1997
OK,electric power,451,1495616,3,1560,260,452,1497176,1997
OK,gas supply,0,0,0,0,0,0,0,1997
OK,transit,0,0,0,0,0,0,0,1997
OK,elem and sec instruction,0,0,0,0,0,0,0,1997
OK,elem and sec admin/cler,0,0,0,0,0,0,0,1997
OK,elem and sec oper/maint,0,0,0,0,0,0,0,1997
OK,elem and sec cafeteria,0,0,0,0,0,0,0,1997
OK,elem and sec bus transit,0,0,0,0,0,0,0,1997
OK,elem and sec health/rec,0,0,0,0,0,0,0,1997
OK,elem and sec student,0,0,0,0,0,0,0,1997
OK,elem and sec unalloc,0,0,0,0,0,0,0,1997
OK,instructional staff,5511,21032361,4970,5492624,357145,7540,26524985,1997
OK,auxiliary enterprises,12488,22686019,13154,4558545,831791,17247,27244564,1997
OK,education - other,2144,4846644,109,73204,6049,2179,4919848,1997
OK,libraries,0,0,0,0,0,0,0,1997
OK,liquor stores,0,0,0,0,0,0,0,1997
OK,other and unallocable,2111,4573958,49,40191,3629,2131,4614149,1997
OR,total,43763,127287168,22531,24149186,1760961,53713,151436354,1997
OR,financial administration,3661,10191141,342,364974,34210,3855,10556115,1997
OR,other government administration,1290,3732269,199,192250,18457,1394,3924519,1997
OR,judicial and legal,2441,6939378,280,677147,49372,2721,7616525,1997
OR,police arrest,901,3387109,52,70054,5200,930,3457163,1997
OR,police other,410,1159169,173,84321,5463,440,1243490,1997
OR,corrections,3313,9683214,304,437779,41345,3547,10120993,1997
OR,streets and highways,3410,8274389,0,0,0,3410,8274389,1997
OR,air transportation,0,0,0,0,0,0,0,1997
OR,water transportation,0,0,0,0,0,0,0,1997
OR,public welfare,4485,11379657,577,1164936,52413,4781,12544593,1997
OR,health,1440,4055128,195,288700,23734,1574,4343828,1997
OR,hospitals,4514,10861195,1892,3488619,432753,6959,14349814,1997
OR,social insurance administration,2061,6485191,219,510268,35688,2263,6995459,1997
OR,solid waste management,0,0,0,0,0,0,0,1997
OR,sewage disposal,0,0,0,0,0,0,0,1997
OR,parks and recreation,304,775322,61,78350,4880,332,853672,1997
OR,housing and community development,0,0,0,0,0,0,0,1997
OR,natural resources,2590,6983481,540,461570,46904,2853,7445051,1997
OR,water transport and terminals,0,0,0,0,0,0,0,1997
OR,electric power,0,0,0,0,0,0,0,1997
OR,gas supply,0,0,0,0,0,0,0,1997
OR,transit,0,0,0,0,0,0,0,1997
OR,elem and sec instruction,0,0,0,0,0,0,0,1997
OR,elem and sec admin/cler,0,0,0,0,0,0,0,1997
OR,elem and sec oper/maint,0,0,0,0,0,0,0,1997
OR,elem and sec cafeteria,0,0,0,0,0,0,0,1997
OR,elem and sec bus transit,0,0,0,0,0,0,0,1997
OR,elem and sec health/rec,0,0,0,0,0,0,0,1997
OR,elem and sec student,0,0,0,0,0,0,0,1997
OR,elem and sec unalloc,0,0,0,0,0,0,0,1997
OR,instructional staff,5006,23024612,7376,12159330,607967,8441,35183942,1997
OR,auxiliary enterprises,4694,10970474,9998,3674305,367430,6770,14644779,1997
OR,education - other,936,2589961,159,341717,22754,1064,2931678,1997
OR,libraries,0,0,0,0,0,0,0,1997
OR,liquor stores,156,418890,24,20510,1655,165,439400,1997
OR,other and unallocable,2151,6376588,140,134356,10736,2214,6510944,1997
PA,total,132698,411226507,48285,41589137,2987250,150371,452815644,1997
PA,financial administration,7091,20714134,639,912773,101092,7700,21626907,1997
PA,other government administration,2861,8166046,1219,1921874,111901,3523,10087920,1997
PA,judicial and legal,2338,9186164,93,442074,15556,2445,9628238,1997
PA,police arrest,5184,18465409,0,0,0,5184,18465409,1997
PA,police other,1157,3109676,132,176686,21919,1289,3286362,1997
PA,corrections,13551,39050547,303,578602,45983,13828,39629149,1997
PA,streets and highways,12942,36734128,819,1315940,135995,13761,38050068,1997
PA,air transportation,95,282444,14,36905,2325,109,319349,1997
PA,water transportation,72,287001,2,13601,332,74,300602,1997
PA,public welfare,11866,34819009,215,384762,31265,12055,35203771,1997
PA,health,1598,5040912,76,150664,4566,1626,5191576,1997
PA,hospitals,15145,37095975,776,1075732,72004,15576,38171707,1997
PA,social insurance administration,4293,12806203,229,436785,37031,4516,13242988,1997
PA,solid waste management,0,0,0,0,0,0,0,1997
PA,sewage disposal,0,0,0,0,0,0,0,1997
PA,parks and recreation,882,2576474,493,827075,75838,1339,3403549,1997
PA,housing and community development,0,0,0,0,0,0,0,1997
PA,natural resources,6663,21140846,1335,1761769,121551,7372,22902615,1997
PA,water transport and terminals,0,0,0,0,0,0,0,1997
PA,electric power,0,0,0,0,0,0,0,1997
PA,gas supply,0,0,0,0,0,0,0,1997
PA,transit,0,0,0,0,0,0,0,1997
PA,elem and sec instruction,0,0,0,0,0,0,0,1997
PA,elem and sec admin/cler,0,0,0,0,0,0,0,1997
PA,elem and sec oper/maint,0,0,0,0,0,0,0,1997
PA,elem and sec cafeteria,0,0,0,0,0,0,0,1997
PA,elem and sec bus transit,0,0,0,0,0,0,0,1997
PA,elem and sec health/rec,0,0,0,0,0,0,0,1997
PA,elem and sec student,0,0,0,0,0,0,0,1997
PA,elem and sec unalloc,0,0,0,0,0,0,0,1997
PA,instructional staff,12485,71307095,9239,16110840,731147,16756,87417935,1997
PA,auxiliary enterprises,24349,60592628,30587,14535070,1369857,32435,75127698,1997
PA,education - other,2823,8518907,209,96820,10636,2887,8615727,1997
PA,libraries,0,0,0,0,0,0,0,1997
PA,liquor stores,2811,7185429,1525,319936,48112,3101,7505365,1997
PA,other and unallocable,4492,14147480,380,491229,50140,4795,14638709,1997
RI,total,17939,58582906,5984,4761913,370652,20177,63344819,1997
RI,financial administration,619,1756194,4,7580,354,621,1763774,1997
RI,other government administration,760,1563073,159,13793,381,762,1576866,1997
RI,judicial and legal,1084,3725745,25,47009,1721,1096,3772754,1997
RI,police arrest,185,971213,0,0,0,185,971213,1997
RI,police other,69,209312,2,436,15,69,209748,1997
RI,corrections,1649,7265308,0,0,0,1649,7265308,1997
RI,streets and highways,874,2624015,17,22536,1710,884,2646551,1997
RI,air transportation,0,0,0,0,0,0,0,1997
RI,water transportation,0,0,0,0,0,0,0,1997
RI,public welfare,1839,6040895,42,54741,3451,1861,6095636,1997
RI,health,1295,4587945,3,8962,377,1297,4596907,1997
RI,hospitals,1229,4017819,36,84686,3930,1251,4102505,1997
RI,social insurance administration,690,1961738,43,67446,5404,725,2029184,1997
RI,solid waste management,75,312050,2,3649,292,77,315699,1997
RI,sewage disposal,259,759479,1,1539,66,259,761018,1997
RI,parks and recreation,75,169856,0,0,0,75,169856,1997
RI,housing and community development,0,0,0,0,0,0,0,1997
RI,natural resources,527,1709795,51,25018,3821,549,1734813,1997
RI,water transport and terminals,0,0,0,0,0,0,0,1997
RI,electric power,0,0,0,0,0,0,0,1997
RI,gas supply,0,0,0,0,0,0,0,1997
RI,transit,503,1554752,9,12614,1098,509,1567366,1997
RI,elem and sec instruction,289,1228542,59,38045,4477,318,1266587,1997
RI,elem and sec admin/cler,29,78440,5,10424,416,32,88864,1997
RI,elem and sec oper/maint,26,66577,3,3232,463,29,69809,1997
RI,elem and sec cafeteria,0,0,25,9726,1769,11,9726,1997
RI,elem and sec bus transit,6,11068,19,19640,2805,24,30708,1997
RI,elem and sec health/rec,5,22691,1,618,86,6,23309,1997
RI,elem and sec student,0,0,0,0,0,0,0,1997
RI,elem and sec unalloc,0,0,16,6629,948,6,6629,1997
RI,instructional staff,1854,7120992,2536,3488420,200077,3077,10609412,1997
RI,auxiliary enterprises,2361,5421864,2744,617080,124790,3090,6038944,1997
RI,education - other,527,2240252,113,179836,8594,582,2420088,1997
RI,libraries,0,0,0,0,0,0,0,1997
RI,liquor stores,0,0,0,0,0,0,0,1997
RI,other and unallocable,1110,3163291,69,38254,3607,1133,3201545,1997
SC,total,72569,174599079,16211,9372336,874012,77783,183971415,1997
SC,financial administration,2865,7143046,26,21658,2496,2880,7164704,1997
SC,other government administration,555,1453896,569,354161,29009,729,1808057,1997
SC,judicial and legal,642,2252994,7,7008,588,645,2260002,1997
SC,police arrest,1316,3682514,0,0,0,1316,3682514,1997
SC,police other,831,1685212,15,12710,1528,840,1697922,1997
SC,corrections,8404,17174034,12,21610,1342,8412,17195644,1997
SC,streets and highways,5019,9439410,11,9872,1148,5026,9449282,1997
SC,water transportation,450,1605150,0,0,0,450,1605150,1997
SC,air transportation,0,0,0,0,0,0,0,1997
SC,public welfare,4982,10553386,13,14406,1198,4990,10567792,1997
SC,health,7804,18499670,229,442702,25172,7955,18942372,1997
SC,hospitals,9405,16052309,255,425209,34785,9607,16477518,1997
SC,social insurance administration,1374,3290990,4,13792,350,1376,3304782,1997
SC,solid waste management,0,0,0,0,0,0,0,1997
SC,sewage disposal,0,0,0,0,0,0,0,1997
SC,parks and recreation,603,1208599,8,6021,924,608,1214620,1997
SC,housing and community development,0,0,0,0,0,0,0,1997
SC,natural resources,2491,6575686,17,17684,1986,2502,6593370,1997
SC,water transport and terminals,0,0,0,0,0,0,0,1997
SC,electric power,1801,6313194,13,13198,1649,1810,6326392,1997
SC,gas supply,0,0,0,0,0,0,0,1997
SC,transit,0,0,0,0,0,0,0,1997
SC,elem and sec instruction,0,0,0,0,0,0,0,1997
SC,elem and sec admin/cler,0,0,0,0,0,0,0,1997
SC,elem and sec oper/maint,0,0,0,0,0,0,0,1997
SC,elem and sec cafeteria,0,0,0,0,0,0,0,1997
SC,elem and sec bus transit,0,0,0,0,0,0,0,1997
SC,elem and sec health/rec,0,0,0,0,0,0,0,1997
SC,elem and sec student,0,0,0,0,0,0,0,1997
SC,elem and sec unalloc,0,0,0,0,0,0,0,1997
SC,instructional staff,7608,31203754,6535,4559481,300912,9416,35763235,1997
SC,auxiliary enterprises,12158,25557841,8432,3376218,465205,14923,28934059,1997
SC,education - other,2818,7021812,47,54690,3806,2841,7076502,1997
SC,libraries,0,0,0,0,0,0,0,1997
SC,liquor stores,0,0,0,0,0,0,0,1997
SC,other and unallocable,1443,3885582,18,21916,1914,1457,3907498,1997
SD,total,11610,28746056,5332,2633694,293464,13270,31379750,1997
SD,financial administration,424,1059325,14,25875,1957,436,1085200,1997
SD,other government administration,260,600450,132,36392,2263,272,636842,1997
SD,judicial and legal,422,1033987,136,324840,14431,504,1358827,1997
SD,police arrest,177,484230,2,1242,210,178,485472,1997
SD,police other,87,168815,2,2371,248,88,171186,1997
SD,corrections,741,1418427,35,30349,3315,761,1448776,1997
SD,streets and highways,1164,2970528,134,132789,15919,1254,3103317,1997
SD,air transportation,0,0,0,0,0,0,0,1997
SD,water transportation,0,0,0,0,0,0,0,1997
SD,public welfare,886,1855130,67,61994,7381,928,1917124,1997
SD,health,453,1130948,102,112899,12905,527,1243847,1997
SD,hospitals,941,1841720,171,129477,14933,1025,1971197,1997
SD,social insurance administration,265,543530,6,6919,735,269,550449,1997
SD,solid waste management,0,0,0,0,0,0,0,1997
SD,sewage disposal,0,0,0,0,0,0,0,1997
SD,parks and recreation,95,216044,33,28554,3945,117,244598,1997
SD,housing and community development,0,0,0,0,0,0,0,1997
SD,natural resources,739,1768547,323,117862,17580,838,1886409,1997
SD,water transport and terminals,0,0,0,0,0,0,0,1997
SD,electric power,0,0,0,0,0,0,0,1997
SD,gas supply,0,0,0,0,0,0,0,1997
SD,transit,0,0,0,0,0,0,0,1997
SD,elem and sec instruction,0,0,0,0,0,0,0,1997
SD,elem and sec admin/cler,0,0,0,0,0,0,0,1997
SD,elem and sec oper/maint,0,0,0,0,0,0,0,1997
SD,elem and sec cafeteria,0,0,0,0,0,0,0,1997
SD,elem and sec bus transit,0,0,0,0,0,0,0,1997
SD,elem and sec health/rec,0,0,0,0,0,0,0,1997
SD,elem and sec student,0,0,0,0,0,0,0,1997
SD,elem and sec unalloc,0,0,0,0,0,0,0,1997
SD,instructional staff,1535,5908743,1010,810973,61198,1881,6719716,1997
SD,auxiliary enterprises,2351,4955352,3055,711438,125745,3060,5666790,1997
SD,education - other,366,831487,45,32103,3875,388,863590,1997
SD,libraries,0,0,0,0,0,0,0,1997
SD,liquor stores,0,0,0,0,0,0,0,1997
SD,other and unallocable,704,1958793,65,67617,6824,744,2026410,1997
TN,total,71363,178302389,22278,19484015,1775944,81759,197786404,1997
TN,financial administration,2484,6325684,52,41538,4360,2511,6367222,1997
TN,other government administration,673,1696062,64,51950,3362,693,1748012,1997
TN,judicial and legal,1838,6552026,66,71360,4744,1868,6623386,1997
TN,police arrest,956,3019840,0,0,0,956,3019840,1997
TN,police other,801,1667196,6,2550,430,804,1669746,1997
TN,corrections,7296,15104510,0,0,0,7296,15104510,1997
TN,streets and highways,4819,10199330,0,0,0,4819,10199330,1997
TN,water transportation,0,0,0,0,0,0,0,1997
TN,air transportation,0,0,0,0,0,0,0,1997
TN,public welfare,4504,10666180,27,20318,1980,4517,10686498,1997
TN,health,2852,7509444,71,85093,5761,2885,7594537,1997
TN,hospitals,10133,24155401,518,1022877,72869,10547,25178278,1997
TN,social insurance administration,1409,3324074,306,357606,36842,1631,3681680,1997
TN,solid waste management,0,0,0,0,0,0,0,1997
TN,sewage disposal,0,0,0,0,0,0,0,1997
TN,parks and recreation,1017,1727262,70,34984,6350,1055,1762246,1997
TN,housing and community development,0,0,0,0,0,0,0,1997
TN,natural resources,3089,7249888,618,528198,66986,3475,7778086,1997
TN,water transport and terminals,0,0,0,0,0,0,0,1997
TN,electric power,0,0,0,0,0,0,0,1997
TN,gas supply,0,0,0,0,0,0,0,1997
TN,transit,0,0,0,0,0,0,0,1997
TN,elem and sec instruction,0,0,0,0,0,0,0,1997
TN,elem and sec admin/cler,0,0,0,0,0,0,0,1997
TN,elem and sec oper/maint,0,0,0,0,0,0,0,1997
TN,elem and sec cafeteria,0,0,0,0,0,0,0,1997
TN,elem and sec bus transit,0,0,0,0,0,0,0,1997
TN,elem and sec health/rec,0,0,0,0,0,0,0,1997
TN,elem and sec student,0,0,0,0,0,0,0,1997
TN,elem and sec unalloc,0,0,0,0,0,0,0,1997
TN,instructional staff,8785,36072164,6877,7906170,566671,12154,43978334,1997
TN,auxiliary enterprises,16377,32637224,13424,9259338,997572,22170,41896562,1997
TN,education - other,1800,4392780,112,71003,4987,1830,4463783,1997
TN,libraries,0,0,0,0,0,0,0,1997
TN,liquor stores,0,0,0,0,0,0,0,1997
TN,other and unallocable,2530,6003324,67,31030,3030,2548,6034354,1997
TX,total,241299,630739373,50641,41748676,3658594,261975,672488049,1997
TX,financial administration,9252,24443875,261,273889,22807,9382,24717764,1997
TX,other government administration,2545,6092544,544,437136,43374,2789,6529680,1997
TX,judicial and legal,4776,15788622,110,150395,10318,4836,15939017,1997
TX,police arrest,1515,4705968,0,0,0,1515,4705968,1997
TX,police other,1930,4962538,43,29266,3440,1949,4991804,1997
TX,corrections,42956,86904457,76,59858,5376,42986,86964315,1997
TX,streets and highways,13941,31455547,136,156495,15865,14031,31612042,1997
TX,water transportation,0,0,0,0,0,0,0,1997
TX,air transportation,0,0,0,0,0,0,0,1997
TX,public welfare,21786,44707818,155,192470,15643,21875,44900288,1997
TX,health,10053,23891728,565,1142432,53263,10354,25034160,1997
TX,hospitals,39888,114618014,1520,1771052,145111,40708,116389066,1997
TX,social insurance administration,5880,14270536,92,103497,12101,5948,14374033,1997
TX,solid waste management,0,0,0,0,0,0,0,1997
TX,sewage disposal,0,0,0,0,0,0,0,1997
TX,parks and recreation,734,1505747,350,268636,40913,965,1774383,1997
TX,housing and community development,0,0,0,0,0,0,0,1997
TX,natural resources,11307,30341359,2857,1920555,171193,12275,32261914,1997
TX,water transport and terminals,0,0,0,0,0,0,0,1997
TX,electric power,0,0,0,0,0,0,0,1997
TX,gas supply,0,0,0,0,0,0,0,1997
TX,transit,0,0,0,0,0,0,0,1997
TX,elem and sec instruction,0,0,0,0,0,0,0,1997
TX,elem and sec admin/cler,0,0,0,0,0,0,0,1997
TX,elem and sec oper/maint,0,0,0,0,0,0,0,1997
TX,elem and sec cafeteria,0,0,0,0,0,0,0,1997
TX,elem and sec bus transit,0,0,0,0,0,0,0,1997
TX,elem and sec health/rec,0,0,0,0,0,0,0,1997
TX,elem and sec student,0,0,0,0,0,0,0,1997
TX,elem and sec unalloc,0,0,0,0,0,0,0,1997
TX,instructional staff,19195,100795037,14519,20836502,1352901,26840,121631539,1997
TX,auxiliary enterprises,44258,97520787,28711,13917773,1730840,54037,111438560,1997
TX,education - other,4742,11352825,168,170155,10663,4802,11522980,1997
TX,libraries,0,0,0,0,0,0,0,1997
TX,liquor stores,0,0,0,0,0,0,0,1997
TX,other and unallocable,6541,17381971,534,318565,24786,6683,17700536,1997
UT,total,40211,104897629,13178,8817999,868860,45144,113715628,1997
UT,financial administration,1426,3821772,179,158122,20164,1540,3979894,1997
UT,other government administration,184,646721,27,30127,2130,197,676848,1997
UT,judicial and legal,1378,4207079,187,173124,16059,1469,4380203,1997
UT,police arrest,382,1194196,0,0,0,382,1194196,1997
UT,police other,302,835344,38,26506,2840,318,861850,1997
UT,corrections,2465,6220543,319,241525,23975,2600,6462068,1997
UT,streets and highways,1726,5130139,66,95313,9336,1779,5225452,1997
UT,air transportation,0,0,0,0,0,0,0,1997
UT,water transportation,0,0,0,0,0,0,0,1997
UT,public welfare,2902,7085897,267,332190,29464,3069,7418087,1997
UT,health,1427,3969767,140,169676,10928,1490,4139443,1997
UT,hospitals,4781,10501670,228,130739,16596,4875,10632409,1997
UT,social insurance administration,575,1572265,189,249181,8413,623,1821446,1997
UT,solid waste management,0,0,0,0,0,0,0,1997
UT,sewage disposal,0,0,0,0,0,0,0,1997
UT,parks and recreation,280,710134,61,56617,6916,320,766751,1997
UT,housing and community development,0,0,0,0,0,0,0,1997
UT,natural resources,995,2811424,201,133668,13743,1072,2945092,1997
UT,water transport and terminals,0,0,0,0,0,0,0,1997
UT,electric power,0,0,0,0,0,0,0,1997
UT,gas supply,0,0,0,0,0,0,0,1997
UT,transit,0,0,0,0,0,0,0,1997
UT,elem and sec instruction,0,0,0,0,0,0,0,1997
UT,elem and sec admin/cler,0,0,0,0,0,0,0,1997
UT,elem and sec oper/maint,0,0,0,0,0,0,0,1997
UT,elem and sec cafeteria,0,0,0,0,0,0,0,1997
UT,elem and sec bus transit,0,0,0,0,0,0,0,1997
UT,elem and sec health/rec,0,0,0,0,0,0,0,1997
UT,elem and sec student,0,0,0,0,0,0,0,1997
UT,elem and sec unalloc,0,0,0,0,0,0,0,1997
UT,instructional staff,4400,21861084,2514,2626183,143902,5224,24487267,1997
UT,auxiliary enterprises,14440,27419536,8058,3945276,519815,17383,31364812,1997
UT,education - other,836,2278901,306,229536,22303,963,2508437,1997
UT,libraries,0,0,0,0,0,0,0,1997
UT,liquor stores,204,428409,160,73985,10667,264,502394,1997
UT,other and unallocable,1508,4202748,238,146231,11609,1576,4348979,1997
VT,total,11363,28957147,2866,1994454,180146,12425,30951601,1997
VT,financial administration,489,1111490,14,19563,2111,501,1131053,1997
VT,other government administration,269,731060,207,64363,2767,285,795423,1997
VT,judicial and legal,506,1532346,63,84847,6760,544,1617193,1997
VT,police arrest,304,1192409,26,7370,753,308,1199779,1997
VT,police other,139,389573,36,31354,3921,161,420927,1997
VT,corrections,861,2007385,27,37135,3472,881,2044520,1997
VT,streets and highways,1100,2659332,7,12008,1140,1106,2671340,1997
VT,air transportation,0,0,0,0,0,0,0,1997
VT,water transportation,0,0,0,0,0,0,0,1997
VT,public welfare,981,1706755,127,191113,17271,1079,1897868,1997
VT,health,462,1210557,80,140241,8486,510,1350798,1997
VT,hospitals,175,363705,9,10886,850,180,374591,1997
VT,social insurance administration,299,747860,21,39509,3412,318,787369,1997
VT,solid waste management,0,0,0,0,0,0,0,1997
VT,sewage disposal,0,0,0,0,0,0,0,1997
VT,parks and recreation,116,311384,8,15170,1065,122,326554,1997
VT,housing and community development,0,0,0,0,0,0,0,1997
VT,natural resources,588,1574821,44,71049,5476,620,1645870,1997
VT,water transport and terminals,0,0,0,0,0,0,0,1997
VT,electric power,0,0,0,0,0,0,0,1997
VT,gas supply,0,0,0,0,0,0,0,1997
VT,transit,0,0,0,0,0,0,0,1997
VT,elem and sec instruction,0,0,0,0,0,0,0,1997
VT,elem and sec admin/cler,0,0,0,0,0,0,0,1997
VT,elem and sec oper/maint,0,0,0,0,0,0,0,1997
VT,elem and sec cafeteria,0,0,0,0,0,0,0,1997
VT,elem and sec bus transit,0,0,0,0,0,0,0,1997
VT,elem and sec health/rec,0,0,0,0,0,0,0,1997
VT,elem and sec student,0,0,0,0,0,0,0,1997
VT,elem and sec unalloc,0,0,0,0,0,0,0,1997
VT,instructional staff,1178,4623412,671,614468,41410,1428,5237880,1997
VT,auxiliary enterprises,2509,5170094,1396,510562,68990,2925,5680656,1997
VT,education - other,366,1055428,38,42587,3752,388,1098015,1997
VT,libraries,0,0,0,0,0,0,0,1997
VT,liquor stores,51,133637,0,0,0,51,133637,1997
VT,other and unallocable,970,2435899,92,102229,8510,1018,2538128,1997
VA,total,90480,246761521,40498,26741039,2660304,105514,273502560,1997
VA,financial administration,3704,9957160,644,635249,68420,4089,10592409,1997
VA,other government administration,590,1808165,234,320473,24752,733,2128638,1997
VA,judicial and legal,2860,9197054,515,447324,25218,3002,9644378,1997
VA,police arrest,1761,5806834,0,0,0,1761,5806834,1997
VA,police other,610,1421492,150,91892,10126,667,1513384,1997
VA,corrections,12938,28777274,461,401374,38340,13154,29178648,1997
VA,streets and highways,9579,26455248,879,359593,37051,9788,26814841,1997
VA,air transportation,0,0,0,0,0,0,0,1997
VA,water transportation,120,355410,0,0,0,120,355410,1997
VA,public welfare,1886,5089516,197,256130,22958,2015,5345646,1997
VA,health,4626,13511426,733,688012,75160,5051,14199438,1997
VA,hospitals,12523,24470081,1323,881906,99189,13085,25351987,1997
VA,social insurance administration,1083,3006120,468,495910,47422,1351,3502030,1997
VA,solid waste management,0,0,0,0,0,0,0,1997
VA,sewage disposal,0,0,0,0,0,0,0,1997
VA,parks and recreation,485,1184836,564,308604,43533,730,1493440,1997
VA,housing and community development,0,0,0,0,0,0,0,1997
VA,natural resources,2691,7913229,536,431356,52150,2987,8344585,1997
VA,water transport and terminals,0,0,0,0,0,0,0,1997
VA,electric power,0,0,0,0,0,0,0,1997
VA,gas supply,0,0,0,0,0,0,0,1997
VA,transit,0,0,0,0,0,0,0,1997
VA,elem and sec instruction,0,0,0,0,0,0,0,1997
VA,elem and sec admin/cler,0,0,0,0,0,0,0,1997
VA,elem and sec oper/maint,0,0,0,0,0,0,0,1997
VA,elem and sec cafeteria,0,0,0,0,0,0,0,1997
VA,elem and sec bus transit,0,0,0,0,0,0,0,1997
VA,elem and sec health/rec,0,0,0,0,0,0,0,1997
VA,elem and sec student,0,0,0,0,0,0,0,1997
VA,elem and sec unalloc,0,0,0,0,0,0,0,1997
VA,instructional staff,10784,48427585,10562,11304340,704456,14764,59731925,1997
VA,auxiliary enterprises,17764,40007191,21403,8526764,1247768,24812,48533955,1997
VA,education - other,2552,7375716,570,530110,46190,2814,7905826,1997
VA,libraries,0,0,0,0,0,0,0,1997
VA,liquor stores,675,1574030,885,669406,83290,1146,2243436,1997
VA,other and unallocable,3249,10423154,374,392596,34281,3445,10815750,1997
WA,total,85091,263586311,48159,43685999,4071188,108093,307272310,1997
WA,financial administration,2440,7686112,209,302414,20374,2555,7988526,1997
WA,other government administration,1349,3910914,208,161096,18930,1457,4072010,1997
WA,judicial and legal,1567,6457080,167,150076,16470,1660,6607156,1997
WA,police arrest,914,3802386,0,0,0,914,3802386,1997
WA,police other,1017,2898720,0,0,0,1017,2898720,1997
WA,corrections,6714,13473026,553,1117250,63194,7071,14590276,1997
WA,streets and highways,6096,21055846,453,793838,45620,6353,21849684,1997
WA,air transportation,0,0,0,0,0,0,0,1997
WA,water transportation,0,0,0,0,0,0,0,1997
WA,public welfare,7228,21910206,797,1134112,71788,7634,23044318,1997
WA,health,6058,21167028,924,1475636,81520,6519,22642664,1997
WA,hospitals,6421,17064520,2453,4371714,193544,7514,21436234,1997
WA,social insurance administration,4289,10183998,621,310254,28138,4449,10494252,1997
WA,solid waste management,0,0,0,0,0,0,0,1997
WA,sewage disposal,0,0,0,0,0,0,0,1997
WA,parks and recreation,489,1177814,77,160440,7154,530,1338254,1997
WA,housing and community development,0,0,0,0,0,0,0,1997
WA,natural resources,4542,12020293,1057,969387,102241,5119,12989680,1997
WA,water transport and terminals,0,0,0,0,0,0,0,1997
WA,electric power,0,0,0,0,0,0,0,1997
WA,gas supply,0,0,0,0,0,0,0,1997
WA,transit,0,0,0,0,0,0,0,1997
WA,elem and sec instruction,0,0,0,0,0,0,0,1997
WA,elem and sec admin/cler,0,0,0,0,0,0,0,1997
WA,elem and sec oper/maint,0,0,0,0,0,0,0,1997
WA,elem and sec cafeteria,0,0,0,0,0,0,0,1997
WA,elem and sec bus transit,0,0,0,0,0,0,0,1997
WA,elem and sec health/rec,0,0,0,0,0,0,0,1997
WA,elem and sec student,0,0,0,0,0,0,0,1997
WA,elem and sec unalloc,0,0,0,0,0,0,0,1997
WA,instructional staff,10965,46229381,10517,10212922,535986,13991,56442303,1997
WA,auxiliary enterprises,19146,57030425,29216,21240496,2789913,34908,78270921,1997
WA,education - other,660,2192316,83,101286,6920,699,2293602,1997
WA,libraries,0,0,0,0,0,0,0,1997
WA,liquor stores,447,1247834,480,660618,56210,765,1908452,1997
WA,other and unallocable,4749,14078412,344,524460,33186,4938,14602872,1997
WV,total,29419,70364762,8325,4929519,489807,32349,75294281,1997
WV,financial administration,1196,2165246,6,5786,502,1200,2171032,1997
WV,other government administration,254,607150,252,611425,28517,428,1218575,1997
WV,judicial and legal,1127,2852248,30,19530,2514,1141,2871778,1997
WV,police arrest,616,1923570,0,0,0,616,1923570,1997
WV,police other,319,533668,10,4984,804,324,538652,1997
WV,corrections,1006,1797232,3,2422,152,1006,1799654,1997
WV,streets and highways,5877,13074071,39,57325,5805,5910,13131396,1997
WV,air transportation,0,0,0,0,0,0,0,1997
WV,water transportation,0,0,0,0,0,0,0,1997
WV,public welfare,78,103366,0,0,0,78,103366,1997
WV,health,698,1442154,18,18184,1800,708,1460338,1997
WV,hospitals,1878,2772002,60,49932,5848,1912,2821934,1997
WV,social insurance administration,780,1571230,17,6488,794,785,1577718,1997
WV,solid waste management,10,25480,0,0,0,10,25480,1997
WV,sewage disposal,0,0,0,0,0,0,0,1997
WV,parks and recreation,427,628700,250,123138,25924,573,751838,1997
WV,housing and community development,0,0,0,0,0,0,0,1997
WV,natural resources,1850,4460486,149,68428,11662,1916,4528914,1997
WV,water transport and terminals,0,0,0,0,0,0,0,1997
WV,electric power,0,0,0,0,0,0,0,1997
WV,gas supply,0,0,0,0,0,0,0,1997
WV,transit,0,0,0,0,0,0,0,1997
WV,elem and sec instruction,0,0,0,0,0,0,0,1997
WV,elem and sec admin/cler,0,0,0,0,0,0,0,1997
WV,elem and sec oper/maint,0,0,0,0,0,0,0,1997
WV,elem and sec cafeteria,0,0,0,0,0,0,0,1997
WV,elem and sec bus transit,0,0,0,0,0,0,0,1997
WV,elem and sec health/rec,0,0,0,0,0,0,0,1997
WV,elem and sec student,0,0,0,0,0,0,0,1997
WV,elem and sec unalloc,0,0,0,0,0,0,0,1997
WV,instructional staff,3321,13982926,4152,2596227,218457,4637,16579153,1997
WV,auxiliary enterprises,6250,13824510,3121,1224961,171172,7279,15049471,1997
WV,education - other,1373,3360896,122,89576,8364,1422,3450472,1997
WV,libraries,0,0,0,0,0,0,0,1997
WV,liquor stores,54,107916,2,2062,274,56,109978,1997
WV,other and unallocable,2305,5131911,94,49051,7218,2348,5180962,1997
WI,total,52275,171881030,24955,32386256,2201165,64709,204267286,1997
WI,financial administration,2494,7170637,1065,1082390,111704,3125,8253027,1997
WI,other government administration,751,2349631,421,570926,31130,925,2920557,1997
WI,judicial and legal,1727,8111136,314,636341,31418,1905,8747477,1997
WI,police arrest,628,1980558,0,0,0,628,1980558,1997
WI,police other,213,579503,24,20296,2094,225,599799,1997
WI,corrections,6726,17503039,790,1195039,81708,7188,18698078,1997
WI,streets and highways,1816,6027159,262,232200,21341,1937,6259359,1997
WI,water transportation,0,0,0,0,0,0,0,1997
WI,air transportation,0,0,0,0,0,0,0,1997
WI,public welfare,871,2388837,381,546196,40425,1099,2935033,1997
WI,health,1657,5593861,534,746975,50254,1941,6340836,1997
WI,hospitals,5715,15391931,3312,4908585,339892,7635,20300516,1997
WI,social insurance administration,833,2297696,50,113277,6485,869,2410973,1997
WI,solid waste management,0,0,0,0,0,0,0,1997
WI,sewage disposal,0,0,0,0,0,0,0,1997
WI,parks and recreation,136,408000,128,116744,10545,196,524744,1997
WI,housing and community development,0,0,0,0,0,0,0,1997
WI,natural resources,2028,5824322,1140,1233573,103047,2612,7057895,1997
WI,water transport and terminals,0,0,0,0,0,0,0,1997
WI,electric power,0,0,0,0,0,0,0,1997
WI,gas supply,0,0,0,0,0,0,0,1997
WI,transit,0,0,0,0,0,0,0,1997
WI,elem and sec instruction,0,0,0,0,0,0,0,1997
WI,elem and sec admin/cler,0,0,0,0,0,0,0,1997
WI,elem and sec oper/maint,0,0,0,0,0,0,0,1997
WI,elem and sec cafeteria,0,0,0,0,0,0,0,1997
WI,elem and sec bus transit,0,0,0,0,0,0,0,1997
WI,elem and sec health/rec,0,0,0,0,0,0,0,1997
WI,elem and sec student,0,0,0,0,0,0,0,1997
WI,elem and sec unalloc,0,0,0,0,0,0,0,1997
WI,instructional staff,7390,35834091,6061,7927382,448301,9923,43761473,1997
WI,auxiliary enterprises,13263,41531578,8697,11058096,773165,17631,52589674,1997
WI,education - other,1071,3372681,311,216422,24029,1206,3589103,1997
WI,libraries,0,0,0,0,0,0,0,1997
WI,liquor stores,0,0,0,0,0,0,0,1997
WI,other and unallocable,4956,15516370,1465,1781814,125627,5664,17298184,1997
WY,total,9711,21654560,3113,1685549,231687,11023,23340109,1997
WY,financial administration,457,1125073,1,1037,117,458,1126110,1997
WY,other government administration,88,242220,71,9730,751,93,251950,1997
WY,judicial and legal,356,1038018,33,40740,2890,372,1078758,1997
WY,police arrest,116,308908,0,0,0,116,308908,1997
WY,police other,78,207063,0,0,0,78,207063,1997
WY,corrections,704,1451861,2,2389,247,705,1454250,1997
WY,streets and highways,1842,3745253,95,123498,16100,1933,3868751,1997
WY,water transportation,0,0,0,0,0,0,0,1997
WY,air transportation,0,0,0,0,0,0,0,1997
WY,public welfare,571,1099713,48,38795,6215,607,1138508,1997
WY,health,460,1139296,92,128845,11400,525,1268141,1997
WY,hospitals,901,1643812,52,85360,5828,934,1729172,1997
WY,social insurance administration,300,667941,0,0,0,300,667941,1997
WY,solid waste management,0,0,0,0,0,0,0,1997
WY,sewage disposal,0,0,0,0,0,0,0,1997
WY,parks and recreation,101,224242,5,4634,457,104,228876,1997
WY,housing and community development,0,0,0,0,0,0,0,1997
WY,natural resources,632,1619615,24,26389,2848,648,1646004,1997
WY,water transport and terminals,0,0,0,0,0,0,0,1997
WY,electric power,0,0,0,0,0,0,0,1997
WY,gas supply,0,0,0,0,0,0,0,1997
WY,transit,0,0,0,0,0,0,0,1997
WY,elem and sec instruction,0,0,0,0,0,0,0,1997
WY,elem and sec admin/cler,0,0,0,0,0,0,0,1997
WY,elem and sec oper/maint,0,0,0,0,0,0,0,1997
WY,elem and sec cafeteria,0,0,0,0,0,0,0,1997
WY,elem and sec bus transit,0,0,0,0,0,0,0,1997
WY,elem and sec health/rec,0,0,0,0,0,0,0,1997
WY,elem and sec student,0,0,0,0,0,0,0,1997
WY,elem and sec unalloc,0,0,0,0,0,0,0,1997
WY,instructional staff,744,2404750,672,541899,44527,996,2946649,1997
WY,auxiliary enterprises,1438,2733085,1915,601703,130956,2178,3334788,1997
WY,education - other,139,344879,12,6557,751,143,351436,1997
WY,libraries,0,0,0,0,0,0,0,1997
WY,liquor stores,33,54149,0,0,0,33,54149,1997
WY,other and unallocable,751,1604682,91,73973,8600,800,1678655,1997
