state,government_function,full_time_employees,full_time_pay,part_time_employees,part_time_pay,part_time_hours,full_time_equivalent_employees,total_march_pay,year
US,total,3474525,10728268267,1283902,1116950575,89269654,3985350,11845218842,1998
US,financial administration,155483,460227158,14475,17360887,1498031,164095,477588045,1998
US,other government administration,47344,144345697,11453,16046883,1094942,53684,160392580,1998
US,judicial and legal,134372,478975282,9278,14333260,923295,139678,493308542,1998
US,police arrest,55018,209448436,507,592545,36504,55224,210040981,1998
US,police other,36897,106781762,2206,2176951,181678,37932,108958713,1998
US,corrections,437455,1220595993,29779,18206737,1275115,444711,1238802730,1998
US,streets and highways,235181,689308764,11247,16167999,1176559,241896,705476763,1998
US,air transportation,2717,9126964,179,217841,10347,2775,9344805,1998
US,water transportation,4731,15145664,148,188935,14421,4811,15334599,1998
US,public welfare,217949,575576620,10222,15151105,1125027,224397,590727725,1998
US,health,159194,460778423,13922,19964163,1362290,166930,480742586,1998
US,hospitals,396055,1089733635,57137,92666139,6093154,430763,1182399774,1998
US,social insurance administration,84616,249436915,8019,13012429,950723,90081,262449344,1998
US,solid waste management,1363,5520014,73,154225,8034,1408,5674239,1998
US,sewage disposal,1482,5723852,42,117772,5164,1511,5841624,1998
US,parks and recreation,26656,65195335,11952,10300443,1186766,33434,75495778,1998
US,housing and community development,0,0,0,0,0,0,0,1998
US,natural resources,127523,378428989,35445,34754069,3342813,146569,413183058,1998
US,water transport and terminals,841,2939731,19,46035,2196,854,2985766,1998
US,electric power,5360,27914543,120,202728,10797,5424,28117271,1998
US,gas supply,0,0,0,0,0,0,0,1998
US,transit,18100,78214939,767,773534,74523,18520,78988473,1998
US,elem and sec instruction,29856,105632292,7874,5380120,324810,31908,111012412,1998
US,elem and sec admin/cler,3529,8962028,180,129617,9261,3588,9091645,1998
US,elem and sec oper/maint,3029,5941746,2406,1107959,105696,3672,7049705,1998
US,elem and sec cafeteria,2370,3868533,700,301780,34707,2610,4170313,1998
US,elem and sec bus transit,179,345941,64,69323,6927,228,415264,1998
US,elem and sec health/rec,258,866173,247,471381,27994,427,1337554,1998
US,elem and sec student,0,0,551,88250,13561,83,88250,1998
US,elem and sec unalloc,2453,5097767,1423,273757,33701,2659,5371524,1998
US,higher ed - instructional,338464,1648076457,312789,395123092,21499190,461580,2043199549,1998
US,education - higher education other,657405,1761716202,702538,404007419,43988355,908905,2165723621,1998
US,education - other,88601,267754422,18041,16902744,1239372,95716,284657166,1998
US,libraries,563,1324450,239,128081,12305,636,1452531,1998
US,liquor stores,5779,14525086,2931,1955993,217417,7035,16481079,1998
US,other and unallocable,193702,630738454,16929,18576379,1383979,201606,649314833,1998
AL,total,72982,186323759,23224,17561670,1659561,82483,203885429,1998
AL,financial administration,2591,7153069,140,102167,12802,2663,7255236,1998
AL,other government administration,450,1290516,53,100312,4117,475,1390828,1998
AL,judicial and legal,2882,8538955,143,172225,18617,2987,8711180,1998
AL,police arrest,774,3108989,0,0,0,774,3108989,1998
AL,police other,449,1207889,39,16574,2221,462,1224463,1998
AL,corrections,4374,10472180,15,12890,1428,4382,10485070,1998
AL,streets and highways,3720,9050263,56,43029,4959,3748,9093292,1998
AL,air transportation,0,0,0,0,0,0,0,1998
AL,water transportation,440,1115440,1,600,48,440,1116040,1998
AL,public welfare,3823,9402057,35,46778,3388,3842,9448835,1998
AL,health,7018,15329980,681,592889,87533,7513,15922869,1998
AL,hospitals,10796,22089458,1227,1698937,101410,11369,23788395,1998
AL,social insurance administration,1449,3327339,48,23659,3775,1470,3350998,1998
AL,solid waste management,0,0,0,0,0,0,0,1998
AL,sewage disposal,0,0,0,0,0,0,0,1998
AL,parks and recreation,465,868513,485,337602,63717,825,1206115,1998
AL,housing and community development,0,0,0,0,0,0,0,1998
AL,natural resources,2211,6015469,439,253117,36885,2418,6268586,1998
AL,water transport and terminals,0,0,0,0,0,0,0,1998
AL,electric power,0,0,0,0,0,0,0,1998
AL,gas supply,0,0,0,0,0,0,0,1998
AL,transit,0,0,0,0,0,0,0,1998
AL,elem and sec instruction,0,0,0,0,0,0,0,1998
AL,elem and sec admin/cler,0,0,0,0,0,0,0,1998
AL,elem and sec oper/maint,0,0,0,0,0,0,0,1998
AL,elem and sec cafeteria,0,0,0,0,0,0,0,1998
AL,elem and sec bus transit,0,0,0,0,0,0,0,1998
AL,elem and sec health/rec,0,0,0,0,0,0,0,1998
AL,elem and sec student,0,0,0,0,0,0,0,1998
AL,elem and sec unalloc,0,0,0,0,0,0,0,1998
AL,higher ed - instructional,8721,35640935,5982,6984787,405456,11047,42625722,1998
AL,education - higher education other,16977,35889116,12598,6233407,821402,21705,42122523,1998
AL,education - other,3191,9126088,706,455596,32385,3376,9581684,1998
AL,libraries,0,0,0,0,0,0,0,1998
AL,liquor stores,641,1302088,0,0,0,641,1302088,1998
AL,other and unallocable,2010,5395415,576,487101,59418,2346,5882516,1998
AK,total,20447,77257277,5093,4175369,291706,22147,81432646,1998
AK,financial administration,941,3550064,22,29460,1754,953,3579524,1998
AK,other government administration,528,1890470,46,49814,3467,549,1940284,1998
AK,judicial and legal,1149,4783285,81,98373,5047,1179,4881658,1998
AK,police arrest,250,1457003,0,0,0,250,1457003,1998
AK,police other,172,555216,59,16025,1408,180,571241,1998
AK,corrections,1282,5218701,3,5253,288,1284,5223954,1998
AK,streets and highways,2621,10668244,14,17976,1324,2629,10686220,1998
AK,water transportation,0,0,0,0,0,0,0,1998
AK,air transportation,0,0,0,0,0,0,0,1998
AK,public welfare,1764,5756098,171,195839,19638,1883,5951937,1998
AK,health,606,2279973,34,46147,2702,623,2326120,1998
AK,hospitals,220,749677,7,11211,572,223,760888,1998
AK,social insurance administration,396,1397021,3,4647,233,397,1401668,1998
AK,solid waste management,0,0,0,0,0,0,0,1998
AK,sewage disposal,0,0,0,0,0,0,0,1998
AK,parks and recreation,87,288031,0,0,0,87,288031,1998
AK,housing and community development,0,0,0,0,0,0,0,1998
AK,natural resources,1961,7525453,66,95564,6670,2001,7621017,1998
AK,water transport and terminals,0,0,0,0,0,0,0,1998
AK,electric power,0,0,0,0,0,0,0,1998
AK,gas supply,0,0,0,0,0,0,0,1998
AK,transit,0,0,0,0,0,0,0,1998
AK,elem and sec instruction,1888,7246361,526,393832,30284,2077,7640193,1998
AK,elem and sec admin/cler,299,941554,104,88926,5556,334,1030480,1998
AK,elem and sec oper/maint,239,665834,150,165683,11448,311,831517,1998
AK,elem and sec cafeteria,95,181684,106,99218,7227,141,280902,1998
AK,elem and sec bus transit,2,3686,16,9969,1053,9,13655,1998
AK,elem and sec health/rec,15,16119,5,2833,210,16,18952,1998
AK,elem and sec student,0,0,20,1058,180,0,1058,1998
AK,elem and sec unalloc,153,438757,7,5053,428,156,443810,1998
AK,higher ed - instructional,934,5049445,1448,1438312,47094,1200,6487757,1998
AK,education - higher education other,2154,6287539,2105,1283910,138191,2934,7571449,1998
AK,education - other,466,1643000,42,29904,2074,478,1672904,1998
AK,libraries,0,0,0,0,0,0,0,1998
AK,liquor stores,0,0,0,0,0,0,0,1998
AK,other and unallocable,2225,8664062,58,86362,4858,2253,8750424,1998
AZ,total,53124,151163896,23067,18210748,1553311,61904,169374644,1998
AZ,financial administration,3476,8681160,24,37711,2433,3491,8718871,1998
AZ,other government administration,606,1598137,111,140357,5972,640,1738494,1998
AZ,judicial and legal,1316,4529425,93,211612,7592,1359,4741037,1998
AZ,police arrest,956,3465835,0,0,0,956,3465835,1998
AZ,police other,753,2096517,12,5181,445,756,2101698,1998
AZ,corrections,8126,20489871,73,130790,5883,8159,20620661,1998
AZ,streets and highways,3034,8570897,0,0,0,3034,8570897,1998
AZ,air transportation,0,0,0,0,0,0,0,1998
AZ,water transportation,0,0,0,0,0,0,0,1998
AZ,public welfare,5770,12815929,132,133794,10838,5832,12949723,1998
AZ,health,2038,5007689,38,49592,4129,2061,5057281,1998
AZ,hospitals,648,1457647,38,52594,3436,667,1510241,1998
AZ,social insurance administration,1871,4315168,186,177618,17493,1970,4492786,1998
AZ,solid waste management,0,0,0,0,0,0,0,1998
AZ,sewage disposal,0,0,0,0,0,0,0,1998
AZ,parks and recreation,289,697505,152,119024,13038,362,816529,1998
AZ,housing and community development,0,0,0,0,0,0,0,1998
AZ,natural resources,2096,5984718,689,591025,56658,2417,6575743,1998
AZ,water transport and terminals,0,0,0,0,0,0,0,1998
AZ,electric power,8,29102,5,210,15,8,29312,1998
AZ,gas supply,0,0,0,0,0,0,0,1998
AZ,transit,0,0,0,0,0,0,0,1998
AZ,elem and sec instruction,0,0,0,0,0,0,0,1998
AZ,elem and sec admin/cler,0,0,0,0,0,0,0,1998
AZ,elem and sec oper/maint,0,0,0,0,0,0,0,1998
AZ,elem and sec cafeteria,0,0,0,0,0,0,0,1998
AZ,elem and sec bus transit,0,0,0,0,0,0,0,1998
AZ,elem and sec health/rec,0,0,0,0,0,0,0,1998
AZ,elem and sec student,0,0,0,0,0,0,0,1998
AZ,elem and sec unalloc,0,0,0,0,0,0,0,1998
AZ,higher ed - instructional,4789,25193534,5837,7221091,448644,7323,32414625,1998
AZ,education - higher education other,11408,32038087,15183,8653768,938572,16711,40691855,1998
AZ,education - other,2558,5906720,392,609272,32003,2739,6515992,1998
AZ,libraries,0,0,0,0,0,0,0,1998
AZ,liquor stores,0,0,0,0,0,0,0,1998
AZ,other and unallocable,3382,8285955,102,77109,6160,3419,8363064,1998
AR,total,45809,117413758,10853,7613432,625419,49351,125027190,1998
AR,financial administration,1769,4041914,116,99262,15581,1856,4141176,1998
AR,other government administration,490,1352533,107,117886,4365,516,1470419,1998
AR,judicial and legal,394,1802475,8,6532,523,396,1809007,1998
AR,police arrest,597,1732105,0,0,0,597,1732105,1998
AR,police other,485,1056497,0,0,0,485,1056497,1998
AR,corrections,3513,7048405,7,6453,852,3518,7054858,1998
AR,streets and highways,3550,9121603,51,31837,4782,3577,9153440,1998
AR,air transportation,0,0,0,0,0,0,0,1998
AR,water transportation,0,0,0,0,0,0,0,1998
AR,public welfare,3663,7092286,0,0,0,3663,7092286,1998
AR,health,4889,10854721,94,79474,8666,4939,10934195,1998
AR,hospitals,4398,10295043,101,212710,14466,4480,10507753,1998
AR,social insurance administration,881,2493196,224,219875,27483,1036,2713071,1998
AR,solid waste management,0,0,0,0,0,0,0,1998
AR,sewage disposal,0,0,0,0,0,0,0,1998
AR,parks and recreation,556,1086797,244,132966,24133,692,1219763,1998
AR,housing and community development,0,0,0,0,0,0,0,1998
AR,natural resources,2078,4937698,183,140749,22606,2207,5078447,1998
AR,water transport and terminals,0,0,0,0,0,0,0,1998
AR,electric power,0,0,0,0,0,0,0,1998
AR,gas supply,0,0,0,0,0,0,0,1998
AR,transit,0,0,0,0,0,0,0,1998
AR,elem and sec instruction,0,0,0,0,0,0,0,1998
AR,elem and sec admin/cler,0,0,0,0,0,0,0,1998
AR,elem and sec oper/maint,0,0,0,0,0,0,0,1998
AR,elem and sec cafeteria,0,0,0,0,0,0,0,1998
AR,elem and sec bus transit,0,0,0,0,0,0,0,1998
AR,elem and sec health/rec,0,0,0,0,0,0,0,1998
AR,elem and sec student,0,0,0,0,0,0,0,1998
AR,elem and sec unalloc,0,0,0,0,0,0,0,1998
AR,higher ed - instructional,4899,21209855,3752,3560574,157046,5788,24770429,1998
AR,education - higher education other,8943,21338343,5107,2461293,292735,10599,23799636,1998
AR,education - other,2604,6518884,717,422536,40594,2838,6941420,1998
AR,libraries,0,0,0,0,0,0,0,1998
AR,liquor stores,0,0,0,0,0,0,0,1998
AR,other and unallocable,2100,5431403,142,121285,11587,2164,5552688,1998
CA,total,281873,1123982760,131677,140432634,9463649,335353,1264415394,1998
CA,financial administration,16331,56352908,3594,3674868,365185,18397,60027776,1998
CA,other government administration,3439,13221791,397,696710,40173,3681,13918501,1998
CA,judicial and legal,2949,14270444,284,598916,24439,3087,14869360,1998
CA,police arrest,7036,31238670,351,408117,22030,7160,31646787,1998
CA,police other,4885,14756690,657,689885,44321,5135,15446575,1998
CA,corrections,43096,165244914,3376,7400552,458434,45686,172645466,1998
CA,streets and highways,16060,81765815,969,2879414,137642,16838,84645229,1998
CA,air transportation,0,0,0,0,0,0,0,1998
CA,water transportation,67,247469,18,9653,900,72,257122,1998
CA,public welfare,3504,11938825,370,528386,32482,3688,12467211,1998
CA,health,10097,39308961,1276,2296133,118177,10764,41605094,1998
CA,hospitals,27222,104079289,7168,13576302,712447,31246,117655591,1998
CA,social insurance administration,15253,52740732,2694,5511878,345379,17204,58252610,1998
CA,solid waste management,326,1382000,51,135943,6098,360,1517943,1998
CA,sewage disposal,0,0,0,0,0,0,0,1998
CA,parks and recreation,1889,6305635,1507,1759850,171663,2859,8065485,1998
CA,housing and community development,0,0,0,0,0,0,0,1998
CA,natural resources,11113,42444571,3599,4207646,480638,13826,46652217,1998
CA,water transport and terminals,0,0,0,0,0,0,0,1998
CA,electric power,0,0,0,0,0,0,0,1998
CA,gas supply,0,0,0,0,0,0,0,1998
CA,transit,0,0,0,0,0,0,0,1998
CA,elem and sec instruction,0,0,0,0,0,0,0,1998
CA,elem and sec admin/cler,0,0,0,0,0,0,0,1998
CA,elem and sec oper/maint,0,0,0,0,0,0,0,1998
CA,elem and sec cafeteria,0,0,0,0,0,0,0,1998
CA,elem and sec bus transit,0,0,0,0,0,0,0,1998
CA,elem and sec health/rec,0,0,0,0,0,0,0,1998
CA,elem and sec student,0,0,0,0,0,0,0,1998
CA,elem and sec unalloc,0,0,0,0,0,0,0,1998
CA,higher ed - instructional,18781,109391644,25627,34456081,1809193,29003,143847725,1998
CA,education - higher education other,60527,215414651,77001,57111717,4456012,85703,272526368,1998
CA,education - other,4326,15153633,744,1078659,72870,4739,16232292,1998
CA,libraries,0,0,0,0,0,0,0,1998
CA,liquor stores,0,0,0,0,0,0,0,1998
CA,other and unallocable,34972,148724118,1994,3411924,165566,35905,152136042,1998
CO,total,43351,154086297,34800,56008180,3207793,61476,210094477,1998
CO,financial administration,1943,6543020,165,230418,12061,2013,6773438,1998
CO,other government administration,457,1330744,112,235021,18354,561,1565765,1998
CO,judicial and legal,2721,9506257,711,1250442,65508,3091,10756699,1998
CO,police arrest,867,2989659,0,0,0,867,2989659,1998
CO,police other,426,1355946,46,87328,4682,452,1443274,1998
CO,corrections,4863,14888060,77,149008,8342,4910,15037068,1998
CO,streets and highways,2963,9606866,198,339201,18515,3068,9946067,1998
CO,air transportation,0,0,0,0,0,0,0,1998
CO,water transportation,0,0,0,0,0,0,0,1998
CO,public welfare,1759,5778800,174,257250,13860,1837,6036050,1998
CO,health,1023,4130214,132,254138,11316,1087,4384352,1998
CO,hospitals,3249,9273462,969,1646766,100259,3815,10920228,1998
CO,social insurance administration,893,3118954,79,110249,5588,925,3229203,1998
CO,solid waste management,0,0,0,0,0,0,0,1998
CO,sewage disposal,0,0,0,0,0,0,0,1998
CO,parks and recreation,189,716464,100,68980,4693,216,785444,1998
CO,housing and community development,0,0,0,0,0,0,0,1998
CO,natural resources,1247,4888499,279,285327,13283,1322,5173826,1998
CO,water transport and terminals,0,0,0,0,0,0,0,1998
CO,electric power,0,0,0,0,0,0,0,1998
CO,gas supply,0,0,0,0,0,0,0,1998
CO,transit,0,0,0,0,0,0,0,1998
CO,elem and sec instruction,0,0,0,0,0,0,0,1998
CO,elem and sec admin/cler,0,0,0,0,0,0,0,1998
CO,elem and sec oper/maint,0,0,0,0,0,0,0,1998
CO,elem and sec cafeteria,0,0,0,0,0,0,0,1998
CO,elem and sec bus transit,0,0,0,0,0,0,0,1998
CO,elem and sec health/rec,0,0,0,0,0,0,0,1998
CO,elem and sec student,0,0,0,0,0,0,0,1998
CO,elem and sec unalloc,0,0,0,0,0,0,0,1998
CO,higher ed - instructional,8877,44352480,9179,23007348,790917,13346,67359828,1998
CO,education - higher education other,9419,27149238,21778,27106007,2085506,21201,54255245,1998
CO,education - other,967,3099948,700,813101,46249,1229,3913049,1998
CO,libraries,0,0,0,0,0,0,0,1998
CO,liquor stores,0,0,0,0,0,0,0,1998
CO,other and unallocable,1488,5357686,101,167596,8660,1536,5525282,1998
CT,total,55629,203288358,15125,14810765,847727,60853,218099123,1998
CT,financial administration,2586,8880956,55,112148,6577,2628,8993104,1998
CT,other government administration,1176,3987047,66,129935,6951,1217,4116982,1998
CT,judicial and legal,3577,11482760,94,231894,10348,3644,11714654,1998
CT,police arrest,1035,4793959,1,2827,111,1036,4796786,1998
CT,police other,559,1871023,38,71292,4556,588,1942315,1998
CT,corrections,8541,28094985,53,103936,4407,8569,28198921,1998
CT,streets and highways,3547,12779487,14,17816,1018,3553,12797303,1998
CT,air transportation,116,393348,0,0,0,116,393348,1998
CT,water transportation,0,0,0,0,0,0,0,1998
CT,public welfare,4412,15473161,156,390183,18638,4533,15863344,1998
CT,health,1867,6534813,64,111033,5763,1901,6645846,1998
CT,hospitals,8833,34712435,1778,3490197,182137,9940,38202632,1998
CT,social insurance administration,944,3276284,11,32962,1397,953,3309246,1998
CT,solid waste management,49,243108,0,0,0,49,243108,1998
CT,sewage disposal,0,0,0,0,0,0,0,1998
CT,parks and recreation,373,1303386,35,57949,6438,415,1361335,1998
CT,housing and community development,0,0,0,0,0,0,0,1998
CT,natural resources,547,1914110,37,67235,5431,582,1981345,1998
CT,water transport and terminals,0,0,0,0,0,0,0,1998
CT,electric power,0,0,0,0,0,0,0,1998
CT,gas supply,0,0,0,0,0,0,0,1998
CT,transit,0,0,0,0,0,0,0,1998
CT,elem and sec instruction,2287,11096104,650,814927,67910,2765,11911031,1998
CT,elem and sec admin/cler,290,1016512,0,0,0,290,1016512,1998
CT,elem and sec oper/maint,248,232128,0,0,0,248,232128,1998
CT,elem and sec cafeteria,101,94536,253,65357,7873,156,159893,1998
CT,elem and sec bus transit,1,1128,0,0,0,1,1128,1998
CT,elem and sec health/rec,53,189314,0,0,0,53,189314,1998
CT,elem and sec student,0,0,60,6166,1027,7,6166,1998
CT,elem and sec unalloc,114,118490,0,0,0,114,118490,1998
CT,higher ed - instructional,3527,17020652,3288,3709244,166564,4517,20729896,1998
CT,education - higher education other,5925,21769274,8117,4817228,312126,7806,26586502,1998
CT,education - other,2678,8199332,228,356943,23563,2831,8556275,1998
CT,libraries,0,0,0,0,0,0,0,1998
CT,liquor stores,0,0,0,0,0,0,0,1998
CT,other and unallocable,2243,7810026,127,221493,14892,2341,8031519,1998
DE,total,19480,56838265,7444,5605996,432655,22080,62444261,1998
DE,financial administration,731,1803230,57,48338,5288,763,1851568,1998
DE,other government administration,210,643716,109,184144,8882,261,827860,1998
DE,judicial and legal,1406,4014660,24,27696,1660,1416,4042356,1998
DE,police arrest,564,2331304,0,0,0,564,2331304,1998
DE,police other,258,658408,33,42538,3586,278,700946,1998
DE,corrections,2102,5705462,128,89680,8818,2152,5795142,1998
DE,streets and highways,1306,3030810,306,154424,17836,1411,3185234,1998
DE,air transportation,0,0,0,0,0,0,0,1998
DE,water transportation,0,0,0,0,0,0,0,1998
DE,public welfare,1446,3742740,149,181386,15576,1540,3924126,1998
DE,health,1586,5040946,251,243422,18546,1696,5284368,1998
DE,hospitals,2131,4648728,171,171652,11744,2201,4820380,1998
DE,social insurance administration,172,430236,3,6394,442,175,436630,1998
DE,solid waste management,77,208047,16,12950,1497,86,220997,1998
DE,sewage disposal,0,0,0,0,0,0,0,1998
DE,parks and recreation,164,412818,93,46306,5326,196,459124,1998
DE,housing and community development,0,0,0,0,0,0,0,1998
DE,natural resources,434,1180116,92,68866,6752,474,1248982,1998
DE,water transport and terminals,0,0,0,0,0,0,0,1998
DE,electric power,0,0,0,0,0,0,0,1998
DE,gas supply,0,0,0,0,0,0,0,1998
DE,transit,484,1384000,25,27438,2675,499,1411438,1998
DE,elem and sec instruction,0,0,0,0,0,0,0,1998
DE,elem and sec admin/cler,0,0,0,0,0,0,0,1998
DE,elem and sec oper/maint,0,0,0,0,0,0,0,1998
DE,elem and sec cafeteria,0,0,0,0,0,0,0,1998
DE,elem and sec bus transit,0,0,0,0,0,0,0,1998
DE,elem and sec health/rec,0,0,0,0,0,0,0,1998
DE,elem and sec student,0,0,0,0,0,0,0,1998
DE,elem and sec unalloc,0,0,0,0,0,0,0,1998
DE,higher ed - instructional,1519,7405422,2233,2361110,153035,2441,9766532,1998
DE,education - higher education other,3408,10065196,3491,1800428,160144,4379,11865624,1998
DE,education - other,296,1005088,3,5934,366,299,1011022,1998
DE,libraries,0,0,0,0,0,0,0,1998
DE,liquor stores,0,0,0,0,0,0,0,1998
DE,other and unallocable,1186,3127338,260,133290,10482,1249,3260628,1998
FL,total,162730,462897278,54212,32220969,2517856,176953,495118247,1998
FL,financial administration,6889,19249582,314,246151,34245,7082,19495733,1998
FL,other government administration,2626,7724780,340,789544,34697,2822,8514324,1998
FL,judicial and legal,15409,50757675,542,866642,63767,15769,51624317,1998
FL,police arrest,2188,7751288,0,0,0,2188,7751288,1998
FL,police other,1615,3553669,119,124675,12800,1687,3678344,1998
FL,corrections,31739,93700947,18621,401808,72322,32147,94102755,1998
FL,streets and highways,9865,25943036,401,394515,28297,10025,26337551,1998
FL,water transportation,1,3638,0,0,0,1,3638,1998
FL,air transportation,0,0,0,0,0,0,0,1998
FL,public welfare,12175,25936930,100,98368,9397,12228,26035298,1998
FL,health,13621,32832341,864,1179042,98604,14178,34011383,1998
FL,hospitals,10312,22170797,72,99077,6563,10350,22269874,1998
FL,social insurance administration,4602,13465453,21,31000,2026,4613,13496453,1998
FL,solid waste management,0,0,0,0,0,0,0,1998
FL,sewage disposal,0,0,0,0,0,0,0,1998
FL,parks and recreation,1075,2082768,11,6884,924,1080,2089652,1998
FL,housing and community development,0,0,0,0,0,0,0,1998
FL,natural resources,6268,14803517,2148,1888254,207591,7442,16691771,1998
FL,water transport and terminals,0,0,0,0,0,0,0,1998
FL,electric power,0,0,0,0,0,0,0,1998
FL,gas supply,0,0,0,0,0,0,0,1998
FL,transit,475,1320316,29,22851,2737,490,1343167,1998
FL,elem and sec instruction,0,0,0,0,0,0,0,1998
FL,elem and sec admin/cler,0,0,0,0,0,0,0,1998
FL,elem and sec oper/maint,0,0,0,0,0,0,0,1998
FL,elem and sec cafeteria,0,0,0,0,0,0,0,1998
FL,elem and sec bus transit,0,0,0,0,0,0,0,1998
FL,elem and sec health/rec,0,0,0,0,0,0,0,1998
FL,elem and sec student,0,0,0,0,0,0,0,1998
FL,elem and sec unalloc,0,0,0,0,0,0,0,1998
FL,higher ed - instructional,11986,54166365,11075,13383658,687564,15871,67550023,1998
FL,education - higher education other,20516,54711148,18187,11576813,1149766,27010,66287961,1998
FL,education - other,1909,5688836,191,37561,1920,1920,5726397,1998
FL,libraries,0,0,0,0,0,0,0,1998
FL,liquor stores,0,0,0,0,0,0,0,1998
FL,other and unallocable,9459,27034192,1177,1074126,104636,10050,28108318,1998
GA,total,99122,265414330,34254,29117055,2345251,112373,294531385,1998
GA,financial administration,2535,7334894,394,436703,49184,2812,7771597,1998
GA,other government administration,589,1987164,379,614484,31342,767,2601648,1998
GA,judicial and legal,1150,5207646,90,156186,7507,1192,5363832,1998
GA,police arrest,1067,3411788,0,0,0,1067,3411788,1998
GA,police other,1021,2639274,50,50787,5104,1050,2690061,1998
GA,corrections,17593,38813807,731,872535,65347,17963,39686342,1998
GA,streets and highways,6081,9936978,21,26442,1940,6092,9963420,1998
GA,air transportation,0,0,0,0,0,0,0,1998
GA,water transportation,758,2092406,4,2839,434,760,2095245,1998
GA,public welfare,8943,20311419,196,205952,21454,9064,20517371,1998
GA,health,3329,10296684,197,310942,24428,3467,10607626,1998
GA,hospitals,11064,25854803,1438,2162024,162608,11982,28016827,1998
GA,social insurance administration,1910,5051005,151,161885,18068,2012,5212890,1998
GA,solid waste management,0,0,0,0,0,0,0,1998
GA,sewage disposal,0,0,0,0,0,0,0,1998
GA,parks and recreation,832,1893975,1307,1133190,141911,1634,3027165,1998
GA,housing and community development,0,0,0,0,0,0,0,1998
GA,natural resources,3978,10521317,1081,783941,93360,4505,11305258,1998
GA,water transport and terminals,0,0,0,0,0,0,0,1998
GA,electric power,0,0,0,0,0,0,0,1998
GA,gas supply,0,0,0,0,0,0,0,1998
GA,transit,0,0,0,0,0,0,0,1998
GA,elem and sec instruction,0,0,0,0,0,0,0,1998
GA,elem and sec admin/cler,0,0,0,0,0,0,0,1998
GA,elem and sec oper/maint,0,0,0,0,0,0,0,1998
GA,elem and sec cafeteria,0,0,0,0,0,0,0,1998
GA,elem and sec bus transit,0,0,0,0,0,0,0,1998
GA,elem and sec health/rec,0,0,0,0,0,0,0,1998
GA,elem and sec student,0,0,0,0,0,0,0,1998
GA,elem and sec unalloc,0,0,0,0,0,0,0,1998
GA,higher ed - instructional,9694,45656495,8623,9540654,452746,12253,55197149,1998
GA,education - higher education other,19545,46571016,16183,10047529,1040707,25424,56618545,1998
GA,education - other,5699,18226839,2938,2190295,178008,6704,20417134,1998
GA,libraries,0,0,0,0,0,0,0,1998
GA,liquor stores,0,0,0,0,0,0,0,1998
GA,other and unallocable,3334,9606820,471,420667,51103,3625,10027487,1998
HI,total,48424,132522424,18952,11227328,716186,52615,143749752,1998
HI,financial administration,756,2128612,5,2192,306,757,2130804,1998
HI,other government administration,1039,2463652,41,32398,2690,1055,2496050,1998
HI,judicial and legal,2147,6783376,53,62100,2516,2162,6845476,1998
HI,police arrest,0,0,0,0,0,0,0,1998
HI,police other,0,0,0,0,0,0,0,1998
HI,corrections,2251,5475912,25,33512,2098,2263,5509424,1998
HI,streets and highways,875,2347148,11,5786,642,879,2352934,1998
HI,air transportation,990,2260570,18,8116,1168,997,2268686,1998
HI,water transportation,212,547214,8,2794,478,215,550008,1998
HI,public welfare,908,2343640,4,3574,308,910,2347214,1998
HI,health,2998,7931350,123,153988,11042,3060,8085338,1998
HI,hospitals,2978,7414898,213,342402,16990,3072,7757300,1998
HI,social insurance administration,391,976036,41,64564,5088,420,1040600,1998
HI,solid waste management,0,0,0,0,0,0,0,1998
HI,sewage disposal,0,0,0,0,0,0,0,1998
HI,parks and recreation,160,376288,411,119106,13174,234,495394,1998
HI,housing and community development,0,0,0,0,0,0,0,1998
HI,natural resources,1080,3393096,364,389428,25502,1224,3782524,1998
HI,water transport and terminals,0,0,0,0,0,0,0,1998
HI,electric power,0,0,0,0,0,0,0,1998
HI,gas supply,0,0,0,0,0,0,0,1998
HI,transit,0,0,0,0,0,0,0,1998
HI,elem and sec instruction,16985,46685444,6244,3911530,213510,18271,50596974,1998
HI,elem and sec admin/cler,1637,3917278,65,30646,2786,1654,3947924,1998
HI,elem and sec oper/maint,1273,1980388,2215,906458,90644,1819,2886846,1998
HI,elem and sec cafeteria,1296,2122950,0,0,0,1296,2122950,1998
HI,elem and sec bus transit,0,0,0,0,0,0,0,1998
HI,elem and sec health/rec,69,271652,235,461978,27174,233,733630,1998
HI,elem and sec student,0,0,423,66610,9514,57,66610,1998
HI,elem and sec unalloc,24,28594,1387,252188,31522,214,280782,1998
HI,higher ed - instructional,2104,9955724,1325,1323680,51068,2393,11279404,1998
HI,education - higher education other,3434,10094392,5085,2687180,168308,4385,12781572,1998
HI,education - other,136,401128,2,2942,160,137,404070,1998
HI,libraries,494,1157562,230,117874,11312,562,1275436,1998
HI,liquor stores,0,0,0,0,0,0,0,1998
HI,other and unallocable,4187,11465520,424,246282,28186,4346,11711802,1998
ID,total,18962,52023009,7709,7638693,545418,22041,59661702,1998
ID,financial administration,1265,3395202,215,106243,13022,1338,3501445,1998
ID,other government administration,155,477653,131,123625,6746,194,601278,1998
ID,judicial and legal,426,1806033,14,11318,817,431,1817351,1998
ID,police arrest,243,791401,0,0,0,243,791401,1998
ID,police other,165,447804,28,23980,2347,178,471784,1998
ID,corrections,1562,3967260,96,97208,10907,1624,4064468,1998
ID,streets and highways,1565,4112301,103,97270,9799,1620,4209571,1998
ID,water transportation,0,0,0,0,0,0,0,1998
ID,air transportation,0,0,0,0,0,0,0,1998
ID,public welfare,1617,3902102,181,312105,20395,1732,4214207,1998
ID,health,1155,2748920,150,157586,14428,1236,2906506,1998
ID,hospitals,846,1996410,176,157048,14942,930,2153458,1998
ID,social insurance administration,461,1600514,182,273834,24168,597,1874348,1998
ID,solid waste management,0,0,0,0,0,0,0,1998
ID,sewage disposal,0,0,0,0,0,0,0,1998
ID,parks and recreation,150,367070,69,32462,4058,173,399532,1998
ID,housing and community development,0,0,0,0,0,0,0,1998
ID,natural resources,1432,3981985,783,813226,87615,1926,4795211,1998
ID,water transport and terminals,0,0,0,0,0,0,0,1998
ID,electric power,0,0,0,0,0,0,0,1998
ID,gas supply,0,0,0,0,0,0,0,1998
ID,transit,0,0,0,0,0,0,0,1998
ID,elem and sec instruction,0,0,0,0,0,0,0,1998
ID,elem and sec admin/cler,0,0,0,0,0,0,0,1998
ID,elem and sec oper/maint,0,0,0,0,0,0,0,1998
ID,elem and sec cafeteria,0,0,0,0,0,0,0,1998
ID,elem and sec bus transit,0,0,0,0,0,0,0,1998
ID,elem and sec health/rec,0,0,0,0,0,0,0,1998
ID,elem and sec student,0,0,0,0,0,0,0,1998
ID,elem and sec unalloc,0,0,0,0,0,0,0,1998
ID,higher ed - instructional,2294,8316027,1121,1630147,63597,2654,9946174,1998
ID,education - higher education other,4190,10198286,3707,3571015,245089,5574,13769301,1998
ID,education - other,496,1478740,364,98857,12355,565,1577597,1998
ID,libraries,0,0,0,0,0,0,0,1998
ID,liquor stores,111,316582,116,28237,3529,131,344819,1998
ID,other and unallocable,829,2118719,273,104532,11604,895,2223251,1998
IL,total,118943,391305737,46804,31447776,3348884,138539,422753513,1998
IL,financial administration,5964,17115210,278,318682,27902,6132,17433892,1998
IL,other government administration,2092,6989115,24,35174,1890,2105,7024289,1998
IL,judicial and legal,2955,14531896,159,256445,12712,3030,14788341,1998
IL,police arrest,2176,9706428,0,0,0,2176,9706428,1998
IL,police other,1804,5946150,2,1872,200,1805,5948022,1998
IL,corrections,14797,45908460,18,29554,914,14803,45938014,1998
IL,streets and highways,6440,22093312,1902,3789769,230990,7745,25883081,1998
IL,air transportation,0,0,0,0,0,0,0,1998
IL,water transportation,95,348992,4,8326,446,98,357318,1998
IL,public welfare,12352,39572634,322,416358,35056,12563,39988992,1998
IL,health,3087,10779171,14,24146,922,3093,10803317,1998
IL,hospitals,14676,41551583,778,854744,43873,14941,42406327,1998
IL,social insurance administration,2446,8423636,319,847906,36882,2668,9271542,1998
IL,solid waste management,0,0,0,0,0,0,0,1998
IL,sewage disposal,0,0,0,0,0,0,0,1998
IL,parks and recreation,686,2001088,140,173376,20120,807,2174464,1998
IL,housing and community development,0,0,0,0,0,0,0,1998
IL,natural resources,3168,10035243,1193,1002255,147228,4006,11037498,1998
IL,water transport and terminals,0,0,0,0,0,0,0,1998
IL,electric power,0,0,0,0,0,0,0,1998
IL,gas supply,0,0,0,0,0,0,0,1998
IL,transit,0,0,0,0,0,0,0,1998
IL,elem and sec instruction,0,0,0,0,0,0,0,1998
IL,elem and sec admin/cler,0,0,0,0,0,0,0,1998
IL,elem and sec oper/maint,0,0,0,0,0,0,0,1998
IL,elem and sec cafeteria,0,0,0,0,0,0,0,1998
IL,elem and sec bus transit,0,0,0,0,0,0,0,1998
IL,elem and sec health/rec,0,0,0,0,0,0,0,1998
IL,elem and sec student,0,0,0,0,0,0,0,1998
IL,elem and sec unalloc,0,0,0,0,0,0,0,1998
IL,higher ed - instructional,12589,59668381,12923,10508315,704517,16729,70176696,1998
IL,education - higher education other,23493,63380216,28470,12812490,2059356,35560,76192706,1998
IL,education - other,2972,9752662,44,70248,3534,2993,9822910,1998
IL,libraries,0,0,0,0,0,0,0,1998
IL,liquor stores,0,0,0,0,0,0,0,1998
IL,other and unallocable,7151,23501560,214,298116,22342,7285,23799676,1998
IN,total,70651,189279119,36359,30268070,2134425,82850,219547189,1998
IN,financial administration,2572,6402542,158,127402,18898,2685,6529944,1998
IN,other government administration,296,888118,109,15974,1068,303,904092,1998
IN,judicial and legal,924,3546493,161,400818,22739,1054,3947311,1998
IN,police arrest,1248,4494143,0,0,0,1248,4494143,1998
IN,police other,785,1661477,1,859,106,786,1662336,1998
IN,corrections,6161,14019763,14,24934,1405,6169,14044697,1998
IN,streets and highways,4329,9067212,0,0,0,4329,9067212,1998
IN,air transportation,0,0,0,0,0,0,0,1998
IN,water transportation,30,94660,3,2652,224,31,97312,1998
IN,public welfare,5114,10554864,25,19614,2028,5126,10574478,1998
IN,health,1713,4733202,8,12104,720,1717,4745306,1998
IN,hospitals,5658,11177707,103,101310,8949,5711,11279017,1998
IN,social insurance administration,1441,3306353,172,149492,18600,1553,3455845,1998
IN,solid waste management,0,0,0,0,0,0,0,1998
IN,sewage disposal,0,0,0,0,0,0,0,1998
IN,parks and recreation,93,189895,64,48403,4308,119,238298,1998
IN,housing and community development,0,0,0,0,0,0,0,1998
IN,natural resources,2298,5404472,2031,1800141,200927,3495,7204613,1998
IN,water transport and terminals,0,0,0,0,0,0,0,1998
IN,electric power,0,0,0,0,0,0,0,1998
IN,gas supply,0,0,0,0,0,0,0,1998
IN,transit,0,0,0,0,0,0,0,1998
IN,elem and sec instruction,0,0,0,0,0,0,0,1998
IN,elem and sec admin/cler,0,0,0,0,0,0,0,1998
IN,elem and sec oper/maint,0,0,0,0,0,0,0,1998
IN,elem and sec cafeteria,0,0,0,0,0,0,0,1998
IN,elem and sec bus transit,0,0,0,0,0,0,0,1998
IN,elem and sec health/rec,0,0,0,0,0,0,0,1998
IN,elem and sec student,0,0,0,0,0,0,0,1998
IN,elem and sec unalloc,0,0,0,0,0,0,0,1998
IN,higher ed - instructional,12173,56690305,12505,17132085,819424,16827,73822390,1998
IN,education - higher education other,22187,48044518,20940,10342510,1029553,28036,58387028,1998
IN,education - other,1237,3336866,47,66154,3989,1261,3403020,1998
IN,libraries,0,0,0,0,0,0,0,1998
IN,liquor stores,0,0,0,0,0,0,0,1998
IN,other and unallocable,2392,5666529,18,23618,1487,2400,5690147,1998
IA,total,40284,131950270,23114,28283661,2255983,53032,160233931,1998
IA,financial administration,1183,3222998,209,238495,25359,1325,3461493,1998
IA,other government administration,498,1506611,311,557313,50878,785,2063924,1998
IA,judicial and legal,2161,6798464,288,386218,32272,2344,7184682,1998
IA,police arrest,637,2199534,0,0,0,637,2199534,1998
IA,police other,299,916100,33,28063,1425,307,944163,1998
IA,corrections,2645,7027444,121,222098,14172,2727,7249542,1998
IA,streets and highways,2975,8134513,0,0,0,2975,8134513,1998
IA,air transportation,0,0,0,0,0,0,0,1998
IA,water transportation,0,0,0,0,0,0,0,1998
IA,public welfare,2675,6968110,122,212640,13364,2751,7180750,1998
IA,health,299,949888,23,38113,2894,315,988001,1998
IA,hospitals,5767,18115017,2003,4765011,342818,7703,22880028,1998
IA,social insurance administration,348,1030619,17,29741,1827,358,1060360,1998
IA,solid waste management,0,0,0,0,0,0,0,1998
IA,sewage disposal,0,0,0,0,0,0,0,1998
IA,parks and recreation,109,342550,5,2967,314,111,345517,1998
IA,housing and community development,0,0,0,0,0,0,0,1998
IA,natural resources,2123,6475920,1503,2023947,142895,2931,8499867,1998
IA,water transport and terminals,0,0,0,0,0,0,0,1998
IA,electric power,0,0,0,0,0,0,0,1998
IA,gas supply,0,0,0,0,0,0,0,1998
IA,transit,0,0,0,0,0,0,0,1998
IA,elem and sec instruction,0,0,0,0,0,0,0,1998
IA,elem and sec admin/cler,0,0,0,0,0,0,0,1998
IA,elem and sec oper/maint,0,0,0,0,0,0,0,1998
IA,elem and sec cafeteria,0,0,0,0,0,0,0,1998
IA,elem and sec bus transit,0,0,0,0,0,0,0,1998
IA,elem and sec health/rec,0,0,0,0,0,0,0,1998
IA,elem and sec student,0,0,0,0,0,0,0,1998
IA,elem and sec unalloc,0,0,0,0,0,0,0,1998
IA,higher ed - instructional,4315,25262313,3659,9269753,588843,7642,34532066,1998
IA,education - higher education other,10151,30940241,14494,10034200,1007876,15846,40974441,1998
IA,education - other,1106,3251266,78,90720,6371,1144,3341986,1998
IA,libraries,0,0,0,0,0,0,0,1998
IA,liquor stores,0,0,0,0,0,0,0,1998
IA,other and unallocable,2993,8808682,248,384382,24675,3131,9193064,1998
KS,total,37677,108776373,17262,12649693,1188782,44395,121426066,1998
KS,financial administration,1972,5181719,71,97552,8607,2021,5279271,1998
KS,other government administration,330,1007381,292,342542,24069,467,1349923,1998
KS,judicial and legal,1965,5389623,251,158933,19517,2074,5548556,1998
KS,police arrest,607,1863325,0,0,0,607,1863325,1998
KS,police other,379,816918,16,8678,1141,385,825596,1998
KS,corrections,3411,8030850,25,29404,2334,3425,8060254,1998
KS,streets and highways,3386,9593205,72,62085,6018,3420,9655290,1998
KS,air transportation,0,0,0,0,0,0,0,1998
KS,water transportation,0,0,0,0,0,0,0,1998
KS,public welfare,2138,6497707,0,0,0,2138,6497707,1998
KS,health,930,2854940,68,25822,1901,941,2880762,1998
KS,hospitals,4390,10973752,903,1441342,75707,4819,12415094,1998
KS,social insurance administration,126,381052,0,0,0,126,381052,1998
KS,solid waste management,0,0,0,0,0,0,0,1998
KS,sewage disposal,0,0,0,0,0,0,0,1998
KS,parks and recreation,407,960520,136,56920,9814,462,1017440,1998
KS,housing and community development,0,0,0,0,0,0,0,1998
KS,natural resources,1412,4079629,492,709095,43630,1659,4788724,1998
KS,water transport and terminals,0,0,0,0,0,0,0,1998
KS,electric power,0,0,0,0,0,0,0,1998
KS,gas supply,0,0,0,0,0,0,0,1998
KS,transit,0,0,0,0,0,0,0,1998
KS,elem and sec instruction,0,0,0,0,0,0,0,1998
KS,elem and sec admin/cler,0,0,0,0,0,0,0,1998
KS,elem and sec oper/maint,0,0,0,0,0,0,0,1998
KS,elem and sec cafeteria,0,0,0,0,0,0,0,1998
KS,elem and sec bus transit,0,0,0,0,0,0,0,1998
KS,elem and sec health/rec,0,0,0,0,0,0,0,1998
KS,elem and sec student,0,0,0,0,0,0,0,1998
KS,elem and sec unalloc,0,0,0,0,0,0,0,1998
KS,higher ed - instructional,3799,19521467,2211,3344481,173519,4780,22865948,1998
KS,education - higher education other,8411,20640397,12410,6138630,794432,12899,26779027,1998
KS,education - other,761,2375118,43,36606,3951,783,2411724,1998
KS,libraries,0,0,0,0,0,0,0,1998
KS,liquor stores,0,0,0,0,0,0,0,1998
KS,other and unallocable,3253,8608770,272,197603,24142,3389,8806373,1998
KY,total,60758,170824371,25366,19732530,2031263,72606,190556901,1998
KY,financial administration,3015,7099448,133,110312,11892,3086,7209760,1998
KY,other government administration,1054,3598636,475,841180,58052,1402,4439816,1998
KY,judicial and legal,3401,9615008,807,1062014,90506,3946,10677022,1998
KY,police arrest,957,2987572,21,33156,1888,968,3020728,1998
KY,police other,830,2011778,16,24482,2028,843,2036260,1998
KY,corrections,5231,11553972,255,309128,21674,5362,11863100,1998
KY,streets and highways,5478,13427562,162,266286,21054,5604,13693848,1998
KY,water transportation,0,0,0,0,0,0,0,1998
KY,air transportation,0,0,0,0,0,0,0,1998
KY,public welfare,4455,10313348,154,217178,22556,4590,10530526,1998
KY,health,1889,6406939,51,80902,6690,1928,6487841,1998
KY,hospitals,4282,10629693,553,851695,93484,4824,11481388,1998
KY,social insurance administration,1237,3261700,26,42082,2946,1255,3303782,1998
KY,solid waste management,0,0,0,0,0,0,0,1998
KY,sewage disposal,0,0,0,0,0,0,0,1998
KY,parks and recreation,1398,2404950,257,312564,38372,1629,2717514,1998
KY,housing and community development,0,0,0,0,0,0,0,1998
KY,natural resources,3268,7919067,845,653304,70241,3686,8572371,1998
KY,water transport and terminals,0,0,0,0,0,0,0,1998
KY,electric power,0,0,0,0,0,0,0,1998
KY,gas supply,0,0,0,0,0,0,0,1998
KY,transit,0,0,0,0,0,0,0,1998
KY,elem and sec instruction,0,0,0,0,0,0,0,1998
KY,elem and sec admin/cler,0,0,0,0,0,0,0,1998
KY,elem and sec oper/maint,0,0,0,0,0,0,0,1998
KY,elem and sec cafeteria,0,0,0,0,0,0,0,1998
KY,elem and sec bus transit,0,0,0,0,0,0,0,1998
KY,elem and sec health/rec,0,0,0,0,0,0,0,1998
KY,elem and sec student,0,0,0,0,0,0,0,1998
KY,elem and sec unalloc,0,0,0,0,0,0,0,1998
KY,higher ed - instructional,6606,33273913,4752,5124420,269229,8175,38398333,1998
KY,education - higher education other,10963,26806467,15406,8364493,1214721,17975,35170960,1998
KY,education - other,3580,10612030,1051,975150,66820,3982,11587180,1998
KY,libraries,0,0,0,0,0,0,0,1998
KY,liquor stores,0,0,0,0,0,0,0,1998
KY,other and unallocable,3114,8902288,402,464184,39110,3351,9366472,1998
LA,total,85403,211331898,26760,15940928,1583001,94349,227272826,1998
LA,financial administration,2424,5418991,254,330650,30388,2596,5749641,1998
LA,other government administration,1230,3632406,569,626693,59563,1566,4259099,1998
LA,judicial and legal,1661,5556568,96,57856,6011,1697,5614424,1998
LA,police arrest,678,1746521,0,0,0,678,1746521,1998
LA,police other,417,794933,8,4091,520,420,799024,1998
LA,corrections,6751,13001164,92,34408,6801,6789,13035572,1998
LA,streets and highways,5672,12411921,26,23621,3810,5694,12435542,1998
LA,air transportation,0,0,0,0,0,0,0,1998
LA,water transportation,531,1330567,20,16618,1432,538,1347185,1998
LA,public welfare,6097,14441014,15,13638,1187,6104,14454652,1998
LA,health,5484,13634137,259,314904,24536,5623,13949041,1998
LA,hospitals,18825,41460144,2457,3256984,287829,20451,44717128,1998
LA,social insurance administration,982,2514860,64,39728,3664,1003,2554588,1998
LA,solid waste management,0,0,0,0,0,0,0,1998
LA,sewage disposal,0,0,0,0,0,0,0,1998
LA,parks and recreation,822,1753459,331,260532,35634,1023,2013991,1998
LA,housing and community development,0,0,0,0,0,0,0,1998
LA,natural resources,4472,10381451,976,534048,69253,4863,10915499,1998
LA,water transport and terminals,0,0,0,0,0,0,0,1998
LA,electric power,0,0,0,0,0,0,0,1998
LA,gas supply,0,0,0,0,0,0,0,1998
LA,transit,0,0,0,0,0,0,0,1998
LA,elem and sec instruction,0,0,0,0,0,0,0,1998
LA,elem and sec admin/cler,0,0,0,0,0,0,0,1998
LA,elem and sec oper/maint,0,0,0,0,0,0,0,1998
LA,elem and sec cafeteria,0,0,0,0,0,0,0,1998
LA,elem and sec bus transit,0,0,0,0,0,0,0,1998
LA,elem and sec health/rec,0,0,0,0,0,0,0,1998
LA,elem and sec student,0,0,0,0,0,0,0,1998
LA,elem and sec unalloc,0,0,0,0,0,0,0,1998
LA,higher ed - instructional,7973,38196302,5203,4978670,314036,9748,43174972,1998
LA,education - higher education other,15225,29290852,15492,4783168,674993,19037,34074020,1998
LA,education - other,3509,9248145,555,405163,33967,3702,9653308,1998
LA,libraries,0,0,0,0,0,0,0,1998
LA,liquor stores,0,0,0,0,0,0,0,1998
LA,other and unallocable,2650,6518463,343,260156,29377,2817,6778619,1998
ME,total,17559,49311694,6738,4720908,421345,19982,54032602,1998
ME,financial administration,1100,2823639,23,25444,1942,1110,2849083,1998
ME,other government administration,309,904398,209,241435,16028,419,1145833,1998
ME,judicial and legal,593,1924374,47,51894,3859,616,1976268,1998
ME,police arrest,308,1123510,0,0,0,308,1123510,1998
ME,police other,54,115199,0,0,0,54,115199,1998
ME,corrections,1129,2939996,11,12029,685,1152,2952025,1998
ME,streets and highways,2421,6341512,164,323065,27974,2579,6664577,1998
ME,air transportation,0,0,0,0,0,0,0,1998
ME,water transportation,63,138470,5,6600,762,67,145070,1998
ME,public welfare,1897,4727846,62,96466,6341,1933,4824312,1998
ME,health,1136,3210871,57,103619,4713,1163,3314490,1998
ME,hospitals,462,1565967,25,34417,1647,472,1600384,1998
ME,social insurance administration,523,1403547,5,9408,657,526,1412955,1998
ME,solid waste management,0,0,0,0,0,0,0,1998
ME,sewage disposal,0,0,0,0,0,0,0,1998
ME,parks and recreation,87,254416,14,15591,1610,96,270007,1998
ME,housing and community development,0,0,0,0,0,0,0,1998
ME,natural resources,1132,3233702,215,225065,16715,1226,3458767,1998
ME,water transport and terminals,0,0,0,0,0,0,0,1998
ME,electric power,0,0,0,0,0,0,0,1998
ME,gas supply,0,0,0,0,0,0,0,1998
ME,transit,0,0,0,0,0,0,0,1998
ME,elem and sec instruction,27,78090,9,12660,1395,36,90750,1998
ME,elem and sec admin/cler,1,1731,2,1946,177,2,3677,1998
ME,elem and sec oper/maint,0,0,2,1455,142,1,1455,1998
ME,elem and sec cafeteria,0,0,6,8759,875,6,8759,1998
ME,elem and sec bus transit,5,9268,16,19984,2480,21,29252,1998
ME,elem and sec health/rec,0,0,0,0,0,0,0,1998
ME,elem and sec student,0,0,0,0,0,0,0,1998
ME,elem and sec unalloc,0,0,0,0,0,0,0,1998
ME,higher ed - instructional,1024,4316474,213,235472,14135,1104,4551946,1998
ME,education - higher education other,3008,8177712,5183,2903692,291471,4655,11081404,1998
ME,education - other,932,2447398,418,335040,23060,1062,2782438,1998
ME,libraries,0,0,0,0,0,0,0,1998
ME,liquor stores,119,276874,6,6131,638,123,283005,1998
ME,other and unallocable,1229,3296700,46,50736,4039,1251,3347436,1998
MD,total,77342,235911352,18262,28602836,1997301,88627,264514188,1998
MD,financial administration,3377,9773586,251,304025,24438,3516,10077611,1998
MD,other government administration,1261,3837615,402,610741,41359,1495,4448356,1998
MD,judicial and legal,3348,10066989,521,908783,76225,3778,10975772,1998
MD,police arrest,1594,6655851,0,0,0,1594,6655851,1998
MD,police other,755,1647574,23,44369,2675,770,1691943,1998
MD,corrections,10546,29715077,663,1152432,97296,11095,30867509,1998
MD,streets and highways,4633,13356909,0,0,0,4633,13356909,1998
MD,air transportation,443,1380006,0,0,0,443,1380006,1998
MD,water transportation,356,1297107,0,0,0,356,1297107,1998
MD,public welfare,6119,15691620,1357,2290593,166010,7057,17982213,1998
MD,health,5041,14439321,1035,1469779,128524,5767,15909100,1998
MD,hospitals,5667,14344767,602,623426,54898,5979,14968193,1998
MD,social insurance administration,984,2745367,305,573778,49337,1263,3319145,1998
MD,solid waste management,0,0,0,0,0,0,0,1998
MD,sewage disposal,0,0,0,0,0,0,0,1998
MD,parks and recreation,451,1451946,182,269625,22468,578,1721571,1998
MD,housing and community development,0,0,0,0,0,0,0,1998
MD,natural resources,1931,6406212,329,528658,44091,2180,6934870,1998
MD,water transport and terminals,0,0,0,0,0,0,0,1998
MD,electric power,0,0,0,0,0,0,0,1998
MD,gas supply,0,0,0,0,0,0,0,1998
MD,transit,2073,7400385,222,276091,24630,2212,7676476,1998
MD,elem and sec instruction,0,0,0,0,0,0,0,1998
MD,elem and sec admin/cler,0,0,0,0,0,0,0,1998
MD,elem and sec oper/maint,0,0,0,0,0,0,0,1998
MD,elem and sec cafeteria,0,0,0,0,0,0,0,1998
MD,elem and sec bus transit,0,0,0,0,0,0,0,1998
MD,elem and sec health/rec,0,0,0,0,0,0,0,1998
MD,elem and sec student,0,0,0,0,0,0,0,1998
MD,elem and sec unalloc,0,0,0,0,0,0,0,1998
MD,higher ed - instructional,11100,40791394,3277,8013237,291976,12750,48804631,1998
MD,education - higher education other,9129,29540653,7716,9351230,819818,13761,38891883,1998
MD,education - other,1858,5822281,237,369004,23500,1990,6191285,1998
MD,libraries,0,0,0,0,0,0,0,1998
MD,liquor stores,0,0,0,0,0,0,0,1998
MD,other and unallocable,6676,19546692,1140,1817065,130056,7410,21363757,1998
MA,total,75052,247004986,27084,23963837,1525942,84073,270968823,1998
MA,financial administration,4364,14761559,305,559830,33168,4552,15321389,1998
MA,other government administration,1655,5160444,233,964944,30888,1840,6125388,1998
MA,judicial and legal,6469,21111864,228,439149,24720,6611,21551013,1998
MA,police arrest,1598,6042228,0,0,0,1598,6042228,1998
MA,police other,1069,3342830,13,24357,1492,1077,3367187,1998
MA,corrections,6111,19906123,74,118567,7123,6152,20024690,1998
MA,streets and highways,4347,15272207,144,306526,17724,4448,15578733,1998
MA,air transportation,993,4535186,149,192861,7840,1037,4728047,1998
MA,water transportation,156,711395,15,18996,1435,164,730391,1998
MA,public welfare,6947,21785300,589,1126252,63894,7307,22911552,1998
MA,health,6923,20675468,1003,1792619,112680,7561,22468087,1998
MA,hospitals,8076,21672036,1163,1788632,110278,8697,23460668,1998
MA,social insurance administration,1979,6551361,133,264877,15930,2072,6816238,1998
MA,solid waste management,5,21196,0,0,0,5,21196,1998
MA,sewage disposal,1230,4961481,42,117772,5164,1259,5079253,1998
MA,parks and recreation,898,2478341,7,5302,602,901,2483643,1998
MA,housing and community development,0,0,0,0,0,0,0,1998
MA,natural resources,1195,4591131,122,286469,14642,1282,4877600,1998
MA,water transport and terminals,721,2534314,19,46035,2196,734,2580349,1998
MA,electric power,0,0,0,0,0,0,0,1998
MA,gas supply,0,0,0,0,0,0,0,1998
MA,transit,0,0,0,0,0,0,0,1998
MA,elem and sec instruction,0,0,0,0,0,0,0,1998
MA,elem and sec admin/cler,0,0,0,0,0,0,0,1998
MA,elem and sec oper/maint,0,0,0,0,0,0,0,1998
MA,elem and sec cafeteria,0,0,0,0,0,0,0,1998
MA,elem and sec bus transit,0,0,0,0,0,0,0,1998
MA,elem and sec health/rec,0,0,0,0,0,0,0,1998
MA,elem and sec student,0,0,0,0,0,0,0,1998
MA,elem and sec unalloc,0,0,0,0,0,0,0,1998
MA,higher ed - instructional,5560,24908731,8260,8636047,406451,8005,33544778,1998
MA,education - higher education other,10421,30395619,14408,6899708,649226,14314,37295327,1998
MA,education - other,682,2550749,61,128420,7015,724,2679169,1998
MA,libraries,18,53210,3,5104,393,20,58314,1998
MA,liquor stores,0,0,0,0,0,0,0,1998
MA,other and unallocable,3635,12982213,113,241370,13081,3713,13223583,1998
MI,total,107395,394401041,63676,56586503,5040194,135996,450987544,1998
MI,financial administration,2240,7876635,1083,1873805,109661,2859,9750440,1998
MI,other government administration,1538,4844100,19,23006,1151,1544,4867106,1998
MI,judicial and legal,2006,7603503,32,31742,2019,2017,7635245,1998
MI,police arrest,2009,8034367,0,0,0,2009,8034367,1998
MI,police other,927,2217029,167,102223,10153,984,2319252,1998
MI,corrections,17383,59185950,194,370927,17883,17484,59556877,1998
MI,streets and highways,2882,10498494,141,210547,12177,2951,10709041,1998
MI,air transportation,0,0,0,0,0,0,0,1998
MI,water transportation,0,0,0,0,0,0,0,1998
MI,public welfare,12448,40251399,297,493797,26483,12597,40745196,1998
MI,health,2919,10808192,222,317838,17210,3016,11126030,1998
MI,hospitals,9911,32609703,3978,7209167,497789,12724,39818870,1998
MI,social insurance administration,1284,4130458,94,49859,2340,1297,4180317,1998
MI,solid waste management,0,0,0,0,0,0,0,1998
MI,sewage disposal,0,0,0,0,0,0,0,1998
MI,parks and recreation,314,770884,49,78214,4552,340,849098,1998
MI,housing and community development,0,0,0,0,0,0,0,1998
MI,natural resources,4070,14556093,1041,905172,87368,4563,15461265,1998
MI,water transport and terminals,0,0,0,0,0,0,0,1998
MI,electric power,0,0,0,0,0,0,0,1998
MI,gas supply,0,0,0,0,0,0,0,1998
MI,transit,0,0,0,0,0,0,0,1998
MI,elem and sec instruction,12,24613,1,221,44,18,24834,1998
MI,elem and sec admin/cler,1,4683,1,744,106,2,5427,1998
MI,elem and sec oper/maint,0,0,0,0,0,0,0,1998
MI,elem and sec cafeteria,1,1328,0,0,0,1,1328,1998
MI,elem and sec bus transit,0,0,0,0,0,0,0,1998
MI,elem and sec health/rec,0,0,0,0,0,0,0,1998
MI,elem and sec student,0,0,5,1570,370,2,1570,1998
MI,elem and sec unalloc,0,0,0,0,0,0,0,1998
MI,higher ed - instructional,12951,81810797,14822,20831822,1394053,20881,102642619,1998
MI,education - higher education other,27571,83618635,40176,23355036,2807641,43501,106973671,1998
MI,education - other,418,1603149,61,89118,4362,443,1692267,1998
MI,libraries,0,0,0,0,0,0,0,1998
MI,liquor stores,0,0,0,0,0,0,0,1998
MI,other and unallocable,6510,23951029,1293,641695,44832,6763,24592724,1998
MN,total,56498,210141926,22191,24863292,2247624,69199,235005218,1998
MN,financial administration,2432,8219722,181,299685,24529,2571,8519407,1998
MN,other government administration,1117,3972600,212,340667,25942,1264,4313267,1998
MN,judicial and legal,1987,8044231,111,236899,12653,2058,8281130,1998
MN,police arrest,503,2358917,0,0,0,503,2358917,1998
MN,police other,343,1064352,23,28813,2280,356,1093165,1998
MN,corrections,3484,11398055,132,242736,17894,3585,11640791,1998
MN,streets and highways,4875,17433388,210,302592,25490,5019,17735980,1998
MN,air transportation,0,0,0,0,0,0,0,1998
MN,water transportation,0,0,0,0,0,0,0,1998
MN,public welfare,1671,5648169,835,1414574,134106,2429,7062743,1998
MN,health,2031,7516768,171,333329,20606,2148,7850097,1998
MN,hospitals,3658,12977505,1232,2223084,203706,4809,15200589,1998
MN,social insurance administration,1296,4333649,3,5001,283,1298,4338650,1998
MN,solid waste management,0,0,0,0,0,0,0,1998
MN,sewage disposal,0,0,0,0,0,0,0,1998
MN,parks and recreation,482,1638141,162,185405,16010,572,1823546,1998
MN,housing and community development,0,0,0,0,0,0,0,1998
MN,natural resources,2652,9130713,584,697972,60918,2997,9828685,1998
MN,water transport and terminals,0,0,0,0,0,0,0,1998
MN,electric power,0,0,0,0,0,0,0,1998
MN,gas supply,0,0,0,0,0,0,0,1998
MN,transit,0,0,0,0,0,0,0,1998
MN,elem and sec instruction,0,0,0,0,0,0,0,1998
MN,elem and sec admin/cler,0,0,0,0,0,0,0,1998
MN,elem and sec oper/maint,0,0,0,0,0,0,0,1998
MN,elem and sec cafeteria,0,0,0,0,0,0,0,1998
MN,elem and sec bus transit,0,0,0,0,0,0,0,1998
MN,elem and sec health/rec,0,0,0,0,0,0,0,1998
MN,elem and sec student,0,0,0,0,0,0,0,1998
MN,elem and sec unalloc,0,0,0,0,0,0,0,1998
MN,higher ed - instructional,8517,47455788,7003,9733944,587682,11837,57189732,1998
MN,education - higher education other,14935,45851656,10194,7495769,988717,20521,53347425,1998
MN,education - other,3253,11843646,934,1016230,103967,3841,12859876,1998
MN,libraries,0,0,0,0,0,0,0,1998
MN,liquor stores,0,0,0,0,0,0,0,1998
MN,other and unallocable,3262,11254626,204,306592,22841,3391,11561218,1998
MS,total,47743,118538248,11026,6873064,721851,51817,125411312,1998
MS,financial administration,1180,3204411,0,0,0,1180,3204411,1998
MS,other government administration,414,1215986,75,80905,6066,448,1296891,1998
MS,judicial and legal,457,2159102,16,24676,1150,463,2183778,1998
MS,police arrest,617,1774495,0,0,0,617,1774495,1998
MS,police other,310,734148,0,0,0,310,734148,1998
MS,corrections,4130,7401720,12,6811,981,4136,7408531,1998
MS,streets and highways,3280,6933767,2,1974,320,3282,6935741,1998
MS,air transportation,0,0,0,0,0,0,0,1998
MS,water transportation,52,136722,4,3251,504,55,139973,1998
MS,public welfare,3110,6090880,0,0,0,3110,6090880,1998
MS,health,2982,7037981,88,159759,10315,3040,7197740,1998
MS,hospitals,9375,21236562,386,733003,49307,9653,21969565,1998
MS,social insurance administration,845,2019342,240,407922,41280,1078,2427264,1998
MS,solid waste management,0,0,0,0,0,0,0,1998
MS,sewage disposal,0,0,0,0,0,0,0,1998
MS,parks and recreation,311,491454,192,76236,12448,381,567690,1998
MS,housing and community development,0,0,0,0,0,0,0,1998
MS,natural resources,3007,6809643,774,425662,56667,3327,7235305,1998
MS,water transport and terminals,0,0,0,0,0,0,0,1998
MS,electric power,0,0,0,0,0,0,0,1998
MS,gas supply,0,0,0,0,0,0,0,1998
MS,transit,0,0,0,0,0,0,0,1998
MS,elem and sec instruction,0,0,0,0,0,0,0,1998
MS,elem and sec admin/cler,0,0,0,0,0,0,0,1998
MS,elem and sec oper/maint,0,0,0,0,0,0,0,1998
MS,elem and sec cafeteria,0,0,0,0,0,0,0,1998
MS,elem and sec bus transit,0,0,0,0,0,0,0,1998
MS,elem and sec health/rec,0,0,0,0,0,0,0,1998
MS,elem and sec student,0,0,0,0,0,0,0,1998
MS,elem and sec unalloc,0,0,0,0,0,0,0,1998
MS,higher ed - instructional,5449,22400959,2374,1927176,147244,6280,24328135,1998
MS,education - higher education other,7983,18817021,6727,2915137,384368,10154,21732158,1998
MS,education - other,1518,3924829,58,46705,5999,1552,3971534,1998
MS,libraries,0,0,0,0,0,0,0,1998
MS,liquor stores,128,245754,0,0,0,128,245754,1998
MS,other and unallocable,2595,5903472,78,63847,5202,2623,5967319,1998
MO,total,78929,197433515,24885,13328782,1361349,86633,210762297,1998
MO,financial administration,2624,5614218,28,26186,3219,2642,5640404,1998
MO,other government administration,1042,2367133,155,126856,10201,1099,2493989,1998
MO,judicial and legal,3243,9402602,283,200135,23627,3376,9602737,1998
MO,police arrest,1232,3964262,0,0,0,1232,3964262,1998
MO,police other,1121,2576426,53,35545,4863,1148,2611971,1998
MO,corrections,10292,19923575,504,345440,29428,10458,20269015,1998
MO,streets and highways,6424,17023795,176,162580,19355,6533,17186375,1998
MO,water transportation,0,0,0,0,0,0,0,1998
MO,air transportation,0,0,0,0,0,0,0,1998
MO,public welfare,7468,14784108,457,424617,42534,7708,15208725,1998
MO,health,4118,9005031,611,309355,30460,4290,9314386,1998
MO,hospitals,12450,25666471,1914,1603166,94043,12981,27269637,1998
MO,social insurance administration,1127,2705563,12,20059,1912,1138,2725622,1998
MO,solid waste management,0,0,0,0,0,0,0,1998
MO,sewage disposal,0,0,0,0,0,0,0,1998
MO,parks and recreation,538,1108622,247,15762,3152,556,1124384,1998
MO,housing and community development,0,0,0,0,0,0,0,1998
MO,natural resources,2448,6169452,506,323191,47025,2714,6492643,1998
MO,water transport and terminals,0,0,0,0,0,0,0,1998
MO,electric power,0,0,0,0,0,0,0,1998
MO,gas supply,0,0,0,0,0,0,0,1998
MO,transit,0,0,0,0,0,0,0,1998
MO,elem and sec instruction,0,0,0,0,0,0,0,1998
MO,elem and sec admin/cler,0,0,0,0,0,0,0,1998
MO,elem and sec oper/maint,0,0,0,0,0,0,0,1998
MO,elem and sec cafeteria,0,0,0,0,0,0,0,1998
MO,elem and sec bus transit,0,0,0,0,0,0,0,1998
MO,elem and sec health/rec,0,0,0,0,0,0,0,1998
MO,elem and sec student,0,0,0,0,0,0,0,1998
MO,elem and sec unalloc,0,0,0,0,0,0,0,1998
MO,higher ed - instructional,7738,32955728,6354,4966213,323806,9569,37921941,1998
MO,education - higher education other,10892,28797158,12980,4389128,698356,14850,33186286,1998
MO,education - other,2059,4921190,264,159489,7306,2101,5080679,1998
MO,libraries,0,0,0,0,0,0,0,1998
MO,liquor stores,0,0,0,0,0,0,0,1998
MO,other and unallocable,4113,10448181,341,221060,22062,4238,10669241,1998
MT,total,15886,40805058,7580,5382982,597027,19264,46188040,1998
MT,financial administration,854,1931723,113,106659,12154,924,2038382,1998
MT,other government administration,259,748978,65,49388,4532,285,798366,1998
MT,judicial and legal,162,636737,70,131614,5463,193,768351,1998
MT,police arrest,217,545778,3,2318,248,218,548096,1998
MT,police other,204,520361,14,17320,1280,211,537681,1998
MT,corrections,843,1944968,67,76301,7335,884,2021269,1998
MT,streets and highways,1805,4835567,138,129036,11900,1872,4964603,1998
MT,air transportation,0,0,0,0,0,0,0,1998
MT,water transportation,0,0,0,0,0,0,0,1998
MT,public welfare,1364,3323212,168,211434,19585,1475,3534646,1998
MT,health,805,1555952,124,91974,10335,863,1647926,1998
MT,hospitals,534,1125819,95,96324,11347,598,1222143,1998
MT,social insurance administration,607,1460466,40,46018,3956,630,1506484,1998
MT,solid waste management,0,0,0,0,0,0,0,1998
MT,sewage disposal,0,0,0,0,0,0,0,1998
MT,parks and recreation,56,131910,31,12560,1284,63,144470,1998
MT,housing and community development,0,0,0,0,0,0,0,1998
MT,natural resources,1157,3072592,355,362238,27391,1313,3434830,1998
MT,water transport and terminals,0,0,0,0,0,0,0,1998
MT,electric power,0,0,0,0,0,0,0,1998
MT,gas supply,0,0,0,0,0,0,0,1998
MT,transit,0,0,0,0,0,0,0,1998
MT,elem and sec instruction,0,0,0,0,0,0,0,1998
MT,elem and sec admin/cler,0,0,0,0,0,0,0,1998
MT,elem and sec oper/maint,0,0,0,0,0,0,0,1998
MT,elem and sec cafeteria,0,0,0,0,0,0,0,1998
MT,elem and sec bus transit,0,0,0,0,0,0,0,1998
MT,elem and sec health/rec,0,0,0,0,0,0,0,1998
MT,elem and sec student,0,0,0,0,0,0,0,1998
MT,elem and sec unalloc,0,0,0,0,0,0,0,1998
MT,higher ed - instructional,1859,7428286,1099,1786674,123809,2559,9214960,1998
MT,education - higher education other,3646,7541671,4829,1957415,329627,5509,9499086,1998
MT,education - other,491,1229576,268,185566,16237,583,1415142,1998
MT,libraries,0,0,0,0,0,0,0,1998
MT,liquor stores,76,229344,5,6722,726,80,236066,1998
MT,other and unallocable,947,2542118,96,113421,9818,1004,2655539,1998
NE,total,25602,61489964,9157,5189002,632854,29176,66678966,1998
NE,financial administration,573,1501666,148,113425,15504,660,1615091,1998
NE,other government administration,392,1015804,68,47839,6112,426,1063643,1998
NE,judicial and legal,635,2122307,82,52313,6752,673,2174620,1998
NE,police arrest,434,1183269,18,22485,1441,442,1205754,1998
NE,police other,220,509567,7,8555,859,225,518122,1998
NE,corrections,1872,4253328,63,65868,6223,1907,4319196,1998
NE,streets and highways,2318,6600662,11,14962,1262,2325,6615624,1998
NE,air transportation,30,81525,1,585,88,30,82110,1998
NE,water transportation,0,0,0,0,0,0,0,1998
NE,public welfare,2730,5853969,127,39513,9296,2783,5893482,1998
NE,health,717,1788172,80,92527,8185,763,1880699,1998
NE,hospitals,3962,8285366,944,1222550,117592,4626,9507916,1998
NE,social insurance administration,454,1192530,13,13152,1214,461,1205682,1998
NE,solid waste management,0,0,0,0,0,0,0,1998
NE,sewage disposal,0,0,0,0,0,0,0,1998
NE,parks and recreation,229,497381,137,85670,14863,313,583051,1998
NE,housing and community development,0,0,0,0,0,0,0,1998
NE,natural resources,1384,2897124,662,378287,55916,1700,3275411,1998
NE,water transport and terminals,0,0,0,0,0,0,0,1998
NE,electric power,0,0,0,0,0,0,0,1998
NE,gas supply,0,0,0,0,0,0,0,1998
NE,transit,0,0,0,0,0,0,0,1998
NE,elem and sec instruction,0,0,0,0,0,0,0,1998
NE,elem and sec admin/cler,0,0,0,0,0,0,0,1998
NE,elem and sec oper/maint,0,0,0,0,0,0,0,1998
NE,elem and sec cafeteria,0,0,0,0,0,0,0,1998
NE,elem and sec bus transit,0,0,0,0,0,0,0,1998
NE,elem and sec health/rec,0,0,0,0,0,0,0,1998
NE,elem and sec student,0,0,0,0,0,0,0,1998
NE,elem and sec unalloc,0,0,0,0,0,0,0,1998
NE,higher ed - instructional,2399,7932565,905,784440,53580,2701,8717005,1998
NE,education - higher education other,5117,9593824,5599,2081998,319951,6925,11675822,1998
NE,education - other,591,1862048,97,42514,3440,610,1904562,1998
NE,libraries,0,0,0,0,0,0,0,1998
NE,liquor stores,0,0,0,0,0,0,0,1998
NE,other and unallocable,1545,4318857,195,122319,10576,1606,4441176,1998
NV,total,20899,66838979,5740,6500045,571861,24132,73339024,1998
NV,financial administration,1152,3004916,23,26135,2256,1165,3031051,1998
NV,other government administration,598,2072930,52,49835,3469,617,2122765,1998
NV,judicial and legal,507,2259792,11,19279,972,513,2279071,1998
NV,police arrest,353,1456812,0,0,0,353,1456812,1998
NV,police other,273,853666,1,890,97,274,854556,1998
NV,corrections,3047,9584662,76,130053,7745,3091,9714715,1998
NV,streets and highways,1539,4997815,7,3031,469,1542,5000846,1998
NV,air transportation,0,0,0,0,0,0,0,1998
NV,water transportation,0,0,0,0,0,0,0,1998
NV,public welfare,933,2598857,11,12288,1065,939,2611145,1998
NV,health,1616,5283515,128,204672,13889,1694,5488187,1998
NV,hospitals,1715,5263193,213,316475,23300,1847,5579668,1998
NV,social insurance administration,1476,4639326,20,39454,2176,1489,4678780,1998
NV,solid waste management,0,0,0,0,0,0,0,1998
NV,sewage disposal,0,0,0,0,0,0,0,1998
NV,parks and recreation,204,525635,12,17154,1244,211,542789,1998
NV,housing and community development,0,0,0,0,0,0,0,1998
NV,natural resources,872,2582271,394,336470,36434,1078,2918741,1998
NV,water transport and terminals,10,44340,0,0,0,10,44340,1998
NV,electric power,10,31107,0,0,0,10,31107,1998
NV,gas supply,0,0,0,0,0,0,0,1998
NV,transit,0,0,0,0,0,0,0,1998
NV,elem and sec instruction,0,0,0,0,0,0,0,1998
NV,elem and sec admin/cler,0,0,0,0,0,0,0,1998
NV,elem and sec oper/maint,0,0,0,0,0,0,0,1998
NV,elem and sec cafeteria,0,0,0,0,0,0,0,1998
NV,elem and sec bus transit,0,0,0,0,0,0,0,1998
NV,elem and sec health/rec,0,0,0,0,0,0,0,1998
NV,elem and sec student,0,0,0,0,0,0,0,1998
NV,elem and sec unalloc,0,0,0,0,0,0,0,1998
NV,higher ed - instructional,1606,8234090,1447,2602344,139900,2396,10836434,1998
NV,education - higher education other,2980,7037233,3234,2612444,329580,4842,9649677,1998
NV,education - other,98,323003,23,70706,3711,119,393709,1998
NV,libraries,0,0,0,0,0,0,0,1998
NV,liquor stores,0,0,0,0,0,0,0,1998
NV,other and unallocable,1910,6045816,88,58815,5554,1942,6104631,1998
NH,total,14710,38226355,7594,4535155,406173,17061,42761510,1998
NH,financial administration,442,1075792,32,22941,3065,461,1098733,1998
NH,other government administration,284,780325,50,49949,4975,313,830274,1998
NH,judicial and legal,894,2619338,32,25880,1920,906,2645218,1998
NH,police arrest,299,1140983,0,0,0,299,1140983,1998
NH,police other,107,280090,18,12582,1680,116,292672,1998
NH,corrections,1118,2916168,65,60086,5858,1152,2976254,1998
NH,streets and highways,1804,4312879,205,152795,16793,1905,4465674,1998
NH,air transportation,0,0,0,0,0,0,0,1998
NH,water transportation,5,15115,6,4452,492,8,19567,1998
NH,public welfare,1292,3138746,50,45076,4153,1317,3183822,1998
NH,health,852,2378771,76,62548,6264,890,2441319,1998
NH,hospitals,783,1797755,101,120570,5707,815,1918325,1998
NH,social insurance administration,429,1032705,66,58263,5444,461,1090968,1998
NH,solid waste management,0,0,0,0,0,0,0,1998
NH,sewage disposal,0,0,0,0,0,0,0,1998
NH,parks and recreation,80,187021,439,257926,36055,297,444947,1998
NH,housing and community development,0,0,0,0,0,0,0,1998
NH,natural resources,407,975037,129,78301,10346,466,1053338,1998
NH,water transport and terminals,0,0,0,0,0,0,0,1998
NH,electric power,0,0,0,0,0,0,0,1998
NH,gas supply,0,0,0,0,0,0,0,1998
NH,transit,0,0,0,0,0,0,0,1998
NH,elem and sec instruction,0,0,0,0,0,0,0,1998
NH,elem and sec admin/cler,0,0,0,0,0,0,0,1998
NH,elem and sec oper/maint,0,0,0,0,0,0,0,1998
NH,elem and sec cafeteria,0,0,0,0,0,0,0,1998
NH,elem and sec bus transit,0,0,0,0,0,0,0,1998
NH,elem and sec health/rec,0,0,0,0,0,0,0,1998
NH,elem and sec student,0,0,0,0,0,0,0,1998
NH,elem and sec unalloc,0,0,0,0,0,0,0,1998
NH,higher ed - instructional,1529,5308013,1508,1421804,61173,1885,6729817,1998
NH,education - higher education other,2164,4532304,4248,1795381,196295,3273,6327685,1998
NH,education - other,305,794551,26,31169,2435,319,825720,1998
NH,libraries,51,113678,6,5103,600,54,118781,1998
NH,liquor stores,299,695780,340,176967,27852,467,872747,1998
NH,other and unallocable,1566,4131304,197,153362,15066,1657,4284666,1998
NJ,total,114227,431718099,23910,19960674,1430382,123098,451678773,1998
NJ,financial administration,4732,16374487,603,909194,86920,5293,17283681,1998
NJ,other government administration,1365,5532072,37,52745,4151,1392,5584817,1998
NJ,judicial and legal,12291,42496655,155,196123,13977,12381,42692778,1998
NJ,police arrest,1001,2902388,14,17770,1698,1012,2920158,1998
NJ,police other,2625,14108004,0,0,0,2625,14108004,1998
NJ,corrections,9316,35458235,22,30848,2949,9335,35489083,1998
NJ,streets and highways,6992,27247349,943,729891,75762,7421,27977240,1998
NJ,air transportation,0,0,0,0,0,0,0,1998
NJ,water transportation,109,386479,5,5736,531,112,392215,1998
NJ,public welfare,5515,19250584,209,294597,27057,5689,19545181,1998
NJ,health,2515,9786831,376,241888,23123,2664,10028719,1998
NJ,hospitals,14903,45155060,1557,1656637,144868,15827,46811697,1998
NJ,social insurance administration,1740,5457335,367,629391,46076,2037,6086726,1998
NJ,solid waste management,654,2853430,3,1842,175,655,2855272,1998
NJ,sewage disposal,0,0,0,0,0,0,0,1998
NJ,parks and recreation,1530,5120452,1065,868559,76084,1966,5989011,1998
NJ,housing and community development,0,0,0,0,0,0,0,1998
NJ,natural resources,2373,8977686,440,471314,20488,2499,9449000,1998
NJ,water transport and terminals,110,361077,0,0,0,110,361077,1998
NJ,electric power,0,0,0,0,0,0,0,1998
NJ,gas supply,0,0,0,0,0,0,0,1998
NJ,transit,489,1783725,14,21905,1229,496,1805630,1998
NJ,elem and sec instruction,8333,39213046,397,205834,8200,8391,39418880,1998
NJ,elem and sec admin/cler,1274,3023038,5,4078,370,1277,3027116,1998
NJ,elem and sec oper/maint,1244,3004924,36,31308,3130,1266,3036232,1998
NJ,elem and sec cafeteria,877,1468035,313,115476,16496,993,1583511,1998
NJ,elem and sec bus transit,165,313859,6,4500,520,169,318359,1998
NJ,elem and sec health/rec,121,389088,7,6570,610,125,395658,1998
NJ,elem and sec student,0,0,43,12846,2470,17,12846,1998
NJ,elem and sec unalloc,2162,4511926,0,0,0,2162,4511926,1998
NJ,higher ed - instructional,6564,43670718,4783,6258366,210588,7860,49929084,1998
NJ,education - higher education other,15162,53573396,12102,6568268,613550,18943,60141664,1998
NJ,education - other,3387,13241586,276,440121,35716,3617,13681707,1998
NJ,libraries,0,0,0,0,0,0,0,1998
NJ,liquor stores,0,0,0,0,0,0,0,1998
NJ,other and unallocable,6678,26056634,132,184867,13644,6764,26241501,1998
NM,total,38330,93874715,14410,8420644,787455,42784,102295359,1998
NM,financial administration,1769,4327658,7,13410,978,1775,4341068,1998
NM,other government administration,217,616814,4,4756,310,219,621570,1998
NM,judicial and legal,2171,6058812,109,114974,9844,2228,6173786,1998
NM,police arrest,462,1569958,0,0,0,462,1569958,1998
NM,police other,171,584303,0,0,0,171,584303,1998
NM,corrections,3760,8557568,37,56776,5097,3789,8614344,1998
NM,streets and highways,2347,5630007,0,0,0,2347,5630007,1998
NM,air transportation,7,20907,0,0,0,7,20907,1998
NM,water transportation,0,0,0,0,0,0,0,1998
NM,public welfare,1311,2947290,7,9965,788,1315,2957255,1998
NM,health,2633,5196653,166,96511,7496,2676,5293164,1998
NM,hospitals,4855,9169309,1542,2472390,129314,5586,11641699,1998
NM,social insurance administration,517,1142373,8,10971,744,522,1153344,1998
NM,solid waste management,0,0,0,0,0,0,0,1998
NM,sewage disposal,0,0,0,0,0,0,0,1998
NM,parks and recreation,728,1316759,26,45329,4032,751,1362088,1998
NM,housing and community development,0,0,0,0,0,0,0,1998
NM,natural resources,1496,3992641,132,116979,12819,1569,4109620,1998
NM,water transport and terminals,0,0,0,0,0,0,0,1998
NM,electric power,0,0,0,0,0,0,0,1998
NM,gas supply,0,0,0,0,0,0,0,1998
NM,transit,0,0,0,0,0,0,0,1998
NM,elem and sec instruction,0,0,0,0,0,0,0,1998
NM,elem and sec admin/cler,0,0,0,0,0,0,0,1998
NM,elem and sec oper/maint,0,0,0,0,0,0,0,1998
NM,elem and sec cafeteria,0,0,0,0,0,0,0,1998
NM,elem and sec bus transit,0,0,0,0,0,0,0,1998
NM,elem and sec health/rec,0,0,0,0,0,0,0,1998
NM,elem and sec student,0,0,0,0,0,0,0,1998
NM,elem and sec unalloc,0,0,0,0,0,0,0,1998
NM,higher ed - instructional,3765,11775667,3371,2525810,161111,4675,14301477,1998
NM,education - higher education other,9780,25086813,8914,2882635,446600,12303,27969448,1998
NM,education - other,838,1979648,78,60560,7250,880,2040208,1998
NM,libraries,0,0,0,0,0,0,0,1998
NM,liquor stores,0,0,0,0,0,0,0,1998
NM,other and unallocable,1503,3901535,9,9578,1072,1509,3911113,1998
NY,total,231443,844471080,45711,48770248,3392669,251587,893241328,1998
NY,financial administration,17556,54558201,1152,1705631,58766,17891,56263832,1998
NY,other government administration,4764,14466039,848,1083185,123437,5461,15549224,1998
NY,judicial and legal,16797,76209026,871,1409166,75955,17228,77618192,1998
NY,police arrest,3989,18924302,0,0,0,3989,18924302,1998
NY,police other,1390,4050801,164,145695,14311,1471,4196496,1998
NY,corrections,34576,119121479,1063,1890360,84455,35053,121011839,1998
NY,streets and highways,12525,39159955,1074,1024717,92277,13045,40184672,1998
NY,air transportation,96,326859,10,14632,1085,102,341491,1998
NY,water transportation,858,3213643,46,93347,5585,889,3306990,1998
NY,public welfare,7894,26489638,629,956272,57381,8221,27445910,1998
NY,health,8696,34192960,1071,2210450,114293,9343,36403410,1998
NY,hospitals,44433,144698204,6502,10629700,565732,47660,155327904,1998
NY,social insurance administration,4453,14103552,92,190809,10178,4512,14294361,1998
NY,solid waste management,0,0,0,0,0,0,0,1998
NY,sewage disposal,0,0,0,0,0,0,0,1998
NY,parks and recreation,1696,5463071,1177,1440147,163619,2620,6903218,1998
NY,housing and community development,0,0,0,0,0,0,0,1998
NY,natural resources,2976,10870522,481,700959,39028,3197,11571481,1998
NY,water transport and terminals,0,0,0,0,0,0,0,1998
NY,electric power,3215,19848012,97,158921,8590,3267,20006933,1998
NY,gas supply,0,0,0,0,0,0,0,1998
NY,transit,14063,64647647,452,384826,39208,14284,65032473,1998
NY,elem and sec instruction,0,0,0,0,0,0,0,1998
NY,elem and sec admin/cler,0,0,0,0,0,0,0,1998
NY,elem and sec oper/maint,0,0,0,0,0,0,0,1998
NY,elem and sec cafeteria,0,0,0,0,0,0,0,1998
NY,elem and sec bus transit,0,0,0,0,0,0,0,1998
NY,elem and sec health/rec,0,0,0,0,0,0,0,1998
NY,elem and sec student,0,0,0,0,0,0,0,1998
NY,elem and sec unalloc,0,0,0,0,0,0,0,1998
NY,higher ed - instructional,12634,66345042,12402,12818401,732861,17124,79163443,1998
NY,education - higher education other,24052,74128229,15862,9234485,1057026,30606,83362714,1998
NY,education - other,3842,13513094,493,923168,48295,4114,14436262,1998
NY,libraries,0,0,0,0,0,0,0,1998
NY,liquor stores,0,0,0,0,0,0,0,1998
NY,other and unallocable,10938,40140804,1225,1755377,100587,11510,41896181,1998
NC,total,108343,306793346,31490,25879622,2653093,123329,332672968,1998
NC,financial administration,3300,8613829,123,134800,13469,3376,8748629,1998
NC,other government administration,625,2169364,507,887040,73434,1041,3056404,1998
NC,judicial and legal,5819,18168826,218,287092,28762,5982,18455918,1998
NC,police arrest,2263,8208277,18,26336,2883,2279,8234613,1998
NC,police other,1025,2567019,10,16629,1295,1032,2583648,1998
NC,corrections,19065,48892681,94,39435,4200,19089,48932116,1998
NC,streets and highways,12254,28318457,12,22902,2081,12266,28341359,1998
NC,air transportation,0,0,0,0,0,0,0,1998
NC,water transportation,282,1007490,0,0,0,282,1007490,1998
NC,public welfare,1313,3939557,65,25586,1722,1323,3965143,1998
NC,health,2479,7688330,213,189332,23518,2612,7877662,1998
NC,hospitals,14942,37508505,1277,1169867,82635,15408,38678372,1998
NC,social insurance administration,2401,6368048,226,223791,22714,2529,6591839,1998
NC,solid waste management,164,474064,3,3490,264,165,477554,1998
NC,sewage disposal,0,0,0,0,0,0,0,1998
NC,parks and recreation,864,1815941,18,15603,1634,872,1831544,1998
NC,housing and community development,0,0,0,0,0,0,0,1998
NC,natural resources,3574,9312479,1042,2343455,137237,4350,11655934,1998
NC,water transport and terminals,0,0,0,0,0,0,0,1998
NC,electric power,0,0,0,0,0,0,0,1998
NC,gas supply,0,0,0,0,0,0,0,1998
NC,transit,0,0,0,0,0,0,0,1998
NC,elem and sec instruction,0,0,0,0,0,0,0,1998
NC,elem and sec admin/cler,0,0,0,0,0,0,0,1998
NC,elem and sec oper/maint,0,0,0,0,0,0,0,1998
NC,elem and sec cafeteria,0,0,0,0,0,0,0,1998
NC,elem and sec bus transit,0,0,0,0,0,0,0,1998
NC,elem and sec health/rec,0,0,0,0,0,0,0,1998
NC,elem and sec student,0,0,0,0,0,0,0,1998
NC,elem and sec unalloc,0,0,0,0,0,0,0,1998
NC,higher ed - instructional,11350,50713493,10067,11542710,1164066,17926,62256203,1998
NC,education - higher education other,19528,50826347,17344,8635783,1067399,25557,59462130,1998
NC,education - other,2955,8714498,92,68533,5138,2985,8783031,1998
NC,libraries,0,0,0,0,0,0,0,1998
NC,liquor stores,0,0,0,0,0,0,0,1998
NC,other and unallocable,4140,11486141,161,247238,20642,4255,11733379,1998
ND,total,12881,32979072,7838,4296337,428953,15297,37275409,1998
ND,financial administration,561,1282443,88,71219,10405,620,1353662,1998
ND,other government administration,174,422377,115,437095,13438,249,859472,1998
ND,judicial and legal,395,1244937,49,13011,1790,405,1257948,1998
ND,police arrest,127,361899,0,0,0,127,361899,1998
ND,police other,95,202512,1,2850,176,96,205362,1998
ND,corrections,435,950018,28,17841,2424,448,967859,1998
ND,streets and highways,900,2194570,19,19277,2376,913,2213847,1998
ND,air transportation,0,0,0,0,0,0,0,1998
ND,water transportation,0,0,0,0,0,0,0,1998
ND,public welfare,270,552554,43,21450,3354,288,574004,1998
ND,health,1160,2696798,179,159366,13268,1235,2856164,1998
ND,hospitals,1117,2195988,159,31670,5554,1148,2227658,1998
ND,social insurance administration,404,945893,29,20124,2090,415,966017,1998
ND,solid waste management,0,0,0,0,0,0,0,1998
ND,sewage disposal,0,0,0,0,0,0,0,1998
ND,parks and recreation,94,216085,26,20619,2510,108,236704,1998
ND,housing and community development,0,0,0,0,0,0,0,1998
ND,natural resources,870,2330133,602,336973,60230,1210,2667106,1998
ND,water transport and terminals,0,0,0,0,0,0,0,1998
ND,electric power,0,0,0,0,0,0,0,1998
ND,gas supply,0,0,0,0,0,0,0,1998
ND,transit,0,0,0,0,0,0,0,1998
ND,elem and sec instruction,0,0,0,0,0,0,0,1998
ND,elem and sec admin/cler,0,0,0,0,0,0,0,1998
ND,elem and sec oper/maint,0,0,0,0,0,0,0,1998
ND,elem and sec cafeteria,0,0,0,0,0,0,0,1998
ND,elem and sec bus transit,0,0,0,0,0,0,0,1998
ND,elem and sec health/rec,0,0,0,0,0,0,0,1998
ND,elem and sec student,0,0,0,0,0,0,0,1998
ND,elem and sec unalloc,0,0,0,0,0,0,0,1998
ND,higher ed - instructional,1822,7317540,1907,1887385,100916,2391,9204925,1998
ND,education - higher education other,3066,6624837,4450,1148684,198363,4186,7773521,1998
ND,education - other,309,718420,52,35920,3612,329,754340,1998
ND,libraries,0,0,0,0,0,0,0,1998
ND,liquor stores,0,0,0,0,0,0,0,1998
ND,other and unallocable,1082,2722068,91,72853,8447,1129,2794921,1998
OH,total,112054,356820447,60150,49194675,4202380,135824,406015122,1998
OH,financial administration,8005,27546786,546,666347,56272,8325,28213133,1998
OH,other government administration,878,2534964,176,99431,13664,954,2634395,1998
OH,judicial and legal,2372,8474350,454,873344,53652,2675,9347694,1998
OH,police arrest,1307,5565531,0,0,0,1307,5565531,1998
OH,police other,1122,3123551,14,20066,1752,1132,3143617,1998
OH,corrections,17022,51339140,99,146478,11136,17085,51485618,1998
OH,streets and highways,7361,24732672,361,350286,35503,7562,25082958,1998
OH,air transportation,0,0,0,0,0,0,0,1998
OH,water transportation,0,0,0,0,0,0,0,1998
OH,public welfare,2024,7331070,185,151332,20271,2139,7482402,1998
OH,health,3579,13487036,322,254943,25523,3724,13741979,1998
OH,hospitals,10363,24922908,3081,5479557,344143,12308,30402465,1998
OH,social insurance administration,2915,9326017,47,55939,3398,2934,9381956,1998
OH,solid waste management,0,0,0,0,0,0,0,1998
OH,sewage disposal,0,0,0,0,0,0,0,1998
OH,parks and recreation,631,1904184,204,196685,17694,731,2100869,1998
OH,housing and community development,0,0,0,0,0,0,0,1998
OH,natural resources,3422,9793009,841,1071491,84639,3899,10864500,1998
OH,water transport and terminals,0,0,0,0,0,0,0,1998
OH,electric power,0,0,0,0,0,0,0,1998
OH,gas supply,0,0,0,0,0,0,0,1998
OH,transit,0,0,0,0,0,0,0,1998
OH,elem and sec instruction,0,0,0,0,0,0,0,1998
OH,elem and sec admin/cler,0,0,0,0,0,0,0,1998
OH,elem and sec oper/maint,0,0,0,0,0,0,0,1998
OH,elem and sec cafeteria,0,0,0,0,0,0,0,1998
OH,elem and sec bus transit,0,0,0,0,0,0,0,1998
OH,elem and sec health/rec,0,0,0,0,0,0,0,1998
OH,elem and sec student,0,0,0,0,0,0,0,1998
OH,elem and sec unalloc,0,0,0,0,0,0,0,1998
OH,higher ed - instructional,15336,71973494,16825,19234071,1087525,21494,91207565,1998
OH,education - higher education other,28297,68755155,36512,20079509,2408917,41919,88834664,1998
OH,education - other,2134,7587529,136,174905,9472,2186,7762434,1998
OH,libraries,0,0,0,0,0,0,0,1998
OH,liquor stores,0,0,0,0,0,0,0,1998
OH,other and unallocable,5286,18423051,347,340291,28819,5450,18763342,1998
OK,total,63413,130063337,20722,12094100,1386449,71325,142157437,1998
OK,financial administration,2122,3971314,14,17589,1493,2130,3988903,1998
OK,other government administration,1179,2473964,164,192748,15486,1268,2666712,1998
OK,judicial and legal,2232,6407444,85,51058,2930,2248,6458502,1998
OK,police arrest,952,2563824,0,0,0,952,2563824,1998
OK,police other,753,1614526,24,13261,1588,762,1627787,1998
OK,corrections,10623,14410062,178,142455,18866,10730,14552517,1998
OK,streets and highways,4093,6688851,25,16298,1871,4104,6705149,1998
OK,water transportation,0,0,0,0,0,0,0,1998
OK,air transportation,0,0,0,0,0,0,0,1998
OK,public welfare,5900,10107901,179,117417,16166,5992,10225318,1998
OK,health,4077,8816262,252,140531,16716,4171,8956793,1998
OK,hospitals,3659,6612860,37,14765,1749,3668,6627625,1998
OK,social insurance administration,1635,3498841,97,53921,4607,1662,3552762,1998
OK,solid waste management,0,0,0,0,0,0,0,1998
OK,sewage disposal,0,0,0,0,0,0,0,1998
OK,parks and recreation,1527,2418867,535,137411,23415,1659,2556278,1998
OK,housing and community development,0,0,0,0,0,0,0,1998
OK,natural resources,1485,3083017,152,71597,9239,1538,3154614,1998
OK,water transport and terminals,0,0,0,0,0,0,0,1998
OK,electric power,448,1501860,1,112,16,448,1501972,1998
OK,gas supply,0,0,0,0,0,0,0,1998
OK,transit,0,0,0,0,0,0,0,1998
OK,elem and sec instruction,0,0,0,0,0,0,0,1998
OK,elem and sec admin/cler,0,0,0,0,0,0,0,1998
OK,elem and sec oper/maint,0,0,0,0,0,0,0,1998
OK,elem and sec cafeteria,0,0,0,0,0,0,0,1998
OK,elem and sec bus transit,0,0,0,0,0,0,0,1998
OK,elem and sec health/rec,0,0,0,0,0,0,0,1998
OK,elem and sec student,0,0,0,0,0,0,0,1998
OK,elem and sec unalloc,0,0,0,0,0,0,0,1998
OK,higher ed - instructional,5590,22218748,5332,5856042,374128,7719,28074790,1998
OK,education - higher education other,12791,24005583,13464,5144581,886910,17864,29150164,1998
OK,education - other,2115,4894601,114,75092,6566,2153,4969693,1998
OK,libraries,0,0,0,0,0,0,0,1998
OK,liquor stores,0,0,0,0,0,0,0,1998
OK,other and unallocable,2232,4774812,69,49222,4703,2257,4824034,1998
OR,total,45431,136193654,22804,24982920,1800911,55605,161176574,1998
OR,financial administration,3794,11483263,445,646948,52623,4093,12130211,1998
OR,other government administration,1207,3378637,190,181278,17505,1306,3559915,1998
OR,judicial and legal,2433,7272184,268,698109,46484,2695,7970293,1998
OR,police arrest,901,3387109,52,70054,5200,930,3457163,1998
OR,police other,436,1160568,69,95088,5130,464,1255656,1998
OR,corrections,3838,10702896,277,332418,32302,4020,11035314,1998
OR,streets and highways,3598,11972000,453,778000,45765,3857,12750000,1998
OR,air transportation,0,0,0,0,0,0,0,1998
OR,water transportation,0,0,0,0,0,0,0,1998
OR,public welfare,4921,13726989,423,921537,38715,5139,14648526,1998
OR,health,1508,4500173,194,332496,24324,1645,4832669,1998
OR,hospitals,4542,11009306,1903,3503725,434182,6995,14513031,1998
OR,social insurance administration,2009,6334906,233,525917,34402,2203,6860823,1998
OR,solid waste management,0,0,0,0,0,0,0,1998
OR,sewage disposal,0,0,0,0,0,0,0,1998
OR,parks and recreation,676,875993,17,21836,2634,691,897829,1998
OR,housing and community development,0,0,0,0,0,0,0,1998
OR,natural resources,2638,7446303,508,440902,44380,2888,7887205,1998
OR,water transport and terminals,0,0,0,0,0,0,0,1998
OR,electric power,0,0,0,0,0,0,0,1998
OR,gas supply,0,0,0,0,0,0,0,1998
OR,transit,0,0,0,0,0,0,0,1998
OR,elem and sec instruction,0,0,0,0,0,0,0,1998
OR,elem and sec admin/cler,0,0,0,0,0,0,0,1998
OR,elem and sec oper/maint,0,0,0,0,0,0,0,1998
OR,elem and sec cafeteria,0,0,0,0,0,0,0,1998
OR,elem and sec bus transit,0,0,0,0,0,0,0,1998
OR,elem and sec health/rec,0,0,0,0,0,0,0,1998
OR,elem and sec student,0,0,0,0,0,0,0,1998
OR,elem and sec unalloc,0,0,0,0,0,0,0,1998
OR,higher ed - instructional,5006,23024612,7376,12159330,607967,8441,35183942,1998
OR,education - higher education other,4694,10970474,9998,3674305,367430,6770,14644779,1998
OR,education - other,942,2684843,196,426990,28208,1102,3111833,1998
OR,libraries,0,0,0,0,0,0,0,1998
OR,liquor stores,156,418890,24,20510,1655,165,439400,1998
OR,other and unallocable,2132,5844508,178,153477,12005,2201,5997985,1998
PA,total,130966,417496989,47648,41037996,3090733,149185,458534985,1998
PA,financial administration,6950,21191905,603,882467,94065,7516,22074372,1998
PA,other government administration,2855,8240695,1296,1961912,117207,3549,10202607,1998
PA,judicial and legal,2338,9186164,93,442074,15556,2445,9628238,1998
PA,police arrest,4112,15757578,0,0,0,4112,15757578,1998
PA,police other,1162,4427796,117,163710,19428,1279,4591506,1998
PA,corrections,13903,41369960,288,570318,43476,14164,41940278,1998
PA,streets and highways,12715,36454889,948,1655534,154619,13637,38110423,1998
PA,air transportation,42,128563,1,1647,166,43,130210,1998
PA,water transportation,71,297690,3,6939,498,74,304629,1998
PA,public welfare,11926,36217636,180,362614,29125,12102,36580250,1998
PA,health,1562,5086685,65,184003,4461,1590,5270688,1998
PA,hospitals,14561,37224930,918,1402712,94445,15125,38627642,1998
PA,social insurance administration,4274,13288880,204,407239,33020,4473,13696119,1998
PA,solid waste management,0,0,0,0,0,0,0,1998
PA,sewage disposal,0,0,0,0,0,0,0,1998
PA,parks and recreation,893,2708929,436,750519,65992,1290,3459448,1998
PA,housing and community development,0,0,0,0,0,0,0,1998
PA,natural resources,6606,21639739,1242,1692768,112977,7267,23332507,1998
PA,water transport and terminals,0,0,0,0,0,0,0,1998
PA,electric power,0,0,0,0,0,0,0,1998
PA,gas supply,0,0,0,0,0,0,0,1998
PA,transit,0,0,0,0,0,0,0,1998
PA,elem and sec instruction,0,0,0,0,0,0,0,1998
PA,elem and sec admin/cler,0,0,0,0,0,0,0,1998
PA,elem and sec oper/maint,0,0,0,0,0,0,0,1998
PA,elem and sec cafeteria,0,0,0,0,0,0,0,1998
PA,elem and sec bus transit,0,0,0,0,0,0,0,1998
PA,elem and sec health/rec,0,0,0,0,0,0,0,1998
PA,elem and sec student,0,0,0,0,0,0,0,1998
PA,elem and sec unalloc,0,0,0,0,0,0,0,1998
PA,higher ed - instructional,12328,70993808,9250,15619462,719828,16520,86613270,1998
PA,education - higher education other,24719,62968498,30504,13839069,1472683,33369,76807567,1998
PA,education - other,2695,8417314,232,199422,18507,2806,8616736,1998
PA,libraries,0,0,0,0,0,0,0,1998
PA,liquor stores,2743,7202436,911,418871,46884,3025,7621307,1998
PA,other and unallocable,4511,14692894,357,476716,47796,4799,15169610,1998
RI,total,18231,60080343,6072,3981743,332822,20232,64062086,1998
RI,financial administration,686,1992195,6,10024,540,689,2002219,1998
RI,other government administration,764,1588579,159,13793,381,766,1602372,1998
RI,judicial and legal,1068,3911958,33,35468,1156,1075,3947426,1998
RI,police arrest,209,1038891,0,0,0,209,1038891,1998
RI,police other,70,218083,1,500,14,70,218583,1998
RI,corrections,1719,7273964,0,0,0,1719,7273964,1998
RI,streets and highways,872,2816079,20,22419,1590,881,2838498,1998
RI,air transportation,0,0,0,0,0,0,0,1998
RI,water transportation,0,0,0,0,0,0,0,1998
RI,public welfare,1839,6040895,42,54741,3451,1861,6095636,1998
RI,health,1295,4587945,3,8962,377,1297,4596907,1998
RI,hospitals,1229,4017819,36,84686,3930,1251,4102505,1998
RI,social insurance administration,690,1961738,43,67446,5404,725,2029184,1998
RI,solid waste management,80,314831,0,0,0,80,314831,1998
RI,sewage disposal,252,762371,0,0,0,252,762371,1998
RI,parks and recreation,75,169856,0,0,0,75,169856,1998
RI,housing and community development,0,0,0,0,0,0,0,1998
RI,natural resources,536,1749489,51,25018,3821,558,1774507,1998
RI,water transport and terminals,0,0,0,0,0,0,0,1998
RI,electric power,0,0,0,0,0,0,0,1998
RI,gas supply,0,0,0,0,0,0,0,1998
RI,transit,516,1678866,25,40423,4044,539,1719289,1998
RI,elem and sec instruction,324,1288634,47,41116,3467,350,1329750,1998
RI,elem and sec admin/cler,27,57232,3,3277,266,29,60509,1998
RI,elem and sec oper/maint,25,58472,3,3055,332,27,61527,1998
RI,elem and sec cafeteria,0,0,22,12970,2236,17,12970,1998
RI,elem and sec bus transit,6,18000,26,34870,2874,28,52870,1998
RI,elem and sec health/rec,0,0,0,0,0,0,0,1998
RI,elem and sec student,0,0,0,0,0,0,0,1998
RI,elem and sec unalloc,0,0,29,16516,1751,13,16516,1998
RI,higher ed - instructional,1857,7134353,2566,2617816,151709,2768,9752169,1998
RI,education - higher education other,2359,5364768,2760,623863,125920,3096,5988631,1998
RI,education - other,504,2430255,130,196264,13691,593,2626519,1998
RI,libraries,0,0,0,0,0,0,0,1998
RI,liquor stores,0,0,0,0,0,0,0,1998
RI,other and unallocable,1229,3605070,67,68516,5868,1264,3673586,1998
SC,total,73655,183123070,21917,11460083,1067507,80022,194583153,1998
SC,financial administration,2567,7139150,14,11422,1262,2574,7150572,1998
SC,other government administration,503,1404272,559,396851,38012,732,1801123,1998
SC,judicial and legal,666,2379984,4,2260,308,668,2382244,1998
SC,police arrest,1340,3764472,0,0,0,1340,3764472,1998
SC,police other,1402,3376216,15,13518,806,1407,3389734,1998
SC,corrections,8968,18778522,5,7160,444,8970,18785682,1998
SC,streets and highways,4879,9519508,5,4780,360,4881,9524288,1998
SC,water transportation,517,1773199,0,0,0,517,1773199,1998
SC,air transportation,0,0,0,0,0,0,0,1998
SC,public welfare,4979,10843948,9,9822,996,4985,10853770,1998
SC,health,7955,19235991,99,134372,8967,8008,19370363,1998
SC,hospitals,8995,15797789,157,228593,24093,9131,16026382,1998
SC,social insurance administration,1355,3330942,2,2632,84,1356,3333574,1998
SC,solid waste management,0,0,0,0,0,0,0,1998
SC,sewage disposal,0,0,0,0,0,0,0,1998
SC,parks and recreation,630,1277933,13,9759,1415,638,1287692,1998
SC,housing and community development,0,0,0,0,0,0,0,1998
SC,natural resources,2493,6721596,322,130286,21054,2619,6851882,1998
SC,water transport and terminals,0,0,0,0,0,0,0,1998
SC,electric power,1679,6504462,17,43485,2176,1691,6547947,1998
SC,gas supply,0,0,0,0,0,0,0,1998
SC,transit,0,0,0,0,0,0,0,1998
SC,elem and sec instruction,0,0,0,0,0,0,0,1998
SC,elem and sec admin/cler,0,0,0,0,0,0,0,1998
SC,elem and sec oper/maint,0,0,0,0,0,0,0,1998
SC,elem and sec cafeteria,0,0,0,0,0,0,0,1998
SC,elem and sec bus transit,0,0,0,0,0,0,0,1998
SC,elem and sec health/rec,0,0,0,0,0,0,0,1998
SC,elem and sec student,0,0,0,0,0,0,0,1998
SC,elem and sec unalloc,0,0,0,0,0,0,0,1998
SC,higher ed - instructional,8003,33247953,9239,6222948,385709,10316,39470901,1998
SC,education - higher education other,12422,26884367,11424,4205575,579359,15873,31089942,1998
SC,education - other,2834,7092260,20,22314,1264,2841,7114574,1998
SC,libraries,0,0,0,0,0,0,0,1998
SC,liquor stores,0,0,0,0,0,0,0,1998
SC,other and unallocable,1468,4050506,13,14306,1198,1475,4064812,1998
SD,total,11504,29441543,5148,2285380,274663,13056,31726923,1998
SD,financial administration,421,1091693,12,13601,1384,430,1105294,1998
SD,other government administration,297,740687,157,34187,2274,310,774874,1998
SD,judicial and legal,474,1358756,94,58932,6618,511,1417688,1998
SD,police arrest,185,535819,2,1242,210,186,537061,1998
SD,police other,85,168330,5,2570,303,87,170900,1998
SD,corrections,843,1634506,29,25248,2768,859,1659754,1998
SD,streets and highways,904,2387456,131,89452,10060,961,2476908,1998
SD,air transportation,0,0,0,0,0,0,0,1998
SD,water transportation,0,0,0,0,0,0,0,1998
SD,public welfare,894,1898905,60,51575,6242,929,1950480,1998
SD,health,482,1217166,36,53969,4346,507,1271135,1998
SD,hospitals,889,1839862,77,81289,7056,929,1921151,1998
SD,social insurance administration,293,604001,5,5502,523,296,609503,1998
SD,solid waste management,0,0,0,0,0,0,0,1998
SD,sewage disposal,0,0,0,0,0,0,0,1998
SD,parks and recreation,116,256775,23,16908,2274,129,273683,1998
SD,housing and community development,0,0,0,0,0,0,0,1998
SD,natural resources,736,1790253,322,110108,15947,827,1900361,1998
SD,water transport and terminals,0,0,0,0,0,0,0,1998
SD,electric power,0,0,0,0,0,0,0,1998
SD,gas supply,0,0,0,0,0,0,0,1998
SD,transit,0,0,0,0,0,0,0,1998
SD,elem and sec instruction,0,0,0,0,0,0,0,1998
SD,elem and sec admin/cler,0,0,0,0,0,0,0,1998
SD,elem and sec oper/maint,0,0,0,0,0,0,0,1998
SD,elem and sec cafeteria,0,0,0,0,0,0,0,1998
SD,elem and sec bus transit,0,0,0,0,0,0,0,1998
SD,elem and sec health/rec,0,0,0,0,0,0,0,1998
SD,elem and sec student,0,0,0,0,0,0,0,1998
SD,elem and sec unalloc,0,0,0,0,0,0,0,1998
SD,higher ed - instructional,1402,5965365,826,737090,67879,1785,6702455,1998
SD,education - higher education other,2130,4324670,3208,882449,135292,2894,5207119,1998
SD,education - other,358,843429,35,27183,2956,374,870612,1998
SD,libraries,0,0,0,0,0,0,0,1998
SD,liquor stores,0,0,0,0,0,0,0,1998
SD,other and unallocable,995,2783870,126,94075,8531,1042,2877945,1998
TN,total,70398,182822724,22040,19627113,1766449,80727,202449837,1998
TN,financial administration,2517,6866968,56,48050,4702,2545,6915018,1998
TN,other government administration,681,1808400,61,46060,2816,699,1854460,1998
TN,judicial and legal,1847,6831114,53,60008,2972,1865,6891122,1998
TN,police arrest,956,3019840,0,0,0,956,3019840,1998
TN,police other,801,1667196,6,2550,430,804,1669746,1998
TN,corrections,6061,12190775,15,12795,754,6066,12203570,1998
TN,streets and highways,4769,10198602,0,0,0,4769,10198602,1998
TN,water transportation,0,0,0,0,0,0,0,1998
TN,air transportation,0,0,0,0,0,0,0,1998
TN,public welfare,5138,12444922,25,19686,1960,5150,12464608,1998
TN,health,2949,7641832,117,120046,9347,3003,7761878,1998
TN,hospitals,9590,26464546,471,985401,69773,9987,27449947,1998
TN,social insurance administration,1432,3450338,240,270082,26020,1589,3720420,1998
TN,solid waste management,0,0,0,0,0,0,0,1998
TN,sewage disposal,0,0,0,0,0,0,0,1998
TN,parks and recreation,1006,1689964,84,46000,8246,1056,1735964,1998
TN,housing and community development,0,0,0,0,0,0,0,1998
TN,natural resources,3069,7332487,622,590810,67584,3462,7923297,1998
TN,water transport and terminals,0,0,0,0,0,0,0,1998
TN,electric power,0,0,0,0,0,0,0,1998
TN,gas supply,0,0,0,0,0,0,0,1998
TN,transit,0,0,0,0,0,0,0,1998
TN,elem and sec instruction,0,0,0,0,0,0,0,1998
TN,elem and sec admin/cler,0,0,0,0,0,0,0,1998
TN,elem and sec oper/maint,0,0,0,0,0,0,0,1998
TN,elem and sec cafeteria,0,0,0,0,0,0,0,1998
TN,elem and sec bus transit,0,0,0,0,0,0,0,1998
TN,elem and sec health/rec,0,0,0,0,0,0,0,1998
TN,elem and sec student,0,0,0,0,0,0,0,1998
TN,elem and sec unalloc,0,0,0,0,0,0,0,1998
TN,higher ed - instructional,8732,36612906,6933,8019248,572429,12127,44632154,1998
TN,education - higher education other,16280,33393988,13198,9314677,992415,22036,42708665,1998
TN,education - other,1956,4879726,116,70916,5123,1987,4950642,1998
TN,libraries,0,0,0,0,0,0,0,1998
TN,liquor stores,0,0,0,0,0,0,0,1998
TN,other and unallocable,2614,6329120,43,20784,1878,2626,6349904,1998
TX,total,244431,694825167,57082,50612188,4171713,268005,745437355,1998
TX,financial administration,9058,25638162,268,311794,23268,9190,25949956,1998
TX,other government administration,2043,5625309,445,471622,40496,2272,6096931,1998
TX,judicial and legal,4751,17147917,89,128026,3093,4768,17275943,1998
TX,police arrest,1469,4665004,0,0,0,1469,4665004,1998
TX,police other,2092,5510645,40,30337,3200,2110,5540982,1998
TX,corrections,46159,97779646,62,50432,1264,46166,97830078,1998
TX,streets and highways,13696,35917358,123,157824,15468,13783,36075182,1998
TX,water transportation,0,0,0,0,0,0,0,1998
TX,air transportation,0,0,0,0,0,0,0,1998
TX,public welfare,20995,45806918,141,187344,8658,21044,45994262,1998
TX,health,10044,23522811,535,1244049,58113,10372,24766860,1998
TX,hospitals,38356,120249879,1489,2718693,197652,39474,122968572,1998
TX,social insurance administration,6030,14177066,61,78125,6102,6065,14255191,1998
TX,solid waste management,0,0,0,0,0,0,0,1998
TX,sewage disposal,0,0,0,0,0,0,0,1998
TX,parks and recreation,734,1505747,350,268636,40913,965,1774383,1998
TX,housing and community development,0,0,0,0,0,0,0,1998
TX,natural resources,10403,31161714,3515,2383337,226161,11681,33545051,1998
TX,water transport and terminals,0,0,0,0,0,0,0,1998
TX,electric power,0,0,0,0,0,0,0,1998
TX,gas supply,0,0,0,0,0,0,0,1998
TX,transit,0,0,0,0,0,0,0,1998
TX,elem and sec instruction,0,0,0,0,0,0,0,1998
TX,elem and sec admin/cler,0,0,0,0,0,0,0,1998
TX,elem and sec oper/maint,0,0,0,0,0,0,0,1998
TX,elem and sec cafeteria,0,0,0,0,0,0,0,1998
TX,elem and sec bus transit,0,0,0,0,0,0,0,1998
TX,elem and sec health/rec,0,0,0,0,0,0,0,1998
TX,elem and sec student,0,0,0,0,0,0,0,1998
TX,elem and sec unalloc,0,0,0,0,0,0,0,1998
TX,higher ed - instructional,19455,108207701,15131,22417935,1241865,26471,130625636,1998
TX,education - higher education other,48110,126912456,33722,18986748,2217664,60644,145899204,1998
TX,education - other,4271,11583125,596,861644,72957,4684,12444769,1998
TX,libraries,0,0,0,0,0,0,0,1998
TX,liquor stores,0,0,0,0,0,0,0,1998
TX,other and unallocable,6765,19413709,515,315642,14839,6847,19729351,1998
UT,total,41311,109545969,14902,9603435,915478,46485,119149404,1998
UT,financial administration,1438,4068353,244,211701,26870,1589,4280054,1998
UT,other government administration,173,628643,29,42002,3333,192,670645,1998
UT,judicial and legal,1456,4495713,195,200296,17641,1556,4696009,1998
UT,police arrest,386,1308901,0,0,0,386,1308901,1998
UT,police other,319,906600,42,32451,3440,338,939051,1998
UT,corrections,2663,6790670,393,263284,29958,2833,7053954,1998
UT,streets and highways,1715,5351057,64,87411,8365,1762,5438468,1998
UT,air transportation,0,0,0,0,0,0,0,1998
UT,water transportation,0,0,0,0,0,0,0,1998
UT,public welfare,2938,7345773,387,411479,34984,3136,7757252,1998
UT,health,1403,4131920,148,185059,11522,1468,4316979,1998
UT,hospitals,4804,11676366,80,59698,8061,4850,11736064,1998
UT,social insurance administration,769,2427337,219,106285,19873,881,2533622,1998
UT,solid waste management,0,0,0,0,0,0,0,1998
UT,sewage disposal,0,0,0,0,0,0,0,1998
UT,parks and recreation,280,766834,52,52647,6451,316,819481,1998
UT,housing and community development,0,0,0,0,0,0,0,1998
UT,natural resources,1023,2969948,253,195286,18492,1128,3165234,1998
UT,water transport and terminals,0,0,0,0,0,0,0,1998
UT,electric power,0,0,0,0,0,0,0,1998
UT,gas supply,0,0,0,0,0,0,0,1998
UT,transit,0,0,0,0,0,0,0,1998
UT,elem and sec instruction,0,0,0,0,0,0,0,1998
UT,elem and sec admin/cler,0,0,0,0,0,0,0,1998
UT,elem and sec oper/maint,0,0,0,0,0,0,0,1998
UT,elem and sec cafeteria,0,0,0,0,0,0,0,1998
UT,elem and sec bus transit,0,0,0,0,0,0,0,1998
UT,elem and sec health/rec,0,0,0,0,0,0,0,1998
UT,elem and sec student,0,0,0,0,0,0,0,1998
UT,elem and sec unalloc,0,0,0,0,0,0,0,1998
UT,higher ed - instructional,4434,22719604,3520,3164756,170029,5398,25884360,1998
UT,education - higher education other,14889,26617825,8539,4061308,506867,17752,30679133,1998
UT,education - other,872,2384719,323,270460,23338,1003,2655179,1998
UT,libraries,0,0,0,0,0,0,0,1998
UT,liquor stores,203,491362,191,93561,13107,277,584923,1998
UT,other and unallocable,1546,4464344,223,165751,13147,1620,4630095,1998
VT,total,11396,31762894,2758,2525989,193208,12530,34288883,1998
VT,financial administration,488,1391604,15,23335,2511,503,1414939,1998
VT,other government administration,361,935297,155,358308,3837,382,1293605,1998
VT,judicial and legal,516,1657002,70,108555,7343,558,1765557,1998
VT,police arrest,304,1192409,26,7370,753,308,1199779,1998
VT,police other,139,389573,36,31354,3921,161,420927,1998
VT,corrections,882,2138259,26,39051,3615,902,2177310,1998
VT,streets and highways,978,2786923,16,23579,2172,990,2810502,1998
VT,air transportation,0,0,0,0,0,0,0,1998
VT,water transportation,0,0,0,0,0,0,0,1998
VT,public welfare,986,2717262,141,253908,24416,1123,2971170,1998
VT,health,465,1279145,79,164845,10005,521,1443990,1998
VT,hospitals,182,449143,9,14097,1196,189,463240,1998
VT,social insurance administration,304,822054,31,64620,5032,332,886674,1998
VT,solid waste management,0,0,0,0,0,0,0,1998
VT,sewage disposal,0,0,0,0,0,0,0,1998
VT,parks and recreation,113,316480,10,19315,1337,121,335795,1998
VT,housing and community development,0,0,0,0,0,0,0,1998
VT,natural resources,600,1789516,45,78505,6047,635,1868021,1998
VT,water transport and terminals,0,0,0,0,0,0,0,1998
VT,electric power,0,0,0,0,0,0,0,1998
VT,gas supply,0,0,0,0,0,0,0,1998
VT,transit,0,0,0,0,0,0,0,1998
VT,elem and sec instruction,0,0,0,0,0,0,0,1998
VT,elem and sec admin/cler,0,0,0,0,0,0,0,1998
VT,elem and sec oper/maint,0,0,0,0,0,0,0,1998
VT,elem and sec cafeteria,0,0,0,0,0,0,0,1998
VT,elem and sec bus transit,0,0,0,0,0,0,0,1998
VT,elem and sec health/rec,0,0,0,0,0,0,0,1998
VT,elem and sec student,0,0,0,0,0,0,0,1998
VT,elem and sec unalloc,0,0,0,0,0,0,0,1998
VT,higher ed - instructional,1184,4643521,671,630247,42040,1437,5273768,1998
VT,education - higher education other,2462,5196625,1296,543241,65279,2856,5739866,1998
VT,education - other,394,1163706,42,43397,3668,416,1207103,1998
VT,libraries,0,0,0,0,0,0,0,1998
VT,liquor stores,51,145475,0,0,0,51,145475,1998
VT,other and unallocable,987,2748900,90,122262,10036,1045,2871162,1998
VA,total,95763,288552514,45700,33109693,2639917,110675,321662207,1998
VA,financial administration,3667,10651242,634,581495,60136,4006,11232737,1998
VA,other government administration,636,1901593,340,315254,26556,789,2216847,1998
VA,judicial and legal,3027,9426011,532,575720,34316,3219,10001731,1998
VA,police arrest,1764,6159938,0,0,0,1764,6159938,1998
VA,police other,681,1661958,145,103846,10430,740,1765804,1998
VA,corrections,13377,30728228,504,473610,46636,13640,31201838,1998
VA,streets and highways,9696,25627814,848,458595,42015,9933,26086409,1998
VA,air transportation,0,0,0,0,0,0,0,1998
VA,water transportation,128,387968,6,6132,652,132,394100,1998
VA,public welfare,1841,4971164,194,263490,22958,1972,5234654,1998
VA,health,4809,13962478,740,756460,69832,5203,14718938,1998
VA,hospitals,11127,27928849,1325,1612223,100374,11695,29541072,1998
VA,social insurance administration,1090,3115640,462,478222,44206,1340,3593862,1998
VA,solid waste management,0,0,0,0,0,0,0,1998
VA,sewage disposal,0,0,0,0,0,0,0,1998
VA,parks and recreation,513,1324862,624,372283,53353,814,1697145,1998
VA,housing and community development,0,0,0,0,0,0,0,1998
VA,natural resources,2794,8671652,536,488242,49233,3072,9159894,1998
VA,water transport and terminals,0,0,0,0,0,0,0,1998
VA,electric power,0,0,0,0,0,0,0,1998
VA,gas supply,0,0,0,0,0,0,0,1998
VA,transit,0,0,0,0,0,0,0,1998
VA,elem and sec instruction,0,0,0,0,0,0,0,1998
VA,elem and sec admin/cler,0,0,0,0,0,0,0,1998
VA,elem and sec oper/maint,0,0,0,0,0,0,0,1998
VA,elem and sec cafeteria,0,0,0,0,0,0,0,1998
VA,elem and sec bus transit,0,0,0,0,0,0,0,1998
VA,elem and sec health/rec,0,0,0,0,0,0,0,1998
VA,elem and sec student,0,0,0,0,0,0,0,1998
VA,elem and sec unalloc,0,0,0,0,0,0,0,1998
VA,higher ed - instructional,12293,68566819,12659,15153868,738035,16460,83720687,1998
VA,education - higher education other,21750,53705900,24137,9777557,1175637,28392,63483457,1998
VA,education - other,2559,7487982,591,559752,47730,2829,8047734,1998
VA,libraries,0,0,0,0,0,0,0,1998
VA,liquor stores,685,1667030,876,630434,75962,1114,2297464,1998
VA,other and unallocable,3326,10605386,547,502510,41856,3561,11107896,1998
WA,total,86427,282737540,50890,45839684,3533830,106432,328577224,1998
WA,financial administration,2430,7743458,140,266406,15502,2520,8009864,1998
WA,other government administration,1244,3596808,209,133872,16040,1335,3730680,1998
WA,judicial and legal,1609,6890934,173,146390,9620,1665,7037324,1998
WA,police arrest,925,4133600,0,0,0,925,4133600,1998
WA,police other,1207,3299308,1,218,16,1207,3299526,1998
WA,corrections,7705,22729838,262,329060,19586,7816,23058898,1998
WA,streets and highways,6042,21876276,337,608946,28882,6205,22485222,1998
WA,air transportation,0,0,0,0,0,0,0,1998
WA,water transportation,0,0,0,0,0,0,0,1998
WA,public welfare,7114,22419036,674,1181758,75578,7541,23600794,1998
WA,health,6019,19932815,751,1195890,65893,6391,21128705,1998
WA,hospitals,6389,17963766,2385,4781876,189899,7462,22745642,1998
WA,social insurance administration,3653,11224406,404,499534,37196,3863,11723940,1998
WA,solid waste management,0,0,0,0,0,0,0,1998
WA,sewage disposal,0,0,0,0,0,0,0,1998
WA,parks and recreation,501,1235240,52,44270,4816,528,1279510,1998
WA,housing and community development,0,0,0,0,0,0,0,1998
WA,natural resources,4402,14067548,1093,1236513,116525,5061,15304061,1998
WA,water transport and terminals,0,0,0,0,0,0,0,1998
WA,electric power,0,0,0,0,0,0,0,1998
WA,gas supply,0,0,0,0,0,0,0,1998
WA,transit,0,0,0,0,0,0,0,1998
WA,elem and sec instruction,0,0,0,0,0,0,0,1998
WA,elem and sec admin/cler,0,0,0,0,0,0,0,1998
WA,elem and sec oper/maint,0,0,0,0,0,0,0,1998
WA,elem and sec cafeteria,0,0,0,0,0,0,0,1998
WA,elem and sec bus transit,0,0,0,0,0,0,0,1998
WA,elem and sec health/rec,0,0,0,0,0,0,0,1998
WA,elem and sec student,0,0,0,0,0,0,0,1998
WA,elem and sec unalloc,0,0,0,0,0,0,0,1998
WA,higher ed - instructional,9979,41141568,11227,17049102,622661,13503,58190670,1998
WA,education - higher education other,19339,59190241,29607,15467732,2144201,31482,74657973,1998
WA,education - other,2379,8659298,2753,1902617,111157,3006,10561915,1998
WA,libraries,0,0,0,0,0,0,0,1998
WA,liquor stores,485,1375756,460,574092,46994,751,1949848,1998
WA,other and unallocable,5005,15257644,362,421408,29264,5171,15679052,1998
WV,total,28762,69878259,9056,5884822,540640,32004,75763081,1998
WV,financial administration,1175,2251382,26,18426,2527,1189,2269808,1998
WV,other government administration,267,690190,334,792255,38095,501,1482445,1998
WV,judicial and legal,1093,2810406,34,32902,2854,1112,2843308,1998
WV,police arrest,645,1944294,0,0,0,645,1944294,1998
WV,police other,299,541342,15,8520,1276,306,549862,1998
WV,corrections,959,1826072,7,6110,484,961,1832182,1998
WV,streets and highways,5562,11164414,25,27963,3084,5579,11192377,1998
WV,air transportation,0,0,0,0,0,0,0,1998
WV,water transportation,0,0,0,0,0,0,0,1998
WV,public welfare,75,98558,1,800,146,76,99358,1998
WV,health,687,1493538,27,42114,3514,707,1535652,1998
WV,hospitals,1697,2745204,62,42058,4738,1723,2787262,1998
WV,social insurance administration,766,1579252,11,5230,680,770,1584482,1998
WV,solid waste management,8,23338,0,0,0,8,23338,1998
WV,sewage disposal,0,0,0,0,0,0,0,1998
WV,parks and recreation,428,652730,298,165896,29362,594,818626,1998
WV,housing and community development,0,0,0,0,0,0,0,1998
WV,natural resources,1890,4645407,164,71255,12598,1963,4716662,1998
WV,water transport and terminals,0,0,0,0,0,0,0,1998
WV,electric power,0,0,0,0,0,0,0,1998
WV,gas supply,0,0,0,0,0,0,0,1998
WV,transit,0,0,0,0,0,0,0,1998
WV,elem and sec instruction,0,0,0,0,0,0,0,1998
WV,elem and sec admin/cler,0,0,0,0,0,0,0,1998
WV,elem and sec oper/maint,0,0,0,0,0,0,0,1998
WV,elem and sec cafeteria,0,0,0,0,0,0,0,1998
WV,elem and sec bus transit,0,0,0,0,0,0,0,1998
WV,elem and sec health/rec,0,0,0,0,0,0,0,1998
WV,elem and sec student,0,0,0,0,0,0,0,1998
WV,elem and sec unalloc,0,0,0,0,0,0,0,1998
WV,higher ed - instructional,3284,14050620,3966,2825641,208715,4542,16876261,1998
WV,education - higher education other,6152,14388904,3837,1694427,218183,7465,16083331,1998
WV,education - other,1353,3390194,150,94096,7500,1398,3484290,1998
WV,libraries,0,0,0,0,0,0,0,1998
WV,liquor stores,50,104662,2,468,70,50,105130,1998
WV,other and unallocable,2372,5477752,97,56661,6814,2415,5534413,1998
WI,total,52591,175922790,24392,32072782,2143563,64703,207995572,1998
WI,financial administration,2501,7536420,1085,1108093,112712,3137,8644513,1998
WI,other government administration,868,2773438,233,126498,9160,921,2899936,1998
WI,judicial and legal,1759,8608975,331,718523,33990,1951,9327498,1998
WI,police arrest,566,1770747,1,870,42,566,1771617,1998
WI,police other,260,774732,25,22824,1893,270,797556,1998
WI,corrections,6865,18536413,794,1233309,79261,7312,19769722,1998
WI,streets and highways,1803,6176611,249,240865,20639,1920,6417476,1998
WI,water transportation,0,0,0,0,0,0,0,1998
WI,air transportation,0,0,0,0,0,0,0,1998
WI,public welfare,883,2510137,324,427344,33799,1074,2937481,1998
WI,health,1642,5785506,538,1213104,50192,1926,6998610,1998
WI,hospitals,5580,15170542,3253,4823982,332812,7462,19994524,1998
WI,social insurance administration,778,2259702,35,62377,4785,805,2322079,1998
WI,solid waste management,0,0,0,0,0,0,0,1998
WI,sewage disposal,0,0,0,0,0,0,0,1998
WI,parks and recreation,126,340817,119,115073,8652,175,455890,1998
WI,housing and community development,0,0,0,0,0,0,0,1998
WI,natural resources,2064,6117513,1143,1322501,107361,2671,7440014,1998
WI,water transport and terminals,0,0,0,0,0,0,0,1998
WI,electric power,0,0,0,0,0,0,0,1998
WI,gas supply,0,0,0,0,0,0,0,1998
WI,transit,0,0,0,0,0,0,0,1998
WI,elem and sec instruction,0,0,0,0,0,0,0,1998
WI,elem and sec admin/cler,0,0,0,0,0,0,0,1998
WI,elem and sec oper/maint,0,0,0,0,0,0,0,1998
WI,elem and sec cafeteria,0,0,0,0,0,0,0,1998
WI,elem and sec bus transit,0,0,0,0,0,0,0,1998
WI,elem and sec health/rec,0,0,0,0,0,0,0,1998
WI,elem and sec student,0,0,0,0,0,0,0,1998
WI,elem and sec unalloc,0,0,0,0,0,0,0,1998
WI,higher ed - instructional,7390,35834091,6061,7927382,448301,9923,43761473,1998
WI,education - higher education other,13263,41531578,8697,11058096,773165,17631,52589674,1998
WI,education - other,1066,3386609,306,216535,23623,1199,3603144,1998
WI,libraries,0,0,0,0,0,0,0,1998
WI,liquor stores,0,0,0,0,0,0,0,1998
WI,other and unallocable,5177,16808959,1198,1455406,103176,5760,18264365,1998
WY,total,9704,22382418,3254,1818544,244448,11085,24200962,1998
WY,financial administration,465,1163259,3,2046,206,466,1165305,1998
WY,other government administration,109,306772,223,197320,21311,230,504092,1998
WY,judicial and legal,364,1066232,36,42645,2976,381,1108877,1998
WY,police arrest,111,323659,0,0,0,111,323659,1998
WY,police other,78,221168,0,0,0,78,221168,1998
WY,corrections,723,1555282,5,5348,563,726,1560630,1998
WY,streets and highways,1685,3819748,90,92681,11580,1750,3912429,1998
WY,water transportation,0,0,0,0,0,0,0,1998
WY,air transportation,0,0,0,0,0,0,0,1998
WY,public welfare,599,1180113,45,40735,3628,619,1220848,1998
WY,health,466,1180637,89,127377,11282,530,1308014,1998
WY,hospitals,954,1737113,9,9700,1100,960,1746813,1998
WY,social insurance administration,301,694122,31,38967,4001,324,733089,1998
WY,solid waste management,0,0,0,0,0,0,0,1998
WY,sewage disposal,0,0,0,0,0,0,0,1998
WY,parks and recreation,101,230353,4,4422,408,103,234775,1998
WY,housing and community development,0,0,0,0,0,0,0,1998
WY,natural resources,632,1656036,28,21117,2275,645,1677153,1998
WY,water transport and terminals,0,0,0,0,0,0,0,1998
WY,electric power,0,0,0,0,0,0,0,1998
WY,gas supply,0,0,0,0,0,0,0,1998
WY,transit,0,0,0,0,0,0,0,1998
WY,elem and sec instruction,0,0,0,0,0,0,0,1998
WY,elem and sec admin/cler,0,0,0,0,0,0,0,1998
WY,elem and sec oper/maint,0,0,0,0,0,0,0,1998
WY,elem and sec cafeteria,0,0,0,0,0,0,0,1998
WY,elem and sec bus transit,0,0,0,0,0,0,0,1998
WY,elem and sec health/rec,0,0,0,0,0,0,0,1998
WY,elem and sec student,0,0,0,0,0,0,0,1998
WY,elem and sec unalloc,0,0,0,0,0,0,0,1998
WY,higher ed - instructional,744,2404750,672,541899,44527,996,2946649,1998
WY,education - higher education other,1438,2733085,1915,601703,130956,2178,3334788,1998
WY,education - other,142,354843,18,13253,1390,150,368096,1998
WY,libraries,0,0,0,0,0,0,0,1998
WY,liquor stores,32,53053,0,0,0,32,53053,1998
WY,other and unallocable,760,1702193,86,79331,8245,806,1781524,1998
