state,government_function,full_time_employees,full_time_pay,part_time_employees,part_time_pay,part_time_hours,full_time_equivalent_employees,total_march_pay,year
US,total,3514236,11372804640,1303548,1191887547,90877575,4034047,12564692187,1999
US,financial administration,154564,476109860,14215,17958996,1519971,163268,494068856,1999
US,other government administration,46496,152553022,13119,20229873,1235114,53602,172782895,1999
US,judicial and legal,139095,519879171,9368,15252015,950392,144550,535131186,1999
US,police arrest,58917,235073047,486,722055,42051,59157,235795102,1999
US,police other,37935,112550112,2348,2394152,198990,39082,114944264,1999
US,corrections,442481,1303139559,14272,22788928,1620386,451694,1325928487,1999
US,streets and highways,239388,733982621,11631,16004128,1196628,246187,749986749,1999
US,air transportation,2860,10877524,183,256271,13882,2939,11133795,1999
US,water transportation,4558,15490467,110,142887,9731,4612,15633354,1999
US,public welfare,218781,595513341,10136,15600542,1149036,225352,611113883,1999
US,health,161440,486796955,13823,21234942,1367895,169213,508031897,1999
US,hospitals,383144,1078375393,52200,84371880,5561717,414850,1162747273,1999
US,social insurance administration,87318,270860449,8275,13700721,999625,93063,284561170,1999
US,solid waste management,1672,6669095,111,248175,12923,1745,6917270,1999
US,sewage disposal,1441,5713333,48,141591,5846,1474,5854924,1999
US,parks and recreation,26426,69192629,11368,10087025,993948,32085,79279654,1999
US,housing and community development,0,0,0,0,0,0,0,1999
US,natural resources,128700,399405496,35123,34524818,3203068,146892,433930314,1999
US,water transport and terminals,821,3090551,39,73075,4033,844,3163626,1999
US,electric power,5321,29084033,185,334429,25953,5468,29418462,1999
US,gas supply,0,0,0,0,0,0,0,1999
US,transit,27029,116800529,1626,1654073,140797,27826,118454602,1999
US,elem and sec instruction,30693,111332671,7939,5733920,352471,32900,117066591,1999
US,elem and sec admin/cler,3772,10276992,157,126004,8946,3827,10402996,1999
US,elem and sec oper/maint,3636,8221668,2362,1146806,113614,4326,9368474,1999
US,elem and sec cafeteria,1968,3583771,816,392505,42870,2257,3976276,1999
US,elem and sec bus transit,47,96693,70,56881,6643,92,153574,1999
US,elem and sec health/rec,262,1106715,285,510667,24093,407,1617382,1999
US,elem and sec student,0,0,632,99530,17020,105,99530,1999
US,elem and sec unalloc,488,762096,1906,688940,73141,947,1451036,1999
US,higher ed - instructional,342006,1727881576,327357,423116786,22702259,472050,2150998362,1999
US,education - higher education other,674615,1922622952,720810,438009033,44113177,926756,2360631985,1999
US,education - other,90732,283578243,18787,17688766,1212734,97693,301267009,1999
US,libraries,489,1124792,236,123472,9498,546,1248264,1999
US,liquor stores,5630,13851103,2862,2019945,224953,6918,15871048,1999
US,other and unallocable,191511,667208181,20663,24453716,1724170,201320,691661897,1999
AL,total,71626,197247349,24215,16856626,1632511,81001,214103975,1999
AL,financial administration,3426,9623327,158,109950,19750,3538,9733277,1999
AL,other government administration,434,1477947,116,188011,10972,496,1665958,1999
AL,judicial and legal,2935,9453701,158,177510,18870,3042,9631211,1999
AL,police arrest,766,2380584,0,0,0,766,2380584,1999
AL,police other,616,1458057,37,18735,2306,629,1476792,1999
AL,corrections,4431,11517642,21,18757,2143,4443,11536399,1999
AL,streets and highways,3442,8677662,56,44499,4959,3470,8722161,1999
AL,air transportation,0,0,0,0,0,0,0,1999
AL,water transportation,447,1218842,1,1500,20,447,1220342,1999
AL,public welfare,3774,9981840,36,49323,3666,3794,10031163,1999
AL,health,4965,12832776,526,481165,65715,5337,13313941,1999
AL,hospitals,10690,23330676,1233,1745985,101768,11265,25076661,1999
AL,social insurance administration,1375,3414136,40,22142,3314,1394,3436278,1999
AL,solid waste management,0,0,0,0,0,0,0,1999
AL,sewage disposal,0,0,0,0,0,0,0,1999
AL,parks and recreation,403,855571,404,339191,28715,565,1194762,1999
AL,housing and community development,0,0,0,0,0,0,0,1999
AL,natural resources,2146,6427496,440,288146,36471,2354,6715642,1999
AL,water transport and terminals,0,0,0,0,0,0,0,1999
AL,electric power,0,0,0,0,0,0,0,1999
AL,gas supply,0,0,0,0,0,0,0,1999
AL,transit,0,0,0,0,0,0,0,1999
AL,elem and sec instruction,0,0,0,0,0,0,0,1999
AL,elem and sec admin/cler,0,0,0,0,0,0,0,1999
AL,elem and sec oper/maint,0,0,0,0,0,0,0,1999
AL,elem and sec cafeteria,0,0,0,0,0,0,0,1999
AL,elem and sec bus transit,0,0,0,0,0,0,0,1999
AL,elem and sec health/rec,0,0,0,0,0,0,0,1999
AL,elem and sec student,0,0,0,0,0,0,0,1999
AL,elem and sec unalloc,0,0,0,0,0,0,0,1999
AL,higher ed - instructional,9581,40939633,6502,5870120,376539,11759,46809753,1999
AL,education - higher education other,16323,37013664,13188,6575540,868074,21325,43589204,1999
AL,education - other,3244,9689651,690,429885,29311,3411,10119536,1999
AL,libraries,0,0,0,0,0,0,0,1999
AL,liquor stores,633,1252258,7,6567,846,638,1258825,1999
AL,other and unallocable,1995,5701886,602,489600,59072,2328,6191486,1999
AK,total,20861,80029142,5150,4595354,308984,22647,84624496,1999
AK,financial administration,965,3730520,28,38959,2153,978,3769479,1999
AK,other government administration,516,1855350,60,66107,4462,543,1921457,1999
AK,judicial and legal,1170,4901340,76,113808,5437,1203,5015148,1999
AK,police arrest,248,1415977,0,0,0,248,1415977,1999
AK,police other,172,517032,80,22743,1927,184,539775,1999
AK,corrections,1279,5072600,2,3168,172,1280,5075768,1999
AK,streets and highways,2728,11108295,28,31805,2785,2745,11140100,1999
AK,air transportation,0,0,0,0,0,0,0,1999
AK,water transportation,0,0,0,0,0,0,0,1999
AK,public welfare,1878,6181611,158,181306,18796,1991,6362917,1999
AK,health,628,2376629,41,57573,3058,646,2434202,1999
AK,hospitals,226,805746,10,15852,1071,232,821598,1999
AK,social insurance administration,373,1289040,5,8295,444,376,1297335,1999
AK,solid waste management,0,0,0,0,0,0,0,1999
AK,sewage disposal,0,0,0,0,0,0,0,1999
AK,parks and recreation,77,273757,0,0,0,77,273757,1999
AK,housing and community development,0,0,0,0,0,0,0,1999
AK,natural resources,1959,7604059,94,111334,8109,2006,7715393,1999
AK,water transport and terminals,0,0,0,0,0,0,0,1999
AK,electric power,0,0,0,0,0,0,0,1999
AK,gas supply,0,0,0,0,0,0,0,1999
AK,transit,0,0,0,0,0,0,0,1999
AK,elem and sec instruction,1805,7072034,527,446895,31646,1995,7518929,1999
AK,elem and sec admin/cler,284,963777,71,73210,4579,312,1036987,1999
AK,elem and sec oper/maint,247,701853,164,174750,11485,316,876603,1999
AK,elem and sec cafeteria,85,167877,121,119580,8103,135,287457,1999
AK,elem and sec bus transit,1,2655,16,11064,1099,8,13719,1999
AK,elem and sec health/rec,22,34607,2,827,67,22,35434,1999
AK,elem and sec student,0,0,34,4683,668,3,4683,1999
AK,elem and sec unalloc,314,551010,91,48731,4035,340,599741,1999
AK,higher ed - instructional,901,4968112,1442,1446690,46441,1163,6414802,1999
AK,education - higher education other,2172,7293199,1993,1513572,145579,2994,8806771,1999
AK,education - other,472,1697735,55,41528,2982,490,1739263,1999
AK,libraries,0,0,0,0,0,0,0,1999
AK,liquor stores,0,0,0,0,0,0,0,1999
AK,other and unallocable,2339,9444327,52,62874,3886,2360,9507201,1999
AZ,total,54185,161367673,23187,18643803,1529275,62823,180011476,1999
AZ,financial administration,3453,8973916,26,37633,2026,3465,9011549,1999
AZ,other government administration,547,1499826,116,169096,7795,591,1668922,1999
AZ,judicial and legal,1253,5070322,110,195569,10344,1312,5265891,1999
AZ,police arrest,990,3922517,0,0,0,990,3922517,1999
AZ,police other,810,2540348,12,5400,299,812,2545748,1999
AZ,corrections,8799,23474299,94,170119,9883,8855,23644418,1999
AZ,streets and highways,3034,8570897,0,0,0,3034,8570897,1999
AZ,air transportation,0,0,0,0,0,0,0,1999
AZ,water transportation,0,0,0,0,0,0,0,1999
AZ,public welfare,5827,13374335,154,123348,11416,5892,13497683,1999
AZ,health,2121,5325777,37,51374,3994,2143,5377151,1999
AZ,hospitals,648,1457647,38,52594,3436,667,1510241,1999
AZ,social insurance administration,1875,4351635,186,196293,16357,1967,4547928,1999
AZ,solid waste management,0,0,0,0,0,0,0,1999
AZ,sewage disposal,0,0,0,0,0,0,0,1999
AZ,parks and recreation,311,715317,160,121396,9943,367,836713,1999
AZ,housing and community development,0,0,0,0,0,0,0,1999
AZ,natural resources,2090,6013070,732,615822,58037,2418,6628892,1999
AZ,water transport and terminals,0,0,0,0,0,0,0,1999
AZ,electric power,8,28000,5,480,75,8,28480,1999
AZ,gas supply,0,0,0,0,0,0,0,1999
AZ,transit,0,0,0,0,0,0,0,1999
AZ,elem and sec instruction,0,0,0,0,0,0,0,1999
AZ,elem and sec admin/cler,0,0,0,0,0,0,0,1999
AZ,elem and sec oper/maint,0,0,0,0,0,0,0,1999
AZ,elem and sec cafeteria,0,0,0,0,0,0,0,1999
AZ,elem and sec bus transit,0,0,0,0,0,0,0,1999
AZ,elem and sec health/rec,0,0,0,0,0,0,0,1999
AZ,elem and sec student,0,0,0,0,0,0,0,1999
AZ,elem and sec unalloc,0,0,0,0,0,0,0,1999
AZ,higher ed - instructional,4913,26397176,5928,7306190,448935,7449,33703366,1999
AZ,education - higher education other,11281,33570042,15069,8855189,898377,16356,42425231,1999
AZ,education - other,2640,6365267,403,621266,39262,2861,6986533,1999
AZ,libraries,0,0,0,0,0,0,0,1999
AZ,liquor stores,0,0,0,0,0,0,0,1999
AZ,other and unallocable,3585,9717282,117,122034,9096,3636,9839316,1999
AR,total,46229,122465367,13725,10196210,927547,51477,132661577,1999
AR,financial administration,1765,4213046,124,109735,14686,1847,4322781,1999
AR,other government administration,498,1478821,82,114133,7850,543,1592954,1999
AR,judicial and legal,382,1951888,8,10380,820,386,1962268,1999
AR,police arrest,587,1769431,0,0,0,587,1769431,1999
AR,police other,532,1226709,0,0,0,532,1226709,1999
AR,corrections,3653,7955246,9,6195,738,3658,7961441,1999
AR,streets and highways,3461,9551335,37,23800,3454,3481,9575135,1999
AR,air transportation,0,0,0,0,0,0,0,1999
AR,water transportation,0,0,0,0,0,0,0,1999
AR,public welfare,3663,7092578,0,0,0,3663,7092578,1999
AR,health,4824,11089669,96,83102,8050,4870,11172771,1999
AR,hospitals,4465,10644133,106,229990,15646,4553,10874123,1999
AR,social insurance administration,893,2621489,247,256875,30467,1066,2878364,1999
AR,solid waste management,0,0,0,0,0,0,0,1999
AR,sewage disposal,0,0,0,0,0,0,0,1999
AR,parks and recreation,546,1089168,226,125591,20931,664,1214759,1999
AR,housing and community development,0,0,0,0,0,0,0,1999
AR,natural resources,2106,5607228,318,249338,42297,2345,5856566,1999
AR,water transport and terminals,0,0,0,0,0,0,0,1999
AR,electric power,0,0,0,0,0,0,0,1999
AR,gas supply,0,0,0,0,0,0,0,1999
AR,transit,0,0,0,0,0,0,0,1999
AR,elem and sec instruction,0,0,0,0,0,0,0,1999
AR,elem and sec admin/cler,0,0,0,0,0,0,0,1999
AR,elem and sec oper/maint,0,0,0,0,0,0,0,1999
AR,elem and sec cafeteria,0,0,0,0,0,0,0,1999
AR,elem and sec bus transit,0,0,0,0,0,0,0,1999
AR,elem and sec health/rec,0,0,0,0,0,0,0,1999
AR,elem and sec student,0,0,0,0,0,0,0,1999
AR,elem and sec unalloc,0,0,0,0,0,0,0,1999
AR,higher ed - instructional,4900,21912618,3909,4689358,171494,5871,26601976,1999
AR,education - higher education other,9171,21667623,7739,3728738,552053,12292,25396361,1999
AR,education - other,2713,6826219,683,431387,47701,2984,7257606,1999
AR,libraries,0,0,0,0,0,0,0,1999
AR,liquor stores,0,0,0,0,0,0,0,1999
AR,other and unallocable,2070,5768166,141,137588,11360,2135,5905754,1999
CA,total,294094,1243154743,140762,156500639,9922801,350161,1399655382,1999
CA,financial administration,19200,63129480,4077,5277200,466353,21834,68406680,1999
CA,other government administration,3484,14080867,352,665999,33463,3682,14746866,1999
CA,judicial and legal,3162,15554971,291,644366,26035,3309,16199337,1999
CA,police arrest,7116,36533893,297,400027,22223,7242,36933920,1999
CA,police other,4933,15324144,578,585580,40810,5163,15909724,1999
CA,corrections,44589,179515775,3325,7632126,448325,47122,187147901,1999
CA,streets and highways,18756,91335115,995,2825179,133460,19510,94160294,1999
CA,air transportation,0,0,0,0,0,0,0,1999
CA,water transportation,68,239466,11,5940,463,71,245406,1999
CA,public welfare,3403,12014459,314,442916,22636,3531,12457375,1999
CA,health,9916,39736394,1369,2519037,127079,10633,42255431,1999
CA,hospitals,26368,107328944,6201,11184996,587860,29690,118513940,1999
CA,social insurance administration,15328,53155306,2744,5568676,403116,17606,58723982,1999
CA,solid waste management,347,1458166,58,144379,6572,384,1602545,1999
CA,sewage disposal,0,0,0,0,0,0,0,1999
CA,parks and recreation,1989,6645603,1560,1855316,177065,2989,8500919,1999
CA,housing and community development,0,0,0,0,0,0,0,1999
CA,natural resources,11182,43940164,3892,4697400,526556,14158,48637564,1999
CA,water transport and terminals,0,0,0,0,0,0,0,1999
CA,electric power,0,0,0,0,0,0,0,1999
CA,gas supply,0,0,0,0,0,0,0,1999
CA,transit,0,0,0,0,0,0,0,1999
CA,elem and sec instruction,0,0,0,0,0,0,0,1999
CA,elem and sec admin/cler,0,0,0,0,0,0,0,1999
CA,elem and sec oper/maint,0,0,0,0,0,0,0,1999
CA,elem and sec cafeteria,0,0,0,0,0,0,0,1999
CA,elem and sec bus transit,0,0,0,0,0,0,0,1999
CA,elem and sec health/rec,0,0,0,0,0,0,0,1999
CA,elem and sec student,0,0,0,0,0,0,0,1999
CA,elem and sec unalloc,0,0,0,0,0,0,0,1999
CA,higher ed - instructional,19521,123670270,26666,37462247,1674728,28982,161132517,1999
CA,education - higher education other,67544,265250869,81773,65020367,4654627,93841,330271236,1999
CA,education - other,4223,15231948,732,1127661,70731,4622,16359609,1999
CA,libraries,0,0,0,0,0,0,0,1999
CA,liquor stores,0,0,0,0,0,0,0,1999
CA,other and unallocable,32965,159008909,5527,8441227,500699,35792,167450136,1999
CO,total,44189,161267722,35357,60938794,3172633,62112,222206516,1999
CO,financial administration,1982,6993381,157,228388,12261,2052,7221769,1999
CO,other government administration,421,1284691,111,236312,16302,513,1521003,1999
CO,judicial and legal,2851,10300290,783,1447115,74905,3273,11747405,1999
CO,police arrest,859,3068777,0,0,0,859,3068777,1999
CO,police other,446,1535132,44,84600,4504,471,1619732,1999
CO,corrections,5400,17624157,79,171599,8479,5448,17795756,1999
CO,streets and highways,2947,9882334,193,320870,17826,3048,10203204,1999
CO,air transportation,0,0,0,0,0,0,0,1999
CO,water transportation,0,0,0,0,0,0,0,1999
CO,public welfare,1790,6099636,204,288409,15285,1877,6388045,1999
CO,health,1038,4363859,158,308410,13511,1114,4672269,1999
CO,hospitals,3205,9573764,939,1620337,96404,3750,11194101,1999
CO,social insurance administration,885,3265224,64,95352,4768,912,3360576,1999
CO,solid waste management,0,0,0,0,0,0,0,1999
CO,sewage disposal,0,0,0,0,0,0,0,1999
CO,parks and recreation,191,770321,93,71536,4769,218,841857,1999
CO,housing and community development,0,0,0,0,0,0,0,1999
CO,natural resources,1273,5089628,299,316713,15087,1358,5406341,1999
CO,water transport and terminals,0,0,0,0,0,0,0,1999
CO,electric power,0,0,0,0,0,0,0,1999
CO,gas supply,0,0,0,0,0,0,0,1999
CO,transit,0,0,0,0,0,0,0,1999
CO,elem and sec instruction,0,0,0,0,0,0,0,1999
CO,elem and sec admin/cler,0,0,0,0,0,0,0,1999
CO,elem and sec oper/maint,0,0,0,0,0,0,0,1999
CO,elem and sec cafeteria,0,0,0,0,0,0,0,1999
CO,elem and sec bus transit,0,0,0,0,0,0,0,1999
CO,elem and sec health/rec,0,0,0,0,0,0,0,1999
CO,elem and sec student,0,0,0,0,0,0,0,1999
CO,elem and sec unalloc,0,0,0,0,0,0,0,1999
CO,higher ed - instructional,8966,44945355,9615,26006591,772739,13332,70951946,1999
CO,education - higher education other,9471,27605227,21812,28711703,2057596,21096,56316930,1999
CO,education - other,989,3295248,678,848311,48274,1262,4143559,1999
CO,libraries,0,0,0,0,0,0,0,1999
CO,liquor stores,0,0,0,0,0,0,0,1999
CO,other and unallocable,1475,5570698,128,182548,9923,1529,5753246,1999
CT,total,57290,209119532,17652,17868041,1008355,63486,226987573,1999
CT,financial administration,2603,8609056,61,135735,6827,2648,8744791,1999
CT,other government administration,996,3878804,252,743892,40281,1227,4622696,1999
CT,judicial and legal,3836,14197036,103,261692,12872,3919,14458728,1999
CT,police arrest,1054,5040408,0,0,0,1054,5040408,1999
CT,police other,611,2171833,48,82910,4953,643,2254743,1999
CT,corrections,8712,28164102,64,145436,5858,8750,28309538,1999
CT,streets and highways,3613,12193607,0,0,0,3613,12193607,1999
CT,air transportation,35,179181,0,0,0,35,179181,1999
CT,water transportation,0,0,0,0,0,0,0,1999
CT,public welfare,4568,15486740,188,456476,22190,4710,15943216,1999
CT,health,1945,7038681,57,137926,6739,1985,7176607,1999
CT,hospitals,9254,34227347,1934,3758903,197715,10477,37986250,1999
CT,social insurance administration,982,3486461,16,49923,1939,995,3536384,1999
CT,solid waste management,47,237850,9,17628,859,52,255478,1999
CT,sewage disposal,0,0,0,0,0,0,0,1999
CT,parks and recreation,138,445165,14,24097,2037,150,469262,1999
CT,housing and community development,0,0,0,0,0,0,0,1999
CT,natural resources,764,2818442,10,26366,1399,773,2844808,1999
CT,water transport and terminals,0,0,0,0,0,0,0,1999
CT,electric power,0,0,0,0,0,0,0,1999
CT,gas supply,0,0,0,0,0,0,0,1999
CT,transit,0,0,0,0,0,0,0,1999
CT,elem and sec instruction,2287,11096104,650,814927,67910,2765,11911031,1999
CT,elem and sec admin/cler,290,1016512,0,0,0,290,1016512,1999
CT,elem and sec oper/maint,248,232128,0,0,0,248,232128,1999
CT,elem and sec cafeteria,101,94536,253,65357,7873,156,159893,1999
CT,elem and sec bus transit,1,1128,0,0,0,1,1128,1999
CT,elem and sec health/rec,53,189314,0,0,0,53,189314,1999
CT,elem and sec student,0,0,60,6166,1027,7,6166,1999
CT,elem and sec unalloc,114,118490,0,0,0,114,118490,1999
CT,higher ed - instructional,3698,18403196,4952,5958925,246204,5169,24362121,1999
CT,education - higher education other,6323,23722606,8517,4431500,334120,8330,28154106,1999
CT,education - other,2718,8083187,253,388364,25447,2882,8471551,1999
CT,libraries,0,0,0,0,0,0,0,1999
CT,liquor stores,0,0,0,0,0,0,0,1999
CT,other and unallocable,2299,7987618,211,361818,22105,2440,8349436,1999
DE,total,19768,59994686,7562,5932748,456787,22519,65927434,1999
DE,financial administration,739,1869810,79,81160,8280,790,1950970,1999
DE,other government administration,213,696764,117,188538,9292,266,885302,1999
DE,judicial and legal,1416,4290470,19,27803,1560,1426,4318273,1999
DE,police arrest,595,2788634,0,0,0,595,2788634,1999
DE,police other,265,718078,47,57984,5292,295,776062,1999
DE,corrections,2235,6307608,174,177080,16892,2334,6484688,1999
DE,streets and highways,1306,3030810,306,154424,17836,1411,3185234,1999
DE,air transportation,0,0,0,0,0,0,0,1999
DE,water transportation,0,0,0,0,0,0,0,1999
DE,public welfare,1467,4089656,141,200232,15232,1560,4289888,1999
DE,health,1592,5275624,293,262740,22586,1729,5538364,1999
DE,hospitals,2112,4698118,169,210562,14884,2201,4908680,1999
DE,social insurance administration,164,415388,0,0,0,164,415388,1999
DE,solid waste management,80,232364,15,10835,1229,87,243199,1999
DE,sewage disposal,0,0,0,0,0,0,0,1999
DE,parks and recreation,187,483354,124,63828,6804,228,547182,1999
DE,housing and community development,0,0,0,0,0,0,0,1999
DE,natural resources,421,1222234,82,66390,5860,457,1288624,1999
DE,water transport and terminals,0,0,0,0,0,0,0,1999
DE,electric power,0,0,0,0,0,0,0,1999
DE,gas supply,0,0,0,0,0,0,0,1999
DE,transit,477,1392300,20,25772,2657,493,1418072,1999
DE,elem and sec instruction,0,0,0,0,0,0,0,1999
DE,elem and sec admin/cler,0,0,0,0,0,0,0,1999
DE,elem and sec oper/maint,0,0,0,0,0,0,0,1999
DE,elem and sec cafeteria,0,0,0,0,0,0,0,1999
DE,elem and sec bus transit,0,0,0,0,0,0,0,1999
DE,elem and sec health/rec,0,0,0,0,0,0,0,1999
DE,elem and sec student,0,0,0,0,0,0,0,1999
DE,elem and sec unalloc,0,0,0,0,0,0,0,1999
DE,higher ed - instructional,1519,7550092,2218,2392486,150681,2427,9942578,1999
DE,education - higher education other,3453,10524030,3445,1847490,163412,4443,12371520,1999
DE,education - other,317,1092708,6,13052,708,321,1105760,1999
DE,libraries,0,0,0,0,0,0,0,1999
DE,liquor stores,0,0,0,0,0,0,0,1999
DE,other and unallocable,1210,3316644,307,152372,13582,1292,3469016,1999
FL,total,161745,488944572,41138,41580972,3169774,179654,530525544,1999
FL,financial administration,6919,20476720,308,267705,23173,7049,20744425,1999
FL,other government administration,1476,5147871,512,1168376,59495,1812,6316247,1999
FL,judicial and legal,15807,51617569,568,972726,58251,16136,52590295,1999
FL,police arrest,2208,7356366,0,0,0,2208,7356366,1999
FL,police other,1719,3737910,117,125191,11247,1783,3863101,1999
FL,corrections,30963,101305337,1208,1297809,160803,31872,102603146,1999
FL,streets and highways,10046,28909354,430,381422,46700,10310,29290776,1999
FL,air transportation,0,0,0,0,0,0,0,1999
FL,water transportation,1,3819,0,0,0,1,3819,1999
FL,public welfare,12404,28436953,100,105435,9128,12455,28542388,1999
FL,health,17254,42055893,1184,1798518,131483,17996,43854411,1999
FL,hospitals,5946,14219220,43,61791,3996,5969,14281011,1999
FL,social insurance administration,3771,12177000,20,29221,1766,3781,12206221,1999
FL,solid waste management,0,0,0,0,0,0,0,1999
FL,sewage disposal,0,0,0,0,0,0,0,1999
FL,parks and recreation,1075,2082768,11,6884,924,1080,2089652,1999
FL,housing and community development,0,0,0,0,0,0,0,1999
FL,natural resources,6448,15658423,2404,1826100,225922,7724,17484523,1999
FL,water transport and terminals,0,0,0,0,0,0,0,1999
FL,electric power,0,0,0,0,0,0,0,1999
FL,gas supply,0,0,0,0,0,0,0,1999
FL,transit,509,1413626,28,22592,2504,523,1436218,1999
FL,elem and sec instruction,0,0,0,0,0,0,0,1999
FL,elem and sec admin/cler,0,0,0,0,0,0,0,1999
FL,elem and sec oper/maint,0,0,0,0,0,0,0,1999
FL,elem and sec cafeteria,0,0,0,0,0,0,0,1999
FL,elem and sec bus transit,0,0,0,0,0,0,0,1999
FL,elem and sec health/rec,0,0,0,0,0,0,0,1999
FL,elem and sec student,0,0,0,0,0,0,0,1999
FL,elem and sec unalloc,0,0,0,0,0,0,0,1999
FL,higher ed - instructional,13185,64013095,14820,16918464,992027,18790,80931559,1999
FL,education - higher education other,20188,55006381,18064,14996866,1323700,27669,70003247,1999
FL,education - other,1940,6185960,213,173385,22470,2066,6359345,1999
FL,libraries,0,0,0,0,0,0,0,1999
FL,liquor stores,0,0,0,0,0,0,0,1999
FL,other and unallocable,9886,29140307,1108,1428487,96185,10430,30568794,1999
GA,total,101216,286137918,35692,30227249,2547402,115608,316365167,1999
GA,financial administration,2671,8160440,462,612802,62300,3023,8773242,1999
GA,other government administration,623,2238137,380,437506,23553,756,2675643,1999
GA,judicial and legal,1177,5703537,98,168818,8639,1226,5872355,1999
GA,police arrest,1074,3489308,0,0,0,1074,3489308,1999
GA,police other,1073,2896716,50,73620,6052,1107,2970336,1999
GA,corrections,18164,41893842,799,1014382,78600,18608,42908224,1999
GA,streets and highways,6093,14736319,172,190430,24863,6234,14926749,1999
GA,air transportation,0,0,0,0,0,0,0,1999
GA,water transportation,733,2184467,3,2476,337,735,2186943,1999
GA,public welfare,8974,20778685,221,288823,26820,9125,21067508,1999
GA,health,3530,11074261,231,394326,34636,3725,11468587,1999
GA,hospitals,10933,26566592,1477,2327999,176135,11928,28894591,1999
GA,social insurance administration,1951,5351680,105,144238,13980,2030,5495918,1999
GA,solid waste management,0,0,0,0,0,0,0,1999
GA,sewage disposal,0,0,0,0,0,0,0,1999
GA,parks and recreation,817,1977281,1361,1047035,136666,1589,3024316,1999
GA,housing and community development,0,0,0,0,0,0,0,1999
GA,natural resources,3919,10847151,1136,931647,105315,4514,11778798,1999
GA,water transport and terminals,0,0,0,0,0,0,0,1999
GA,electric power,0,0,0,0,0,0,0,1999
GA,gas supply,0,0,0,0,0,0,0,1999
GA,transit,0,0,0,0,0,0,0,1999
GA,elem and sec instruction,0,0,0,0,0,0,0,1999
GA,elem and sec admin/cler,0,0,0,0,0,0,0,1999
GA,elem and sec oper/maint,0,0,0,0,0,0,0,1999
GA,elem and sec cafeteria,0,0,0,0,0,0,0,1999
GA,elem and sec bus transit,0,0,0,0,0,0,0,1999
GA,elem and sec health/rec,0,0,0,0,0,0,0,1999
GA,elem and sec student,0,0,0,0,0,0,0,1999
GA,elem and sec unalloc,0,0,0,0,0,0,0,1999
GA,higher ed - instructional,9838,47527735,8971,10106334,532016,12845,57634069,1999
GA,education - higher education other,19905,49467481,17150,10545757,1136820,26330,60013238,1999
GA,education - other,6097,20029085,2628,1503206,129411,6826,21532291,1999
GA,libraries,0,0,0,0,0,0,0,1999
GA,liquor stores,0,0,0,0,0,0,0,1999
GA,other and unallocable,3644,11215201,448,437850,51259,3933,11653051,1999
HI,total,48270,135627316,18197,11468006,777042,52806,147095322,1999
HI,financial administration,656,1858064,5,2592,222,657,1860656,1999
HI,other government administration,989,2552722,65,101726,5384,1019,2654448,1999
HI,judicial and legal,2210,6675072,65,72926,3044,2227,6747998,1999
HI,police arrest,0,0,0,0,0,0,0,1999
HI,police other,0,0,0,0,0,0,0,1999
HI,corrections,2278,5538582,19,35076,1998,2289,5573658,1999
HI,streets and highways,899,2410244,14,5724,706,903,2415968,1999
HI,air transportation,1036,2316174,15,5312,748,1040,2321486,1999
HI,water transportation,214,541076,10,4804,608,217,545880,1999
HI,public welfare,787,2073046,0,0,0,787,2073046,1999
HI,health,2838,7768212,117,160140,10668,2898,7928352,1999
HI,hospitals,3061,7520656,213,359134,17510,3157,7879790,1999
HI,social insurance administration,404,1002836,31,52822,4170,428,1055658,1999
HI,solid waste management,0,0,0,0,0,0,0,1999
HI,sewage disposal,0,0,0,0,0,0,0,1999
HI,parks and recreation,153,354058,124,56530,5908,186,410588,1999
HI,housing and community development,0,0,0,0,0,0,0,1999
HI,natural resources,1068,3409650,360,426616,26586,1218,3836266,1999
HI,water transport and terminals,0,0,0,0,0,0,0,1999
HI,electric power,0,0,0,0,0,0,0,1999
HI,gas supply,0,0,0,0,0,0,0,1999
HI,transit,0,0,0,0,0,0,0,1999
HI,elem and sec instruction,17152,49626126,6204,4036952,231742,18548,53663078,1999
HI,elem and sec admin/cler,1828,4670772,57,27878,1932,1840,4698650,1999
HI,elem and sec oper/maint,1356,2047814,2083,776584,91042,1904,2824398,1999
HI,elem and sec cafeteria,1362,2269034,0,0,0,1362,2269034,1999
HI,elem and sec bus transit,0,0,0,0,0,0,0,1999
HI,elem and sec health/rec,79,296706,283,509840,24026,224,806546,1999
HI,elem and sec student,0,0,481,69484,11580,70,69484,1999
HI,elem and sec unalloc,48,69992,1413,261052,31720,239,331044,1999
HI,higher ed - instructional,2023,9848914,1315,1385492,51314,2313,11234406,1999
HI,education - higher education other,3406,10542590,4928,2874484,234996,4734,13417074,1999
HI,education - other,135,397500,2,2942,160,136,400442,1999
HI,libraries,489,1124792,236,123472,9498,546,1248264,1999
HI,liquor stores,0,0,0,0,0,0,0,1999
HI,other and unallocable,3799,10712684,157,116424,11480,3864,10829108,1999
ID,total,20109,58103191,8884,9628362,677213,23933,67731553,1999
ID,financial administration,1429,4025253,241,159303,19451,1540,4184556,1999
ID,other government administration,156,494571,133,141789,7670,199,636360,1999
ID,judicial and legal,443,1906827,18,12722,999,449,1919549,1999
ID,police arrest,250,1175337,0,0,0,250,1175337,1999
ID,police other,212,690482,36,39808,2212,224,730290,1999
ID,corrections,1579,4244136,82,77886,8408,1627,4322022,1999
ID,streets and highways,1558,4177238,139,179369,17796,1659,4356607,1999
ID,air transportation,0,0,0,0,0,0,0,1999
ID,water transportation,0,0,0,0,0,0,0,1999
ID,public welfare,1585,4205114,234,379526,24153,1721,4584640,1999
ID,health,1164,3023687,181,187665,17167,1261,3211352,1999
ID,hospitals,864,1991874,180,171368,15963,954,2163242,1999
ID,social insurance administration,489,1718706,187,134618,16828,584,1853324,1999
ID,solid waste management,0,0,0,0,0,0,0,1999
ID,sewage disposal,0,0,0,0,0,0,0,1999
ID,parks and recreation,162,427094,103,41499,5187,191,468593,1999
ID,housing and community development,0,0,0,0,0,0,0,1999
ID,natural resources,1391,4230290,947,1200316,98637,1948,5430606,1999
ID,water transport and terminals,0,0,0,0,0,0,0,1999
ID,electric power,0,0,0,0,0,0,0,1999
ID,gas supply,0,0,0,0,0,0,0,1999
ID,transit,0,0,0,0,0,0,0,1999
ID,elem and sec instruction,0,0,0,0,0,0,0,1999
ID,elem and sec admin/cler,0,0,0,0,0,0,0,1999
ID,elem and sec oper/maint,0,0,0,0,0,0,0,1999
ID,elem and sec cafeteria,0,0,0,0,0,0,0,1999
ID,elem and sec bus transit,0,0,0,0,0,0,0,1999
ID,elem and sec health/rec,0,0,0,0,0,0,0,1999
ID,elem and sec student,0,0,0,0,0,0,0,1999
ID,elem and sec unalloc,0,0,0,0,0,0,0,1999
ID,higher ed - instructional,2366,8993553,1234,2453354,106865,2970,11446907,1999
ID,education - higher education other,4982,12561447,4399,4212016,306855,6715,16773463,1999
ID,education - other,514,1606335,372,117209,14652,596,1723544,1999
ID,libraries,0,0,0,0,0,0,0,1999
ID,liquor stores,114,316133,120,29634,3704,135,345767,1999
ID,other and unallocable,851,2315114,278,90280,10666,910,2405394,1999
IL,total,120466,406600167,47295,31554151,3370931,140207,438154318,1999
IL,financial administration,5765,18551293,374,292605,26007,5921,18843898,1999
IL,other government administration,2128,7172182,23,32160,1664,2138,7204342,1999
IL,judicial and legal,2982,16118206,129,239711,8591,3036,16357917,1999
IL,police arrest,2172,9892242,0,0,0,2172,9892242,1999
IL,police other,1731,5844686,2,955,102,1732,5845641,1999
IL,corrections,15751,51501846,23,59440,1588,15761,51561286,1999
IL,streets and highways,7218,24691510,1652,2670353,198489,8339,27361863,1999
IL,air transportation,0,0,0,0,0,0,0,1999
IL,water transportation,95,355870,4,8496,454,98,364366,1999
IL,public welfare,12264,40690324,358,490266,40468,12508,41180590,1999
IL,health,3048,10511549,16,35294,2056,3061,10546843,1999
IL,hospitals,14676,41551583,778,854744,43873,14936,42406327,1999
IL,social insurance administration,2445,8693730,328,865941,38144,2675,9559671,1999
IL,solid waste management,0,0,0,0,0,0,0,1999
IL,sewage disposal,0,0,0,0,0,0,0,1999
IL,parks and recreation,662,1965906,65,115524,8922,716,2081430,1999
IL,housing and community development,0,0,0,0,0,0,0,1999
IL,natural resources,2957,9460935,1223,1050019,147614,3799,10510954,1999
IL,water transport and terminals,0,0,0,0,0,0,0,1999
IL,electric power,0,0,0,0,0,0,0,1999
IL,gas supply,0,0,0,0,0,0,0,1999
IL,transit,0,0,0,0,0,0,0,1999
IL,elem and sec instruction,0,0,0,0,0,0,0,1999
IL,elem and sec admin/cler,0,0,0,0,0,0,0,1999
IL,elem and sec oper/maint,0,0,0,0,0,0,0,1999
IL,elem and sec cafeteria,0,0,0,0,0,0,0,1999
IL,elem and sec bus transit,0,0,0,0,0,0,0,1999
IL,elem and sec health/rec,0,0,0,0,0,0,0,1999
IL,elem and sec student,0,0,0,0,0,0,0,1999
IL,elem and sec unalloc,0,0,0,0,0,0,0,1999
IL,higher ed - instructional,12592,59502258,13568,11622486,883648,17811,71124744,1999
IL,education - higher education other,23729,64691598,28427,12691546,1939392,35077,77383144,1999
IL,education - other,3000,10275259,34,67191,3607,3021,10342450,1999
IL,libraries,0,0,0,0,0,0,0,1999
IL,liquor stores,0,0,0,0,0,0,0,1999
IL,other and unallocable,7251,25129190,291,457420,26312,7406,25586610,1999
IN,total,69899,198132994,34768,29438024,2050819,81570,227571018,1999
IN,financial administration,2597,6821468,112,56303,7438,2641,6877771,1999
IN,other government administration,427,1173225,123,36516,2559,444,1209741,1999
IN,judicial and legal,1179,5686196,77,53254,2675,1195,5739450,1999
IN,police arrest,1219,4477507,0,0,0,1219,4477507,1999
IN,police other,819,1671028,5,3813,438,822,1674841,1999
IN,corrections,5978,14470296,11,23557,1115,5984,14493853,1999
IN,streets and highways,4331,9075818,0,0,0,4331,9075818,1999
IN,air transportation,0,0,0,0,0,0,0,1999
IN,water transportation,31,96971,1,673,84,32,97644,1999
IN,public welfare,4968,10974652,37,35782,3243,4988,11010434,1999
IN,health,1686,5027629,8,12653,720,1690,5040282,1999
IN,hospitals,4935,10306228,88,92354,7029,4977,10398582,1999
IN,social insurance administration,1433,3456984,170,157057,18976,1548,3614041,1999
IN,solid waste management,0,0,0,0,0,0,0,1999
IN,sewage disposal,0,0,0,0,0,0,0,1999
IN,parks and recreation,91,229200,17,8659,757,95,237859,1999
IN,housing and community development,0,0,0,0,0,0,0,1999
IN,natural resources,2373,6700628,745,547378,56529,2703,7248006,1999
IN,water transport and terminals,0,0,0,0,0,0,0,1999
IN,electric power,0,0,0,0,0,0,0,1999
IN,gas supply,0,0,0,0,0,0,0,1999
IN,transit,0,0,0,0,0,0,0,1999
IN,elem and sec instruction,0,0,0,0,0,0,0,1999
IN,elem and sec admin/cler,0,0,0,0,0,0,0,1999
IN,elem and sec oper/maint,0,0,0,0,0,0,0,1999
IN,elem and sec cafeteria,0,0,0,0,0,0,0,1999
IN,elem and sec bus transit,0,0,0,0,0,0,0,1999
IN,elem and sec health/rec,0,0,0,0,0,0,0,1999
IN,elem and sec student,0,0,0,0,0,0,0,1999
IN,elem and sec unalloc,0,0,0,0,0,0,0,1999
IN,higher ed - instructional,12332,59115078,12349,17790844,866342,17250,76905922,1999
IN,education - higher education other,22757,51349442,20967,10529362,1077583,28877,61878804,1999
IN,education - other,1168,3266667,42,62609,3826,1191,3329276,1999
IN,libraries,0,0,0,0,0,0,0,1999
IN,liquor stores,0,0,0,0,0,0,0,1999
IN,other and unallocable,1575,4233977,16,27210,1505,1583,4261187,1999
IA,total,40984,145431065,22346,29656439,2136248,53059,175087504,1999
IA,financial administration,1294,4409146,184,185482,19644,1406,4594628,1999
IA,other government administration,500,1891132,311,559598,51136,789,2450730,1999
IA,judicial and legal,2271,8090850,225,328071,24148,2408,8418921,1999
IA,police arrest,649,2339726,0,0,0,649,2339726,1999
IA,police other,310,957325,52,37968,3529,330,995293,1999
IA,corrections,3021,9038498,161,298745,17932,3123,9337243,1999
IA,streets and highways,2852,7554230,0,0,0,2852,7554230,1999
IA,air transportation,0,0,0,0,0,0,0,1999
IA,water transportation,0,0,0,0,0,0,0,1999
IA,public welfare,2709,8044786,92,197196,10567,2769,8241982,1999
IA,health,321,1189420,15,25995,1384,329,1215415,1999
IA,hospitals,5905,20046996,2072,5088276,258735,7367,25135272,1999
IA,social insurance administration,345,1239202,7,9815,1240,352,1249017,1999
IA,solid waste management,0,0,0,0,0,0,0,1999
IA,sewage disposal,0,0,0,0,0,0,0,1999
IA,parks and recreation,105,326113,7,5962,693,109,332075,1999
IA,housing and community development,0,0,0,0,0,0,0,1999
IA,natural resources,2156,6987423,1472,2107088,144382,2972,9094511,1999
IA,water transport and terminals,0,0,0,0,0,0,0,1999
IA,electric power,0,0,0,0,0,0,0,1999
IA,gas supply,0,0,0,0,0,0,0,1999
IA,transit,0,0,0,0,0,0,0,1999
IA,elem and sec instruction,0,0,0,0,0,0,0,1999
IA,elem and sec admin/cler,0,0,0,0,0,0,0,1999
IA,elem and sec oper/maint,0,0,0,0,0,0,0,1999
IA,elem and sec cafeteria,0,0,0,0,0,0,0,1999
IA,elem and sec bus transit,0,0,0,0,0,0,0,1999
IA,elem and sec health/rec,0,0,0,0,0,0,0,1999
IA,elem and sec student,0,0,0,0,0,0,0,1999
IA,elem and sec unalloc,0,0,0,0,0,0,0,1999
IA,higher ed - instructional,4327,25974016,3732,9703632,435193,6785,35677648,1999
IA,education - higher education other,10274,34136079,13709,10679759,1138541,16707,44815838,1999
IA,education - other,1132,3727095,93,106694,7388,1175,3833789,1999
IA,libraries,0,0,0,0,0,0,0,1999
IA,liquor stores,0,0,0,0,0,0,0,1999
IA,other and unallocable,2813,9479028,214,322158,21736,2937,9801186,1999
KS,total,36690,108851158,16691,11644809,1152552,43207,120495967,1999
KS,financial administration,1984,5323275,53,75435,5843,2017,5398710,1999
KS,other government administration,278,915613,280,341782,24505,418,1257395,1999
KS,judicial and legal,1994,5732201,209,136170,15124,2080,5868371,1999
KS,police arrest,610,1909689,0,0,0,610,1909689,1999
KS,police other,365,804918,23,14778,1655,374,819696,1999
KS,corrections,3519,8842838,21,27660,2293,3533,8870498,1999
KS,streets and highways,3385,9587654,108,90322,8914,3435,9677976,1999
KS,air transportation,0,0,0,0,0,0,0,1999
KS,water transportation,0,0,0,0,0,0,0,1999
KS,public welfare,2647,7160326,11,4030,483,2650,7164356,1999
KS,health,937,2922719,57,23382,1769,947,2946101,1999
KS,hospitals,2898,7321963,141,103170,7508,2941,7425133,1999
KS,social insurance administration,130,324570,0,0,0,130,324570,1999
KS,solid waste management,0,0,0,0,0,0,0,1999
KS,sewage disposal,0,0,0,0,0,0,0,1999
KS,parks and recreation,393,1201000,450,134200,23136,524,1335200,1999
KS,housing and community development,0,0,0,0,0,0,0,1999
KS,natural resources,834,2435755,90,52095,5259,865,2487850,1999
KS,water transport and terminals,0,0,0,0,0,0,0,1999
KS,electric power,0,0,0,0,0,0,0,1999
KS,gas supply,0,0,0,0,0,0,0,1999
KS,transit,0,0,0,0,0,0,0,1999
KS,elem and sec instruction,0,0,0,0,0,0,0,1999
KS,elem and sec admin/cler,0,0,0,0,0,0,0,1999
KS,elem and sec oper/maint,0,0,0,0,0,0,0,1999
KS,elem and sec cafeteria,0,0,0,0,0,0,0,1999
KS,elem and sec bus transit,0,0,0,0,0,0,0,1999
KS,elem and sec health/rec,0,0,0,0,0,0,0,1999
KS,elem and sec student,0,0,0,0,0,0,0,1999
KS,elem and sec unalloc,0,0,0,0,0,0,0,1999
KS,higher ed - instructional,3810,20158544,2215,3492648,186725,4866,23651192,1999
KS,education - higher education other,9062,23663122,12763,6927913,845313,13837,30591035,1999
KS,education - other,596,1721038,54,41945,4514,621,1762983,1999
KS,libraries,0,0,0,0,0,0,0,1999
KS,liquor stores,0,0,0,0,0,0,0,1999
KS,other and unallocable,3248,8825933,216,179279,19511,3359,9005212,1999
KY,total,62149,182428569,24607,16301671,1323984,69908,198730240,1999
KY,financial administration,2957,7677562,198,148114,19688,3076,7825676,1999
KY,other government administration,1085,3744890,328,773752,43468,1347,4518642,1999
KY,judicial and legal,3800,10814844,797,1048740,94528,4369,11863584,1999
KY,police arrest,999,3425414,10,24270,1598,1009,3449684,1999
KY,police other,1072,2870558,23,29070,2946,1089,2899628,1999
KY,corrections,3488,7940478,48,71958,5130,3519,8012436,1999
KY,streets and highways,5358,13400368,43,68580,4990,5388,13468948,1999
KY,air transportation,0,0,0,0,0,0,0,1999
KY,water transportation,0,0,0,0,0,0,0,1999
KY,public welfare,6391,15761330,45,76582,5450,6424,15837912,1999
KY,health,1683,5862084,23,31768,2324,1698,5893852,1999
KY,hospitals,4425,11578890,395,387370,25508,4570,11966260,1999
KY,social insurance administration,1242,3447230,16,19008,1644,1251,3466238,1999
KY,solid waste management,0,0,0,0,0,0,0,1999
KY,sewage disposal,0,0,0,0,0,0,0,1999
KY,parks and recreation,1565,2612516,54,45822,6634,1605,2658338,1999
KY,housing and community development,0,0,0,0,0,0,0,1999
KY,natural resources,3356,8727823,607,325043,40770,3594,9052866,1999
KY,water transport and terminals,0,0,0,0,0,0,0,1999
KY,electric power,0,0,0,0,0,0,0,1999
KY,gas supply,0,0,0,0,0,0,0,1999
KY,transit,0,0,0,0,0,0,0,1999
KY,elem and sec instruction,0,0,0,0,0,0,0,1999
KY,elem and sec admin/cler,0,0,0,0,0,0,0,1999
KY,elem and sec oper/maint,0,0,0,0,0,0,0,1999
KY,elem and sec cafeteria,0,0,0,0,0,0,0,1999
KY,elem and sec bus transit,0,0,0,0,0,0,0,1999
KY,elem and sec health/rec,0,0,0,0,0,0,0,1999
KY,elem and sec student,0,0,0,0,0,0,0,1999
KY,elem and sec unalloc,0,0,0,0,0,0,0,1999
KY,higher ed - instructional,6234,32801873,4725,5976348,361917,8334,38778221,1999
KY,education - higher education other,11280,30058391,15397,5216404,641139,15022,35274795,1999
KY,education - other,3742,11478348,1708,1924242,55542,4078,13402590,1999
KY,libraries,0,0,0,0,0,0,0,1999
KY,liquor stores,0,0,0,0,0,0,0,1999
KY,other and unallocable,3472,10225970,190,134600,10708,3535,10360570,1999
LA,total,86362,223662887,27094,16873615,1633146,95588,240536502,1999
LA,financial administration,2415,5757851,264,356668,25889,2562,6114519,1999
LA,other government administration,1231,4270523,555,647088,43152,1477,4917611,1999
LA,judicial and legal,1642,5687964,80,41021,4524,1668,5728985,1999
LA,police arrest,678,1746521,0,0,0,678,1746521,1999
LA,police other,424,815355,9,4603,496,427,819958,1999
LA,corrections,6751,13001164,92,34408,6801,6789,13035572,1999
LA,streets and highways,5658,13170479,28,26612,4325,5682,13197091,1999
LA,air transportation,0,0,0,0,0,0,0,1999
LA,water transportation,396,1185985,3,1968,145,396,1187953,1999
LA,public welfare,5952,14685181,14,18794,1415,5959,14703975,1999
LA,health,5854,16261543,421,507818,34224,6048,16769361,1999
LA,hospitals,20505,45375527,2722,3582902,299416,22196,48958429,1999
LA,social insurance administration,947,2514043,110,79425,7273,988,2593468,1999
LA,solid waste management,0,0,0,0,0,0,0,1999
LA,sewage disposal,0,0,0,0,0,0,0,1999
LA,parks and recreation,1013,2028733,305,216975,28883,1177,2245708,1999
LA,housing and community development,0,0,0,0,0,0,0,1999
LA,natural resources,4531,11511079,984,591911,69898,4924,12102990,1999
LA,water transport and terminals,0,0,0,0,0,0,0,1999
LA,electric power,0,0,0,0,0,0,0,1999
LA,gas supply,0,0,0,0,0,0,0,1999
LA,transit,0,0,0,0,0,0,0,1999
LA,elem and sec instruction,0,0,0,0,0,0,0,1999
LA,elem and sec admin/cler,0,0,0,0,0,0,0,1999
LA,elem and sec oper/maint,0,0,0,0,0,0,0,1999
LA,elem and sec cafeteria,0,0,0,0,0,0,0,1999
LA,elem and sec bus transit,0,0,0,0,0,0,0,1999
LA,elem and sec health/rec,0,0,0,0,0,0,0,1999
LA,elem and sec student,0,0,0,0,0,0,0,1999
LA,elem and sec unalloc,0,0,0,0,0,0,0,1999
LA,higher ed - instructional,7794,37302216,4808,4758806,332193,9671,42061022,1999
LA,education - higher education other,14623,32543686,15645,5337124,710302,18635,37880810,1999
LA,education - other,3351,9401382,711,438544,37330,3563,9839926,1999
LA,libraries,0,0,0,0,0,0,0,1999
LA,liquor stores,0,0,0,0,0,0,0,1999
LA,other and unallocable,2597,6403655,343,228948,26880,2748,6632603,1999
ME,total,17688,50519644,7004,4781459,421071,20093,55301103,1999
ME,financial administration,1076,2949763,28,38891,3252,1094,2988654,1999
ME,other government administration,319,997912,211,222779,14136,399,1220691,1999
ME,judicial and legal,585,1938435,45,47103,4010,609,1985538,1999
ME,police arrest,308,1123510,0,0,0,308,1123510,1999
ME,police other,54,115199,0,0,0,54,115199,1999
ME,corrections,1175,2916345,13,11832,784,1199,2928177,1999
ME,streets and highways,2478,6604004,164,323065,27974,2636,6927069,1999
ME,air transportation,0,0,0,0,0,0,0,1999
ME,water transportation,63,140837,18,23902,1957,74,164739,1999
ME,public welfare,1961,5042013,61,88504,6031,1995,5130517,1999
ME,health,1149,3320403,62,119995,6201,1184,3440398,1999
ME,hospitals,391,1063169,28,37202,1751,401,1100371,1999
ME,social insurance administration,524,1428665,2,1709,186,525,1430374,1999
ME,solid waste management,0,0,0,0,0,0,0,1999
ME,sewage disposal,0,0,0,0,0,0,0,1999
ME,parks and recreation,92,270567,16,21960,1872,103,292527,1999
ME,housing and community development,0,0,0,0,0,0,0,1999
ME,natural resources,1189,3332000,240,236764,17673,1289,3568764,1999
ME,water transport and terminals,0,0,0,0,0,0,0,1999
ME,electric power,0,0,0,0,0,0,0,1999
ME,gas supply,0,0,0,0,0,0,0,1999
ME,transit,0,0,0,0,0,0,0,1999
ME,elem and sec instruction,27,78090,9,12660,1395,36,90750,1999
ME,elem and sec admin/cler,1,1731,2,1946,177,2,3677,1999
ME,elem and sec oper/maint,0,0,2,1455,142,1,1455,1999
ME,elem and sec cafeteria,0,0,6,8759,875,6,8759,1999
ME,elem and sec bus transit,5,9268,16,19984,2480,21,29252,1999
ME,elem and sec health/rec,0,0,0,0,0,0,0,1999
ME,elem and sec student,0,0,0,0,0,0,0,1999
ME,elem and sec unalloc,0,0,0,0,0,0,0,1999
ME,higher ed - instructional,1075,4717755,227,271578,15903,1165,4989333,1999
ME,education - higher education other,3051,8407069,5438,3018265,290966,4696,11425334,1999
ME,education - other,1080,2938209,379,228574,19803,1191,3166783,1999
ME,libraries,0,0,0,0,0,0,0,1999
ME,liquor stores,119,278807,13,11488,1198,126,290295,1999
ME,other and unallocable,966,2845893,24,33044,2305,979,2878937,1999
MD,total,78211,250761683,17312,27315966,1888334,88903,278077649,1999
MD,financial administration,3381,10310402,107,207406,14441,3463,10517808,1999
MD,other government administration,1311,4480868,373,575503,21291,1431,5056371,1999
MD,judicial and legal,3467,11241091,558,1005045,80510,3922,12246136,1999
MD,police arrest,1605,7175273,0,0,0,1605,7175273,1999
MD,police other,800,2073030,31,57369,3826,822,2130399,1999
MD,corrections,10693,32466305,835,1522854,132437,11442,33989159,1999
MD,streets and highways,4748,16674916,0,0,0,4748,16674916,1999
MD,air transportation,462,1796783,0,0,0,462,1796783,1999
MD,water transportation,295,1124936,0,0,0,295,1124936,1999
MD,public welfare,6301,16601525,1144,2004062,176636,7299,18605587,1999
MD,health,5248,15517789,916,1351875,109228,5865,16869664,1999
MD,hospitals,5529,14919329,609,661100,56127,5846,15580429,1999
MD,social insurance administration,1006,2958597,266,500619,39564,1230,3459216,1999
MD,solid waste management,0,0,0,0,0,0,0,1999
MD,sewage disposal,0,0,0,0,0,0,0,1999
MD,parks and recreation,446,1563188,184,292128,28317,606,1855316,1999
MD,housing and community development,0,0,0,0,0,0,0,1999
MD,natural resources,1967,6674315,229,423421,31843,2147,7097736,1999
MD,water transport and terminals,0,0,0,0,0,0,0,1999
MD,electric power,0,0,0,0,0,0,0,1999
MD,gas supply,0,0,0,0,0,0,0,1999
MD,transit,2021,7689019,237,301132,23022,2151,7990151,1999
MD,elem and sec instruction,0,0,0,0,0,0,0,1999
MD,elem and sec admin/cler,0,0,0,0,0,0,0,1999
MD,elem and sec oper/maint,0,0,0,0,0,0,0,1999
MD,elem and sec cafeteria,0,0,0,0,0,0,0,1999
MD,elem and sec bus transit,0,0,0,0,0,0,0,1999
MD,elem and sec health/rec,0,0,0,0,0,0,0,1999
MD,elem and sec student,0,0,0,0,0,0,0,1999
MD,elem and sec unalloc,0,0,0,0,0,0,0,1999
MD,higher ed - instructional,11029,40583593,3220,7893139,289413,12674,48476732,1999
MD,education - higher education other,9159,29664399,7106,8170104,702738,13140,37834503,1999
MD,education - other,1828,6053401,276,392069,24762,1968,6445470,1999
MD,libraries,0,0,0,0,0,0,0,1999
MD,liquor stores,0,0,0,0,0,0,0,1999
MD,other and unallocable,6915,21192924,1221,1958140,154179,7787,23151064,1999
MA,total,78383,278204406,27240,26198747,1531007,87393,304403153,1999
MA,financial administration,4367,15384853,335,642732,37132,4577,16027585,1999
MA,other government administration,1862,5881686,249,974678,31662,2052,6856364,1999
MA,judicial and legal,6492,21413523,229,411767,23888,6630,21825290,1999
MA,police arrest,4008,15960954,14,21951,1220,4013,15982905,1999
MA,police other,673,1962876,12,18704,1454,682,1981580,1999
MA,corrections,6866,23369311,75,126652,7529,6909,23495963,1999
MA,streets and highways,4218,15796048,219,477467,27309,4372,16273515,1999
MA,air transportation,1114,5859175,158,226472,11954,1182,6085647,1999
MA,water transportation,159,739510,7,9549,735,163,749059,1999
MA,public welfare,6993,22642615,608,1204141,67999,7378,23846756,1999
MA,health,6957,20350966,1180,2152695,131210,7699,22503661,1999
MA,hospitals,8077,31999298,1087,1861015,120803,8759,33860313,1999
MA,social insurance administration,1434,4852524,108,215876,11790,1501,5068400,1999
MA,solid waste management,2,10246,0,0,0,2,10246,1999
MA,sewage disposal,1200,4852271,48,141591,5846,1233,4993862,1999
MA,parks and recreation,920,2607705,106,80348,8460,968,2688053,1999
MA,housing and community development,0,0,0,0,0,0,0,1999
MA,natural resources,1152,4616275,103,243253,11095,1218,4859528,1999
MA,water transport and terminals,700,2677020,38,70350,3940,722,2747370,1999
MA,electric power,0,0,0,0,0,0,0,1999
MA,gas supply,0,0,0,0,0,0,0,1999
MA,transit,0,0,0,0,0,0,0,1999
MA,elem and sec instruction,0,0,0,0,0,0,0,1999
MA,elem and sec admin/cler,0,0,0,0,0,0,0,1999
MA,elem and sec oper/maint,0,0,0,0,0,0,0,1999
MA,elem and sec cafeteria,0,0,0,0,0,0,0,1999
MA,elem and sec bus transit,0,0,0,0,0,0,0,1999
MA,elem and sec health/rec,0,0,0,0,0,0,0,1999
MA,elem and sec student,0,0,0,0,0,0,0,1999
MA,elem and sec unalloc,0,0,0,0,0,0,0,1999
MA,higher ed - instructional,5589,25894366,9009,10534454,578781,9053,36428820,1999
MA,education - higher education other,10758,33165352,13430,6305698,425362,13302,39471050,1999
MA,education - other,1022,3879645,100,200033,10198,1083,4079678,1999
MA,libraries,0,0,0,0,0,0,0,1999
MA,liquor stores,0,0,0,0,0,0,0,1999
MA,other and unallocable,3820,14288187,125,279321,12640,3895,14567508,1999
MI,total,108510,410819949,64005,56773949,5069809,137275,467593898,1999
MI,financial administration,2429,8767693,924,1533754,86670,2917,10301447,1999
MI,other government administration,1477,4878274,18,22902,1366,1485,4901176,1999
MI,judicial and legal,1991,8104291,36,35362,1718,2001,8139653,1999
MI,police arrest,2122,9384174,0,0,0,2122,9384174,1999
MI,police other,956,3311418,165,153796,13658,1033,3465214,1999
MI,corrections,17666,62545900,227,445637,20883,17784,62991537,1999
MI,streets and highways,2986,11049804,137,188132,10060,3043,11237936,1999
MI,air transportation,0,0,0,0,0,0,0,1999
MI,water transportation,0,0,0,0,0,0,0,1999
MI,public welfare,12834,42790035,236,392106,20362,12949,43182141,1999
MI,health,1661,6470212,222,286920,14865,1745,6757132,1999
MI,hospitals,9921,32935059,3992,7069315,505704,12778,40004374,1999
MI,social insurance administration,1255,4303635,76,62109,3148,1273,4365744,1999
MI,solid waste management,0,0,0,0,0,0,0,1999
MI,sewage disposal,0,0,0,0,0,0,0,1999
MI,parks and recreation,414,1167890,61,106841,6739,452,1274731,1999
MI,housing and community development,0,0,0,0,0,0,0,1999
MI,natural resources,4167,15444274,1170,996054,91545,4685,16440328,1999
MI,water transport and terminals,0,0,0,0,0,0,0,1999
MI,electric power,0,0,0,0,0,0,0,1999
MI,gas supply,0,0,0,0,0,0,0,1999
MI,transit,0,0,0,0,0,0,0,1999
MI,elem and sec instruction,432,1100283,97,58725,5195,462,1159008,1999
MI,elem and sec admin/cler,53,132903,20,15123,1523,62,148026,1999
MI,elem and sec oper/maint,13,27781,5,3552,447,16,31333,1999
MI,elem and sec cafeteria,13,24659,16,11254,1518,21,35913,1999
MI,elem and sec bus transit,16,17442,2,1506,177,17,18948,1999
MI,elem and sec health/rec,1,1196,0,0,0,1,1196,1999
MI,elem and sec student,0,0,8,2199,477,2,2199,1999
MI,elem and sec unalloc,6,10956,8,5407,593,9,16363,1999
MI,higher ed - instructional,13256,83981308,14709,20940447,1374355,21077,104921755,1999
MI,education - higher education other,27704,87199275,40472,23610156,2853686,43892,110809431,1999
MI,education - other,425,1710532,68,93189,4893,453,1803721,1999
MI,libraries,0,0,0,0,0,0,0,1999
MI,liquor stores,0,0,0,0,0,0,0,1999
MI,other and unallocable,6712,25460955,1336,739463,50227,6996,26200418,1999
MN,total,57297,216436828,22685,26154367,2373397,70710,242591195,1999
MN,financial administration,2455,8709501,148,254247,22326,2582,8963748,1999
MN,other government administration,1221,4243296,220,377093,27094,1376,4620389,1999
MN,judicial and legal,1770,7558082,381,1131729,56812,2091,8689811,1999
MN,police arrest,491,2435533,0,0,0,491,2435533,1999
MN,police other,385,1239249,27,35663,2754,401,1274912,1999
MN,corrections,3536,11986027,132,250122,17001,3632,12236149,1999
MN,streets and highways,4957,18188526,213,324650,25206,5099,18513176,1999
MN,air transportation,0,0,0,0,0,0,0,1999
MN,water transportation,0,0,0,0,0,0,0,1999
MN,public welfare,1697,5865442,921,1603173,151139,2551,7468615,1999
MN,health,2080,7845540,166,337650,20322,2195,8183190,1999
MN,hospitals,3637,13079026,1246,2305565,205253,4797,15384591,1999
MN,social insurance administration,1207,4361376,104,194272,12389,1277,4555648,1999
MN,solid waste management,0,0,0,0,0,0,0,1999
MN,sewage disposal,0,0,0,0,0,0,0,1999
MN,parks and recreation,490,1743000,141,180658,14382,571,1923658,1999
MN,housing and community development,0,0,0,0,0,0,0,1999
MN,natural resources,2739,9836554,578,700082,53250,3040,10536636,1999
MN,water transport and terminals,0,0,0,0,0,0,0,1999
MN,electric power,0,0,0,0,0,0,0,1999
MN,gas supply,0,0,0,0,0,0,0,1999
MN,transit,0,0,0,0,0,0,0,1999
MN,elem and sec instruction,0,0,0,0,0,0,0,1999
MN,elem and sec admin/cler,0,0,0,0,0,0,0,1999
MN,elem and sec oper/maint,0,0,0,0,0,0,0,1999
MN,elem and sec cafeteria,0,0,0,0,0,0,0,1999
MN,elem and sec bus transit,0,0,0,0,0,0,0,1999
MN,elem and sec health/rec,0,0,0,0,0,0,0,1999
MN,elem and sec student,0,0,0,0,0,0,0,1999
MN,elem and sec unalloc,0,0,0,0,0,0,0,1999
MN,higher ed - instructional,8821,49602164,7033,9314633,617128,12307,58916797,1999
MN,education - higher education other,15219,45543030,10238,7806456,1022348,20995,53349486,1999
MN,education - other,3307,12252676,933,1027879,103420,3892,13280555,1999
MN,libraries,0,0,0,0,0,0,0,1999
MN,liquor stores,0,0,0,0,0,0,0,1999
MN,other and unallocable,3285,11947806,204,310495,22573,3413,12258301,1999
MS,total,48777,128796321,11625,9272764,953494,54222,138069085,1999
MS,financial administration,1172,3313445,1,1744,112,1173,3315189,1999
MS,other government administration,436,1305408,100,103685,8285,482,1409093,1999
MS,judicial and legal,476,2254156,0,0,0,476,2254156,1999
MS,police arrest,647,1810581,0,0,0,647,1810581,1999
MS,police other,520,1255028,0,0,0,520,1255028,1999
MS,corrections,4051,7585192,27,28498,3078,4068,7613690,1999
MS,streets and highways,3288,7251212,9,10429,1426,3296,7261641,1999
MS,air transportation,0,0,0,0,0,0,0,1999
MS,water transportation,56,154461,3,2525,346,58,156986,1999
MS,public welfare,3082,6294730,0,0,0,3082,6294730,1999
MS,health,3055,7564186,90,189208,10562,3114,7753394,1999
MS,hospitals,10320,23808080,365,784170,45904,10580,24592250,1999
MS,social insurance administration,786,2044675,231,425700,37754,999,2470375,1999
MS,solid waste management,0,0,0,0,0,0,0,1999
MS,sewage disposal,0,0,0,0,0,0,0,1999
MS,parks and recreation,301,551933,234,99146,12876,374,651079,1999
MS,housing and community development,0,0,0,0,0,0,0,1999
MS,natural resources,3115,7422132,853,465562,57144,3437,7887694,1999
MS,water transport and terminals,0,0,0,0,0,0,0,1999
MS,electric power,0,0,0,0,0,0,0,1999
MS,gas supply,0,0,0,0,0,0,0,1999
MS,transit,0,0,0,0,0,0,0,1999
MS,elem and sec instruction,0,0,0,0,0,0,0,1999
MS,elem and sec admin/cler,0,0,0,0,0,0,0,1999
MS,elem and sec oper/maint,0,0,0,0,0,0,0,1999
MS,elem and sec cafeteria,0,0,0,0,0,0,0,1999
MS,elem and sec bus transit,0,0,0,0,0,0,0,1999
MS,elem and sec health/rec,0,0,0,0,0,0,0,1999
MS,elem and sec student,0,0,0,0,0,0,0,1999
MS,elem and sec unalloc,0,0,0,0,0,0,0,1999
MS,higher ed - instructional,4849,24197957,2362,2574869,198045,5973,26772826,1999
MS,education - higher education other,8340,21941105,7230,4478457,567215,11601,26419562,1999
MS,education - other,1595,4095894,31,22647,2912,1612,4118541,1999
MS,libraries,0,0,0,0,0,0,0,1999
MS,liquor stores,119,246486,0,0,0,119,246486,1999
MS,other and unallocable,2569,5699660,89,86124,7835,2611,5785784,1999
MO,total,82496,212432729,27747,15366793,1775711,92543,227799522,1999
MO,financial administration,2547,5929820,85,78152,6844,2586,6007972,1999
MO,other government administration,1017,2483248,124,133431,10318,1078,2616679,1999
MO,judicial and legal,3210,9807116,383,465336,45338,3465,10272452,1999
MO,police arrest,1210,3978364,0,0,0,1210,3978364,1999
MO,police other,1134,2674471,15,11529,1548,1143,2686000,1999
MO,corrections,11255,22859488,550,447817,36426,11461,23307305,1999
MO,streets and highways,6405,17590496,493,330586,38892,6625,17921082,1999
MO,air transportation,0,0,0,0,0,0,0,1999
MO,water transportation,0,0,0,0,0,0,0,1999
MO,public welfare,7742,15784864,508,436271,46913,8007,16221135,1999
MO,health,3257,7821895,198,195946,12797,3329,8017841,1999
MO,hospitals,11964,26549635,1797,1568465,179108,12976,28118100,1999
MO,social insurance administration,1135,2754791,26,37500,3640,1156,2792291,1999
MO,solid waste management,0,0,0,0,0,0,0,1999
MO,sewage disposal,0,0,0,0,0,0,0,1999
MO,parks and recreation,562,1339294,221,60128,8371,609,1399422,1999
MO,housing and community development,0,0,0,0,0,0,0,1999
MO,natural resources,2535,6668478,384,339600,33380,2725,7008078,1999
MO,water transport and terminals,0,0,0,0,0,0,0,1999
MO,electric power,0,0,0,0,0,0,0,1999
MO,gas supply,0,0,0,0,0,0,0,1999
MO,transit,0,0,0,0,0,0,0,1999
MO,elem and sec instruction,0,0,0,0,0,0,0,1999
MO,elem and sec admin/cler,0,0,0,0,0,0,0,1999
MO,elem and sec oper/maint,0,0,0,0,0,0,0,1999
MO,elem and sec cafeteria,0,0,0,0,0,0,0,1999
MO,elem and sec bus transit,0,0,0,0,0,0,0,1999
MO,elem and sec health/rec,0,0,0,0,0,0,0,1999
MO,elem and sec student,0,0,0,0,0,0,0,1999
MO,elem and sec unalloc,0,0,0,0,0,0,0,1999
MO,higher ed - instructional,8006,34479648,7011,5613706,465339,10637,40093354,1999
MO,education - higher education other,13929,34348284,15495,5274155,859467,18796,39622439,1999
MO,education - other,2063,5099705,266,153109,6425,2099,5252814,1999
MO,libraries,0,0,0,0,0,0,0,1999
MO,liquor stores,0,0,0,0,0,0,0,1999
MO,other and unallocable,4525,12263132,191,221062,20905,4641,12484194,1999
MT,total,15910,42493929,8136,5200489,496181,18715,47694418,1999
MT,financial administration,849,2061678,120,107499,12140,918,2169177,1999
MT,other government administration,305,861870,297,383640,27774,462,1245510,1999
MT,judicial and legal,159,661184,70,136513,5469,190,797697,1999
MT,police arrest,188,525258,2,4339,283,190,529597,1999
MT,police other,204,532494,21,23063,1862,215,555557,1999
MT,corrections,936,2267415,95,117741,10853,997,2385156,1999
MT,streets and highways,1847,5086891,150,145365,13860,1925,5232256,1999
MT,air transportation,0,0,0,0,0,0,0,1999
MT,water transportation,0,0,0,0,0,0,0,1999
MT,public welfare,1355,3372366,190,238399,21736,1477,3610765,1999
MT,health,845,2042751,116,136383,9855,901,2179134,1999
MT,hospitals,518,1287541,86,81449,8637,567,1368990,1999
MT,social insurance administration,629,1588875,39,49133,4438,654,1638008,1999
MT,solid waste management,0,0,0,0,0,0,0,1999
MT,sewage disposal,0,0,0,0,0,0,0,1999
MT,parks and recreation,56,139387,21,13430,1379,64,152817,1999
MT,housing and community development,0,0,0,0,0,0,0,1999
MT,natural resources,1212,3337140,258,249578,23692,1346,3586718,1999
MT,water transport and terminals,0,0,0,0,0,0,0,1999
MT,electric power,0,0,0,0,0,0,0,1999
MT,gas supply,0,0,0,0,0,0,0,1999
MT,transit,0,0,0,0,0,0,0,1999
MT,elem and sec instruction,0,0,0,0,0,0,0,1999
MT,elem and sec admin/cler,0,0,0,0,0,0,0,1999
MT,elem and sec oper/maint,0,0,0,0,0,0,0,1999
MT,elem and sec cafeteria,0,0,0,0,0,0,0,1999
MT,elem and sec bus transit,0,0,0,0,0,0,0,1999
MT,elem and sec health/rec,0,0,0,0,0,0,0,1999
MT,elem and sec student,0,0,0,0,0,0,0,1999
MT,elem and sec unalloc,0,0,0,0,0,0,0,1999
MT,higher ed - instructional,1940,7917758,1069,1450759,80055,2392,9368517,1999
MT,education - higher education other,3501,7148678,5380,1816284,252019,4925,8964962,1999
MT,education - other,356,915159,124,120207,11832,423,1035366,1999
MT,libraries,0,0,0,0,0,0,0,1999
MT,liquor stores,76,200398,4,6372,589,79,206770,1999
MT,other and unallocable,934,2547086,94,120335,9708,990,2667421,1999
NE,total,25932,62233706,10070,5546395,645395,29575,67780101,1999
NE,financial administration,562,1538940,19,13609,1604,571,1552549,1999
NE,other government administration,336,959119,108,95445,7739,379,1054564,1999
NE,judicial and legal,663,2164516,65,41732,5000,691,2206248,1999
NE,police arrest,434,1183269,18,22485,1441,442,1205754,1999
NE,police other,222,518691,8,9784,948,228,528475,1999
NE,corrections,1906,4437889,58,59750,5571,1937,4497639,1999
NE,streets and highways,2333,5955715,12,16313,1342,2341,5972028,1999
NE,air transportation,31,88739,0,0,0,31,88739,1999
NE,water transportation,0,0,0,0,0,0,0,1999
NE,public welfare,2730,5853969,127,39513,9296,2783,5893482,1999
NE,health,734,1907547,80,93052,8210,781,2000599,1999
NE,hospitals,3962,8285366,944,1222550,117592,4626,9507916,1999
NE,social insurance administration,254,705382,14,16352,1434,262,721734,1999
NE,solid waste management,0,0,0,0,0,0,0,1999
NE,sewage disposal,0,0,0,0,0,0,0,1999
NE,parks and recreation,222,527452,165,54074,7783,266,581526,1999
NE,housing and community development,0,0,0,0,0,0,0,1999
NE,natural resources,1404,2980432,657,352011,47958,1675,3332443,1999
NE,water transport and terminals,0,0,0,0,0,0,0,1999
NE,electric power,0,0,0,0,0,0,0,1999
NE,gas supply,0,0,0,0,0,0,0,1999
NE,transit,0,0,0,0,0,0,0,1999
NE,elem and sec instruction,0,0,0,0,0,0,0,1999
NE,elem and sec admin/cler,0,0,0,0,0,0,0,1999
NE,elem and sec oper/maint,0,0,0,0,0,0,0,1999
NE,elem and sec cafeteria,0,0,0,0,0,0,0,1999
NE,elem and sec bus transit,0,0,0,0,0,0,0,1999
NE,elem and sec health/rec,0,0,0,0,0,0,0,1999
NE,elem and sec student,0,0,0,0,0,0,0,1999
NE,elem and sec unalloc,0,0,0,0,0,0,0,1999
NE,higher ed - instructional,2505,8317298,1014,898960,54518,2813,9216258,1999
NE,education - higher education other,5281,9944042,5918,2150889,329562,7142,12094931,1999
NE,education - other,538,1645573,58,39948,3533,557,1685521,1999
NE,libraries,0,0,0,0,0,0,0,1999
NE,liquor stores,0,0,0,0,0,0,0,1999
NE,other and unallocable,1815,5219767,805,419928,41864,2050,5639695,1999
NV,total,20201,66578760,5551,6258075,550919,23315,72836835,1999
NV,financial administration,1187,3223044,22,24918,2118,1201,3247962,1999
NV,other government administration,902,3296353,39,42120,3207,920,3338473,1999
NV,judicial and legal,522,2386322,19,28423,1395,530,2414745,1999
NV,police arrest,411,1473572,0,0,0,411,1473572,1999
NV,police other,301,946946,1,956,91,302,947902,1999
NV,corrections,3086,10094704,90,168123,8506,3134,10262827,1999
NV,streets and highways,1559,5163632,8,3525,503,1562,5167157,1999
NV,air transportation,0,0,0,0,0,0,0,1999
NV,water transportation,0,0,0,0,0,0,0,1999
NV,public welfare,950,2698534,12,13683,1258,957,2712217,1999
NV,health,1113,3751402,68,110902,8046,1159,3862304,1999
NV,hospitals,939,3137291,119,209185,13530,1015,3346476,1999
NV,social insurance administration,1462,4771660,23,49268,2154,1474,4820928,1999
NV,solid waste management,0,0,0,0,0,0,0,1999
NV,sewage disposal,0,0,0,0,0,0,0,1999
NV,parks and recreation,195,532589,11,14227,999,201,546816,1999
NV,housing and community development,0,0,0,0,0,0,0,1999
NV,natural resources,867,2652523,391,332009,35722,1068,2984532,1999
NV,water transport and terminals,11,45232,1,2725,93,12,47957,1999
NV,electric power,10,44346,0,0,0,10,44346,1999
NV,gas supply,0,0,0,0,0,0,0,1999
NV,transit,0,0,0,0,0,0,0,1999
NV,elem and sec instruction,0,0,0,0,0,0,0,1999
NV,elem and sec admin/cler,0,0,0,0,0,0,0,1999
NV,elem and sec oper/maint,0,0,0,0,0,0,0,1999
NV,elem and sec cafeteria,0,0,0,0,0,0,0,1999
NV,elem and sec bus transit,0,0,0,0,0,0,0,1999
NV,elem and sec health/rec,0,0,0,0,0,0,0,1999
NV,elem and sec student,0,0,0,0,0,0,0,1999
NV,elem and sec unalloc,0,0,0,0,0,0,0,1999
NV,higher ed - instructional,1606,8234090,1447,2602344,139900,2396,10836434,1999
NV,education - higher education other,2980,7037233,3234,2612444,329580,4842,9649677,1999
NV,education - other,112,403555,0,0,0,112,403555,1999
NV,libraries,0,0,0,0,0,0,0,1999
NV,liquor stores,0,0,0,0,0,0,0,1999
NV,other and unallocable,1988,6685732,66,43223,3817,2009,6728955,1999
NH,total,15545,46675207,8850,6624468,508388,18580,53299675,1999
NH,financial administration,440,1155709,40,33400,4906,468,1189109,1999
NH,other government administration,285,814296,64,66243,5740,318,880539,1999
NH,judicial and legal,899,2822700,5,2732,414,902,2825432,1999
NH,police arrest,309,1202412,0,0,0,309,1202412,1999
NH,police other,113,303284,18,15168,1554,122,318452,1999
NH,corrections,1147,3165575,54,57569,4822,1175,3223144,1999
NH,streets and highways,1810,4911918,225,183151,18432,1914,5095069,1999
NH,air transportation,0,0,0,0,0,0,0,1999
NH,water transportation,5,15259,6,4419,492,8,19678,1999
NH,public welfare,1331,3416105,77,75489,6582,1369,3491594,1999
NH,health,851,2505344,74,68685,6091,888,2574029,1999
NH,hospitals,753,1804844,85,118721,3806,776,1923565,1999
NH,social insurance administration,414,1033028,49,53265,4231,439,1086293,1999
NH,solid waste management,0,0,0,0,0,0,0,1999
NH,sewage disposal,0,0,0,0,0,0,0,1999
NH,parks and recreation,75,190532,186,107780,15246,166,298312,1999
NH,housing and community development,0,0,0,0,0,0,0,1999
NH,natural resources,487,1324497,201,133165,12461,561,1457662,1999
NH,water transport and terminals,0,0,0,0,0,0,0,1999
NH,electric power,0,0,0,0,0,0,0,1999
NH,gas supply,0,0,0,0,0,0,0,1999
NH,transit,0,0,0,0,0,0,0,1999
NH,elem and sec instruction,0,0,0,0,0,0,0,1999
NH,elem and sec admin/cler,0,0,0,0,0,0,0,1999
NH,elem and sec oper/maint,0,0,0,0,0,0,0,1999
NH,elem and sec cafeteria,0,0,0,0,0,0,0,1999
NH,elem and sec bus transit,0,0,0,0,0,0,0,1999
NH,elem and sec health/rec,0,0,0,0,0,0,0,1999
NH,elem and sec student,0,0,0,0,0,0,0,1999
NH,elem and sec unalloc,0,0,0,0,0,0,0,1999
NH,higher ed - instructional,1431,5982985,1676,2065647,85469,1946,8048632,1999
NH,education - higher education other,3003,10057880,5426,3213848,284078,4714,13271728,1999
NH,education - other,293,779582,18,21214,1649,303,800796,1999
NH,libraries,0,0,0,0,0,0,0,1999
NH,liquor stores,305,754916,384,204501,31457,483,959417,1999
NH,other and unallocable,1594,4434341,262,199471,20958,1719,4633812,1999
NJ,total,121048,483775021,25432,21564667,1461367,130131,505339688,1999
NJ,financial administration,4665,16953611,408,530054,48261,4976,17483665,1999
NJ,other government administration,1299,5634145,58,92704,6915,1343,5726849,1999
NJ,judicial and legal,13096,48624174,187,223310,17653,13210,48847484,1999
NJ,police arrest,1047,3167171,19,25229,2311,1062,3192400,1999
NJ,police other,2692,15042317,0,0,0,2692,15042317,1999
NJ,corrections,9362,37140116,25,36947,3387,9384,37177063,1999
NJ,streets and highways,6891,27982267,965,789815,77211,7332,28772082,1999
NJ,air transportation,0,0,0,0,0,0,0,1999
NJ,water transportation,127,478332,2,1772,177,128,480104,1999
NJ,public welfare,5594,20123841,190,284709,20221,5724,20408550,1999
NJ,health,2548,10421587,379,273969,25111,2710,10695556,1999
NJ,hospitals,14187,45010573,1555,1698532,127697,15001,46709105,1999
NJ,social insurance administration,1509,5284535,363,708062,51617,1842,5992597,1999
NJ,solid waste management,640,2920158,0,0,0,640,2920158,1999
NJ,sewage disposal,0,0,0,0,0,0,0,1999
NJ,parks and recreation,1579,6095424,1065,986932,19303,1694,7082356,1999
NJ,housing and community development,0,0,0,0,0,0,0,1999
NJ,natural resources,2534,10005049,535,576466,27768,2704,10581515,1999
NJ,water transport and terminals,110,368299,0,0,0,110,368299,1999
NJ,electric power,0,0,0,0,0,0,0,1999
NJ,gas supply,0,0,0,0,0,0,0,1999
NJ,transit,9056,35779313,839,827085,65939,9429,36606398,1999
NJ,elem and sec instruction,8653,41067507,411,323922,12458,8741,41391429,1999
NJ,elem and sec admin/cler,1286,3398807,3,3700,336,1288,3402507,1999
NJ,elem and sec oper/maint,1745,5152974,108,190465,10498,1814,5343439,1999
NJ,elem and sec cafeteria,407,1027665,395,177213,23040,566,1204878,1999
NJ,elem and sec bus transit,19,57074,10,3954,328,21,61028,1999
NJ,elem and sec health/rec,107,584892,0,0,0,107,584892,1999
NJ,elem and sec student,0,0,49,16998,3268,23,16998,1999
NJ,elem and sec unalloc,0,0,365,353782,35378,228,353782,1999
NJ,higher ed - instructional,6594,44480998,4640,5460606,219217,7950,49941604,1999
NJ,education - higher education other,15623,57364128,12463,7359996,617687,19442,64724124,1999
NJ,education - other,3464,14020127,278,460165,33663,3681,14480292,1999
NJ,libraries,0,0,0,0,0,0,0,1999
NJ,liquor stores,0,0,0,0,0,0,0,1999
NJ,other and unallocable,6214,25589937,120,158280,11923,6289,25748217,1999
NM,total,39643,106089675,13369,10440263,784066,44075,116529938,1999
NM,financial administration,1820,4527579,90,81594,6972,1859,4609173,1999
NM,other government administration,225,723358,235,710941,37723,439,1434299,1999
NM,judicial and legal,2384,6849309,113,119545,10126,2441,6968854,1999
NM,police arrest,462,1569958,0,0,0,462,1569958,1999
NM,police other,171,584303,0,0,0,171,584303,1999
NM,corrections,4121,10310696,53,68912,6979,4161,10379608,1999
NM,streets and highways,2353,5722123,0,0,0,2353,5722123,1999
NM,air transportation,6,19479,0,0,0,6,19479,1999
NM,water transportation,0,0,0,0,0,0,0,1999
NM,public welfare,1417,3298738,21,19322,449,1420,3318060,1999
NM,health,2131,5696975,185,210618,13253,2205,5907593,1999
NM,hospitals,5536,13182893,493,484233,24596,5675,13667126,1999
NM,social insurance administration,506,1164379,13,16149,1514,515,1180528,1999
NM,solid waste management,0,0,0,0,0,0,0,1999
NM,sewage disposal,0,0,0,0,0,0,0,1999
NM,parks and recreation,692,1614476,36,50295,4623,718,1664771,1999
NM,housing and community development,0,0,0,0,0,0,0,1999
NM,natural resources,1598,4475976,128,115425,12605,1670,4591401,1999
NM,water transport and terminals,0,0,0,0,0,0,0,1999
NM,electric power,0,0,0,0,0,0,0,1999
NM,gas supply,0,0,0,0,0,0,0,1999
NM,transit,0,0,0,0,0,0,0,1999
NM,elem and sec instruction,0,0,0,0,0,0,0,1999
NM,elem and sec admin/cler,0,0,0,0,0,0,0,1999
NM,elem and sec oper/maint,0,0,0,0,0,0,0,1999
NM,elem and sec cafeteria,0,0,0,0,0,0,0,1999
NM,elem and sec bus transit,0,0,0,0,0,0,0,1999
NM,elem and sec health/rec,0,0,0,0,0,0,0,1999
NM,elem and sec student,0,0,0,0,0,0,0,1999
NM,elem and sec unalloc,0,0,0,0,0,0,0,1999
NM,higher ed - instructional,3848,13218197,3119,3560536,194732,4949,16778733,1999
NM,education - higher education other,9916,26526580,8779,4918380,460750,12519,31444960,1999
NM,education - other,888,2252173,74,58040,6598,926,2310213,1999
NM,libraries,0,0,0,0,0,0,0,1999
NM,liquor stores,0,0,0,0,0,0,0,1999
NM,other and unallocable,1569,4352483,30,26273,3146,1586,4378756,1999
NY,total,233476,887804016,42304,43562500,2734621,249596,931366516,1999
NY,financial administration,13193,43604727,458,731147,31866,13378,44335874,1999
NY,other government administration,4670,15763568,687,919721,100749,5240,16683289,1999
NY,judicial and legal,17495,82132172,589,1134812,56306,17813,83266984,1999
NY,police arrest,4068,19679316,0,0,0,4068,19679316,1999
NY,police other,1523,4436610,188,191722,19220,1632,4628332,1999
NY,corrections,35038,124564689,534,1100608,48765,35315,125665297,1999
NY,streets and highways,13096,44976830,960,874636,83685,13567,45851466,1999
NY,air transportation,127,441168,10,24487,1180,134,465655,1999
NY,water transportation,858,3496811,35,68814,3299,876,3565625,1999
NY,public welfare,6478,21893830,446,723588,45087,6734,22617418,1999
NY,health,9119,36748923,587,1220610,59452,9455,37969533,1999
NY,hospitals,45514,151124579,5621,9638529,512593,48442,160763108,1999
NY,social insurance administration,8391,28655526,141,271350,17059,8488,28926876,1999
NY,solid waste management,0,0,0,0,0,0,0,1999
NY,sewage disposal,0,0,0,0,0,0,0,1999
NY,parks and recreation,1890,5851184,1023,1303822,144869,2708,7155006,1999
NY,housing and community development,0,0,0,0,0,0,0,1999
NY,natural resources,3082,11894591,295,466955,27274,3236,12361546,1999
NY,water transport and terminals,0,0,0,0,0,0,0,1999
NY,electric power,3185,20802295,157,280319,22071,3310,21082614,1999
NY,gas supply,0,0,0,0,0,0,0,1999
NY,transit,14407,68641922,480,444000,43034,14650,69085922,1999
NY,elem and sec instruction,0,0,0,0,0,0,0,1999
NY,elem and sec admin/cler,0,0,0,0,0,0,0,1999
NY,elem and sec oper/maint,0,0,0,0,0,0,0,1999
NY,elem and sec cafeteria,0,0,0,0,0,0,0,1999
NY,elem and sec bus transit,0,0,0,0,0,0,0,1999
NY,elem and sec health/rec,0,0,0,0,0,0,0,1999
NY,elem and sec student,0,0,0,0,0,0,0,1999
NY,elem and sec unalloc,0,0,0,0,0,0,0,1999
NY,higher ed - instructional,12514,67608548,13013,12978021,688890,16716,80586569,1999
NY,education - higher education other,23394,77729360,16136,9690537,752629,27963,87419897,1999
NY,education - other,4562,16671408,298,495369,25943,4709,17166777,1999
NY,libraries,0,0,0,0,0,0,0,1999
NY,liquor stores,0,0,0,0,0,0,0,1999
NY,other and unallocable,10872,41085959,646,1003453,50650,11162,42089412,1999
NC,total,109874,321097802,32917,27984215,2607514,124601,349082017,1999
NC,financial administration,3124,8042819,120,143478,8775,3174,8186297,1999
NC,other government administration,628,2180110,531,945351,75451,1054,3125461,1999
NC,judicial and legal,5860,18932040,251,363769,17305,5958,19295809,1999
NC,police arrest,2319,8345625,19,26491,841,2324,8372116,1999
NC,police other,1034,2767266,19,25440,1097,1041,2792706,1999
NC,corrections,19087,49970302,131,86286,5952,19121,50056588,1999
NC,streets and highways,11915,28085743,12,23353,2123,11927,28109096,1999
NC,air transportation,0,0,0,0,0,0,0,1999
NC,water transportation,278,844546,2,2307,190,279,846853,1999
NC,public welfare,1381,3928650,65,33515,2085,1393,3962165,1999
NC,health,2518,8169989,211,220767,20627,2634,8390756,1999
NC,hospitals,15199,40520176,1043,981478,119592,15876,41501654,1999
NC,social insurance administration,2509,6345697,329,377896,27582,2665,6723593,1999
NC,solid waste management,235,732833,3,3630,280,237,736463,1999
NC,sewage disposal,0,0,0,0,0,0,0,1999
NC,parks and recreation,873,2158284,20,25038,2292,885,2183322,1999
NC,housing and community development,0,0,0,0,0,0,0,1999
NC,natural resources,3435,9318731,1099,2422511,144765,4253,11741242,1999
NC,water transport and terminals,0,0,0,0,0,0,0,1999
NC,electric power,0,0,0,0,0,0,0,1999
NC,gas supply,0,0,0,0,0,0,0,1999
NC,transit,0,0,0,0,0,0,0,1999
NC,elem and sec instruction,0,0,0,0,0,0,0,1999
NC,elem and sec admin/cler,0,0,0,0,0,0,0,1999
NC,elem and sec oper/maint,0,0,0,0,0,0,0,1999
NC,elem and sec cafeteria,0,0,0,0,0,0,0,1999
NC,elem and sec bus transit,0,0,0,0,0,0,0,1999
NC,elem and sec health/rec,0,0,0,0,0,0,0,1999
NC,elem and sec student,0,0,0,0,0,0,0,1999
NC,elem and sec unalloc,0,0,0,0,0,0,0,1999
NC,higher ed - instructional,11311,51939743,10343,12471888,1090663,17472,64411631,1999
NC,education - higher education other,20792,55826866,18405,9448734,1056949,26762,65275600,1999
NC,education - other,2859,8410084,79,61059,5443,2889,8471143,1999
NC,libraries,0,0,0,0,0,0,0,1999
NC,liquor stores,0,0,0,0,0,0,0,1999
NC,other and unallocable,4517,14578298,235,321224,25502,4657,14899522,1999
ND,total,12982,34541070,7559,5119820,480682,15697,39660890,1999
ND,financial administration,548,1325341,83,83098,11711,613,1408439,1999
ND,other government administration,178,444306,248,706834,25329,321,1151140,1999
ND,judicial and legal,381,1275992,48,23688,2737,396,1299680,1999
ND,police arrest,130,400705,0,0,0,130,400705,1999
ND,police other,90,203538,3,4691,447,93,208229,1999
ND,corrections,526,1144913,43,26723,3234,545,1171636,1999
ND,streets and highways,913,2313024,23,18405,2063,925,2331429,1999
ND,air transportation,0,0,0,0,0,0,0,1999
ND,water transportation,0,0,0,0,0,0,0,1999
ND,public welfare,379,680323,67,24063,3016,395,704386,1999
ND,health,1144,2775367,193,169782,13289,1219,2945149,1999
ND,hospitals,1062,2180013,183,40471,6459,1098,2220484,1999
ND,social insurance administration,390,966005,41,34334,3676,411,1000339,1999
ND,solid waste management,0,0,0,0,0,0,0,1999
ND,sewage disposal,0,0,0,0,0,0,0,1999
ND,parks and recreation,99,217127,27,18353,2209,111,235480,1999
ND,housing and community development,0,0,0,0,0,0,0,1999
ND,natural resources,947,2746667,595,461449,79820,1397,3208116,1999
ND,water transport and terminals,0,0,0,0,0,0,0,1999
ND,electric power,0,0,0,0,0,0,0,1999
ND,gas supply,0,0,0,0,0,0,0,1999
ND,transit,0,0,0,0,0,0,0,1999
ND,elem and sec instruction,0,0,0,0,0,0,0,1999
ND,elem and sec admin/cler,0,0,0,0,0,0,0,1999
ND,elem and sec oper/maint,0,0,0,0,0,0,0,1999
ND,elem and sec cafeteria,0,0,0,0,0,0,0,1999
ND,elem and sec bus transit,0,0,0,0,0,0,0,1999
ND,elem and sec health/rec,0,0,0,0,0,0,0,1999
ND,elem and sec student,0,0,0,0,0,0,0,1999
ND,elem and sec unalloc,0,0,0,0,0,0,0,1999
ND,higher ed - instructional,1789,7570211,1786,2245917,140705,2584,9816128,1999
ND,education - higher education other,3010,6681688,4073,1151646,174429,3996,7833334,1999
ND,education - other,300,729163,49,28677,2518,314,757840,1999
ND,libraries,0,0,0,0,0,0,0,1999
ND,liquor stores,0,0,0,0,0,0,0,1999
ND,other and unallocable,1096,2886687,97,81689,9040,1149,2968376,1999
OH,total,114303,372961550,62391,50883395,4030843,137103,423844945,1999
OH,financial administration,7932,28090242,571,757950,61342,8279,28848192,1999
OH,other government administration,768,2524783,184,114342,14228,848,2639125,1999
OH,judicial and legal,2419,8968331,451,968371,54505,2727,9936702,1999
OH,police arrest,1391,5986001,0,0,0,1391,5986001,1999
OH,police other,1192,3359834,14,16034,1813,1202,3375868,1999
OH,corrections,17837,55597762,91,140804,9956,17894,55738566,1999
OH,streets and highways,7308,26755105,382,403679,33336,7496,27158784,1999
OH,air transportation,0,0,0,0,0,0,0,1999
OH,water transportation,0,0,0,0,0,0,0,1999
OH,public welfare,1984,7249046,184,164263,21577,2106,7413309,1999
OH,health,3465,13642256,269,236404,20324,3580,13878660,1999
OH,hospitals,10187,25055635,3142,5677761,355926,12199,30733396,1999
OH,social insurance administration,2964,9828260,44,54892,3713,2985,9883152,1999
OH,solid waste management,0,0,0,0,0,0,0,1999
OH,sewage disposal,0,0,0,0,0,0,0,1999
OH,parks and recreation,627,1967336,211,245200,21600,749,2212536,1999
OH,housing and community development,0,0,0,0,0,0,0,1999
OH,natural resources,3438,10065011,826,1074051,84213,3913,11139062,1999
OH,water transport and terminals,0,0,0,0,0,0,0,1999
OH,electric power,0,0,0,0,0,0,0,1999
OH,gas supply,0,0,0,0,0,0,0,1999
OH,transit,0,0,0,0,0,0,0,1999
OH,elem and sec instruction,0,0,0,0,0,0,0,1999
OH,elem and sec admin/cler,0,0,0,0,0,0,0,1999
OH,elem and sec oper/maint,0,0,0,0,0,0,0,1999
OH,elem and sec cafeteria,0,0,0,0,0,0,0,1999
OH,elem and sec bus transit,0,0,0,0,0,0,0,1999
OH,elem and sec health/rec,0,0,0,0,0,0,0,1999
OH,elem and sec student,0,0,0,0,0,0,0,1999
OH,elem and sec unalloc,0,0,0,0,0,0,0,1999
OH,higher ed - instructional,15388,72468715,17032,19347118,1046202,21312,91815833,1999
OH,education - higher education other,30643,76500940,38526,21170692,2270839,43485,97671632,1999
OH,education - other,2193,8062414,137,190280,9654,2247,8252694,1999
OH,libraries,0,0,0,0,0,0,0,1999
OH,liquor stores,0,0,0,0,0,0,0,1999
OH,other and unallocable,4567,16839879,327,321554,21615,4690,17161433,1999
OK,total,57413,155861583,22013,15758111,1218397,64361,171619694,1999
OK,financial administration,1766,4873126,87,102243,6478,1803,4975369,1999
OK,other government administration,813,2479813,198,263378,23171,945,2743191,1999
OK,judicial and legal,2357,7820321,240,251608,19618,2468,8071929,1999
OK,police arrest,952,3026279,18,17005,845,957,3043284,1999
OK,police other,801,1735017,43,28015,2167,814,1763032,1999
OK,corrections,5924,13680023,300,286610,21631,6045,13966633,1999
OK,streets and highways,3017,7059473,80,82518,5496,3048,7141991,1999
OK,air transportation,0,0,0,0,0,0,0,1999
OK,water transportation,0,0,0,0,0,0,0,1999
OK,public welfare,6350,13703586,442,333957,38248,6566,14037543,1999
OK,health,3796,9850099,327,369417,29099,3961,10219516,1999
OK,hospitals,3432,8146159,162,158437,16323,3525,8304596,1999
OK,social insurance administration,1276,3338817,170,151791,14011,1355,3490608,1999
OK,solid waste management,80,206403,5,4105,549,83,210508,1999
OK,sewage disposal,0,0,0,0,0,0,0,1999
OK,parks and recreation,866,1346147,407,140873,19480,976,1487020,1999
OK,housing and community development,0,0,0,0,0,0,0,1999
OK,natural resources,1812,4975892,712,403602,33156,1999,5379494,1999
OK,water transport and terminals,0,0,0,0,0,0,0,1999
OK,electric power,469,1754442,3,3016,256,471,1757458,1999
OK,gas supply,0,0,0,0,0,0,0,1999
OK,transit,0,0,0,0,0,0,0,1999
OK,elem and sec instruction,0,0,0,0,0,0,0,1999
OK,elem and sec admin/cler,0,0,0,0,0,0,0,1999
OK,elem and sec oper/maint,0,0,0,0,0,0,0,1999
OK,elem and sec cafeteria,0,0,0,0,0,0,0,1999
OK,elem and sec bus transit,0,0,0,0,0,0,0,1999
OK,elem and sec health/rec,0,0,0,0,0,0,0,1999
OK,elem and sec student,0,0,0,0,0,0,0,1999
OK,elem and sec unalloc,0,0,0,0,0,0,0,1999
OK,higher ed - instructional,5892,24958267,5276,6271489,340428,7831,31229756,1999
OK,education - higher education other,13379,34857198,13174,6509004,618598,16920,41366202,1999
OK,education - other,2035,5575615,170,147791,11206,2097,5723406,1999
OK,libraries,0,0,0,0,0,0,0,1999
OK,liquor stores,0,0,0,0,0,0,0,1999
OK,other and unallocable,2396,6474906,199,233252,17637,2497,6708158,1999
OR,total,44927,140741062,22864,25316511,1803693,55119,166057573,1999
OR,financial administration,3700,12048788,535,732330,59947,4039,12781118,1999
OR,other government administration,1321,3535235,232,289348,17556,1419,3824583,1999
OR,judicial and legal,2697,8397633,256,678908,44300,2948,9076541,1999
OR,police arrest,798,3111923,56,164470,9617,852,3276393,1999
OR,police other,475,1303007,120,119851,7893,520,1422858,1999
OR,corrections,4140,12884525,260,348464,33748,4330,13232989,1999
OR,streets and highways,3274,10155978,434,777801,45753,3532,10933779,1999
OR,air transportation,15,46500,0,0,0,15,46500,1999
OR,water transportation,0,0,0,0,0,0,0,1999
OR,public welfare,5040,14341849,510,1325510,60254,5380,15667359,1999
OR,health,1786,5616596,158,301681,21280,1906,5918277,1999
OR,hospitals,4308,10784572,1868,3463490,428288,6728,14248062,1999
OR,social insurance administration,2130,7233997,82,170252,7653,2173,7404249,1999
OR,solid waste management,0,0,0,0,0,0,0,1999
OR,sewage disposal,0,0,0,0,0,0,0,1999
OR,parks and recreation,347,1001000,31,40526,3720,368,1041526,1999
OR,housing and community development,0,0,0,0,0,0,0,1999
OR,natural resources,2560,8107681,580,541426,52035,2853,8649107,1999
OR,water transport and terminals,0,0,0,0,0,0,0,1999
OR,electric power,0,0,0,0,0,0,0,1999
OR,gas supply,0,0,0,0,0,0,0,1999
OR,transit,0,0,0,0,0,0,0,1999
OR,elem and sec instruction,0,0,0,0,0,0,0,1999
OR,elem and sec admin/cler,0,0,0,0,0,0,0,1999
OR,elem and sec oper/maint,0,0,0,0,0,0,0,1999
OR,elem and sec cafeteria,0,0,0,0,0,0,0,1999
OR,elem and sec bus transit,0,0,0,0,0,0,0,1999
OR,elem and sec health/rec,0,0,0,0,0,0,0,1999
OR,elem and sec student,0,0,0,0,0,0,0,1999
OR,elem and sec unalloc,0,0,0,0,0,0,0,1999
OR,higher ed - instructional,5006,23024612,7376,12159330,607967,8441,35183942,1999
OR,education - higher education other,4694,10970474,9998,3674305,367430,6770,14644779,1999
OR,education - other,888,2642083,161,362751,23178,1019,3004834,1999
OR,libraries,0,0,0,0,0,0,0,1999
OR,liquor stores,137,449782,6,5400,285,139,455182,1999
OR,other and unallocable,1611,5084827,201,160668,12789,1687,5245495,1999
PA,total,130812,436636782,48320,43498872,2709590,146798,480135654,1999
PA,financial administration,6900,22224035,672,950958,97628,7487,23174993,1999
PA,other government administration,2881,8819168,1350,2135412,117245,3574,10954580,1999
PA,judicial and legal,2514,12391847,55,127686,5080,2546,12519533,1999
PA,police arrest,4215,16723299,0,0,0,4215,16723299,1999
PA,police other,1102,4372949,167,232984,23298,1242,4605933,1999
PA,corrections,14566,44700295,272,534861,39794,14806,45235156,1999
PA,streets and highways,12830,38401770,807,1487439,99163,13418,39889209,1999
PA,air transportation,34,130325,0,0,0,34,130325,1999
PA,water transportation,72,318953,0,0,0,72,318953,1999
PA,public welfare,11755,37279430,165,350959,22515,11890,37630389,1999
PA,health,1369,4745709,17,13854,801,1374,4759563,1999
PA,hospitals,13756,36572278,774,1064734,65507,14146,37637012,1999
PA,social insurance administration,4138,13500722,202,407316,33542,4340,13908038,1999
PA,solid waste management,0,0,0,0,0,0,0,1999
PA,sewage disposal,0,0,0,0,0,0,0,1999
PA,parks and recreation,885,2784902,503,900795,65645,1280,3685697,1999
PA,housing and community development,0,0,0,0,0,0,0,1999
PA,natural resources,6163,21138681,1188,1749564,81521,6643,22888245,1999
PA,water transport and terminals,0,0,0,0,0,0,0,1999
PA,electric power,0,0,0,0,0,0,0,1999
PA,gas supply,0,0,0,0,0,0,0,1999
PA,transit,0,0,0,0,0,0,0,1999
PA,elem and sec instruction,0,0,0,0,0,0,0,1999
PA,elem and sec admin/cler,0,0,0,0,0,0,0,1999
PA,elem and sec oper/maint,0,0,0,0,0,0,0,1999
PA,elem and sec cafeteria,0,0,0,0,0,0,0,1999
PA,elem and sec bus transit,0,0,0,0,0,0,0,1999
PA,elem and sec health/rec,0,0,0,0,0,0,0,1999
PA,elem and sec student,0,0,0,0,0,0,0,1999
PA,elem and sec unalloc,0,0,0,0,0,0,0,1999
PA,higher ed - instructional,12488,74523127,9834,17552381,670088,16363,92075508,1999
PA,education - higher education other,25135,66541807,30849,14867237,1276352,32687,81409044,1999
PA,education - other,2739,8781464,252,229448,24657,2888,9010912,1999
PA,libraries,0,0,0,0,0,0,0,1999
PA,liquor stores,2656,7092288,846,385761,43660,2919,7478049,1999
PA,other and unallocable,4614,15593733,367,507483,43094,4874,16101216,1999
RI,total,17891,64964001,6385,4454270,314401,19786,69418271,1999
RI,financial administration,863,2872443,3,4835,221,864,2877278,1999
RI,other government administration,681,1958668,205,20678,1093,688,1979346,1999
RI,judicial and legal,1096,3948531,36,44534,2041,1109,3993065,1999
RI,police arrest,206,1005632,0,0,0,206,1005632,1999
RI,police other,68,229074,1,245,7,68,229319,1999
RI,corrections,1798,7321039,0,0,0,1798,7321039,1999
RI,streets and highways,837,2769221,9,11238,534,841,2780459,1999
RI,air transportation,0,0,0,0,0,0,0,1999
RI,water transportation,0,0,0,0,0,0,0,1999
RI,public welfare,1540,6366671,55,142055,5957,1579,6508726,1999
RI,health,1390,5164916,53,31115,1218,1397,5196031,1999
RI,hospitals,1293,4269934,16,26214,1417,1301,4296148,1999
RI,social insurance administration,633,1963152,42,69820,5302,667,2032972,1999
RI,solid waste management,87,343137,0,0,0,87,343137,1999
RI,sewage disposal,241,861062,0,0,0,241,861062,1999
RI,parks and recreation,71,187851,1,554,44,71,188405,1999
RI,housing and community development,0,0,0,0,0,0,0,1999
RI,natural resources,494,1749084,28,30994,2531,508,1780078,1999
RI,water transport and terminals,0,0,0,0,0,0,0,1999
RI,electric power,0,0,0,0,0,0,0,1999
RI,gas supply,0,0,0,0,0,0,0,1999
RI,transit,559,1884349,22,33492,3641,580,1917841,1999
RI,elem and sec instruction,337,1292527,41,39839,2125,353,1332366,1999
RI,elem and sec admin/cler,30,92490,4,4147,399,33,96637,1999
RI,elem and sec oper/maint,27,59118,0,0,0,27,59118,1999
RI,elem and sec cafeteria,0,0,25,10342,1461,11,10342,1999
RI,elem and sec bus transit,5,9126,26,20373,2559,24,29499,1999
RI,elem and sec health/rec,0,0,0,0,0,0,0,1999
RI,elem and sec student,0,0,0,0,0,0,0,1999
RI,elem and sec unalloc,6,11648,29,19968,1415,17,31616,1999
RI,higher ed - instructional,1812,7654230,2476,2434167,124908,2572,10088397,1999
RI,education - higher education other,2157,6380935,3113,1259424,140304,2973,7640359,1999
RI,education - other,519,2531868,127,195578,13641,607,2727446,1999
RI,libraries,0,0,0,0,0,0,0,1999
RI,liquor stores,0,0,0,0,0,0,0,1999
RI,other and unallocable,1141,4037295,73,54658,3583,1164,4091953,1999
SC,total,73013,186914621,19608,11266550,1000390,78975,198181171,1999
SC,financial administration,2161,6484074,23,22902,1018,2166,6506976,1999
SC,other government administration,491,1431634,568,292769,29564,670,1724403,1999
SC,judicial and legal,681,2533464,10,8836,774,686,2542300,1999
SC,police arrest,1413,4016712,0,0,0,1413,4016712,1999
SC,police other,1773,3617002,11,10342,574,1776,3627344,1999
SC,corrections,8939,19231836,11,14370,858,8944,19246206,1999
SC,streets and highways,4886,10160364,9,8956,460,4889,10169320,1999
SC,air transportation,0,0,0,0,0,0,0,1999
SC,water transportation,528,1908140,0,0,0,528,1908140,1999
SC,public welfare,4955,11115192,15,18844,752,4960,11134036,1999
SC,health,7649,18803343,237,382090,17729,7754,19185433,1999
SC,hospitals,8687,15889907,307,447121,39321,8916,16337028,1999
SC,social insurance administration,1332,3386438,5,7220,78,1332,3393658,1999
SC,solid waste management,0,0,0,0,0,0,0,1999
SC,sewage disposal,0,0,0,0,0,0,0,1999
SC,parks and recreation,622,1307943,8,4100,485,625,1312043,1999
SC,housing and community development,0,0,0,0,0,0,0,1999
SC,natural resources,2453,6851977,429,172509,21204,2580,7024486,1999
SC,water transport and terminals,0,0,0,0,0,0,0,1999
SC,electric power,1649,6454950,20,50614,3551,1669,6505564,1999
SC,gas supply,0,0,0,0,0,0,0,1999
SC,transit,0,0,0,0,0,0,0,1999
SC,elem and sec instruction,0,0,0,0,0,0,0,1999
SC,elem and sec admin/cler,0,0,0,0,0,0,0,1999
SC,elem and sec oper/maint,0,0,0,0,0,0,0,1999
SC,elem and sec cafeteria,0,0,0,0,0,0,0,1999
SC,elem and sec bus transit,0,0,0,0,0,0,0,1999
SC,elem and sec health/rec,0,0,0,0,0,0,0,1999
SC,elem and sec student,0,0,0,0,0,0,0,1999
SC,elem and sec unalloc,0,0,0,0,0,0,0,1999
SC,higher ed - instructional,8218,35095118,7525,5857003,346016,10297,40952121,1999
SC,education - higher education other,12382,27297665,10374,3897046,535366,15561,31194711,1999
SC,education - other,2723,7056964,33,39936,1110,2730,7096900,1999
SC,libraries,0,0,0,0,0,0,0,1999
SC,liquor stores,0,0,0,0,0,0,0,1999
SC,other and unallocable,1471,4271898,23,31892,1530,1479,4303790,1999
SD,total,11429,30716626,5159,2375876,283867,13030,33092502,1999
SD,financial administration,325,859810,8,8930,974,331,868740,1999
SD,other government administration,301,785426,124,54339,4124,323,839765,1999
SD,judicial and legal,473,1415171,85,70633,6421,509,1485804,1999
SD,police arrest,173,532166,2,1430,80,173,533596,1999
SD,police other,95,198529,6,5318,564,99,203847,1999
SD,corrections,839,1737667,50,38404,4237,863,1776071,1999
SD,streets and highways,931,2446169,129,95366,10470,990,2541535,1999
SD,air transportation,0,0,0,0,0,0,0,1999
SD,water transportation,0,0,0,0,0,0,0,1999
SD,public welfare,913,1991287,60,57568,6489,949,2048855,1999
SD,health,497,1298024,51,58366,4928,524,1356390,1999
SD,hospitals,889,1922808,96,104585,10804,950,2027393,1999
SD,social insurance administration,282,620279,7,6046,571,285,626325,1999
SD,solid waste management,0,0,0,0,0,0,0,1999
SD,sewage disposal,0,0,0,0,0,0,0,1999
SD,parks and recreation,106,249234,24,20546,2462,120,269780,1999
SD,housing and community development,0,0,0,0,0,0,0,1999
SD,natural resources,720,1873806,283,104682,15061,805,1978488,1999
SD,water transport and terminals,0,0,0,0,0,0,0,1999
SD,electric power,0,0,0,0,0,0,0,1999
SD,gas supply,0,0,0,0,0,0,0,1999
SD,transit,0,0,0,0,0,0,0,1999
SD,elem and sec instruction,0,0,0,0,0,0,0,1999
SD,elem and sec admin/cler,0,0,0,0,0,0,0,1999
SD,elem and sec oper/maint,0,0,0,0,0,0,0,1999
SD,elem and sec cafeteria,0,0,0,0,0,0,0,1999
SD,elem and sec bus transit,0,0,0,0,0,0,0,1999
SD,elem and sec health/rec,0,0,0,0,0,0,0,1999
SD,elem and sec student,0,0,0,0,0,0,0,1999
SD,elem and sec unalloc,0,0,0,0,0,0,0,1999
SD,higher ed - instructional,1342,6326213,810,742179,70595,1741,7068392,1999
SD,education - higher education other,2147,4686182,3253,886411,134308,2907,5572593,1999
SD,education - other,360,831600,55,58790,5460,391,890390,1999
SD,libraries,0,0,0,0,0,0,0,1999
SD,liquor stores,0,0,0,0,0,0,0,1999
SD,other and unallocable,1036,2942255,116,62283,6319,1070,3004538,1999
TN,total,70633,194126561,23073,21224325,1844656,81407,215350886,1999
TN,financial administration,2537,7206476,51,48090,5438,2571,7254566,1999
TN,other government administration,684,1857734,63,98142,7510,729,1955876,1999
TN,judicial and legal,1959,7336358,53,61064,3086,1977,7397422,1999
TN,police arrest,1039,3278360,0,0,0,1039,3278360,1999
TN,police other,846,1925114,7,2888,446,849,1928002,1999
TN,corrections,6277,13554936,101,143924,8554,6328,13698860,1999
TN,streets and highways,4733,10505116,0,0,0,4733,10505116,1999
TN,air transportation,0,0,0,0,0,0,0,1999
TN,water transportation,0,0,0,0,0,0,0,1999
TN,public welfare,5314,12864018,20,15738,1592,5323,12879756,1999
TN,health,3033,8027661,110,111069,9287,3087,8138730,1999
TN,hospitals,9525,27515712,509,1103596,77132,9963,28619308,1999
TN,social insurance administration,1453,3539828,230,264124,25040,1604,3803952,1999
TN,solid waste management,0,0,0,0,0,0,0,1999
TN,sewage disposal,0,0,0,0,0,0,0,1999
TN,parks and recreation,1034,1771580,95,57808,9998,1094,1829388,1999
TN,housing and community development,0,0,0,0,0,0,0,1999
TN,natural resources,3022,7570779,744,661747,75974,3463,8232526,1999
TN,water transport and terminals,0,0,0,0,0,0,0,1999
TN,electric power,0,0,0,0,0,0,0,1999
TN,gas supply,0,0,0,0,0,0,0,1999
TN,transit,0,0,0,0,0,0,0,1999
TN,elem and sec instruction,0,0,0,0,0,0,0,1999
TN,elem and sec admin/cler,0,0,0,0,0,0,0,1999
TN,elem and sec oper/maint,0,0,0,0,0,0,0,1999
TN,elem and sec cafeteria,0,0,0,0,0,0,0,1999
TN,elem and sec bus transit,0,0,0,0,0,0,0,1999
TN,elem and sec health/rec,0,0,0,0,0,0,0,1999
TN,elem and sec student,0,0,0,0,0,0,0,1999
TN,elem and sec unalloc,0,0,0,0,0,0,0,1999
TN,higher ed - instructional,8738,39586073,7247,8602487,574724,12145,48188560,1999
TN,education - higher education other,15897,35892946,13639,9947925,1036648,21907,45840871,1999
TN,education - other,2016,5231150,143,86351,7305,2058,5317501,1999
TN,libraries,0,0,0,0,0,0,0,1999
TN,liquor stores,0,0,0,0,0,0,0,1999
TN,other and unallocable,2526,6462720,61,19372,1922,2537,6482092,1999
TX,total,243420,687019414,62537,61028415,4606177,269450,748047829,1999
TX,financial administration,8842,25707793,246,286970,21906,8966,25994763,1999
TX,other government administration,2482,6667286,855,772391,68439,2870,7439677,1999
TX,judicial and legal,4922,18197943,88,130481,8521,4973,18328424,1999
TX,police arrest,2095,7163181,0,0,0,2095,7163181,1999
TX,police other,1478,3479314,32,25238,2560,1492,3504552,1999
TX,corrections,46642,99361529,219,193009,19507,46752,99554538,1999
TX,streets and highways,14435,36146160,326,565679,38589,14653,36711839,1999
TX,air transportation,0,0,0,0,0,0,0,1999
TX,water transportation,0,0,0,0,0,0,0,1999
TX,public welfare,21449,47465419,154,203138,15508,21536,47668557,1999
TX,health,14145,36326169,721,1695879,84628,14623,38022048,1999
TX,hospitals,32335,81478162,1655,2486579,167311,33282,83964741,1999
TX,social insurance administration,4724,12549973,73,88450,2747,4739,12638423,1999
TX,solid waste management,0,0,0,0,0,0,0,1999
TX,sewage disposal,0,0,0,0,0,0,0,1999
TX,parks and recreation,877,1869240,165,111180,16390,970,1980420,1999
TX,housing and community development,0,0,0,0,0,0,0,1999
TX,natural resources,10896,33210491,3452,2256797,207725,12071,35467288,1999
TX,water transport and terminals,0,0,0,0,0,0,0,1999
TX,electric power,0,0,0,0,0,0,0,1999
TX,gas supply,0,0,0,0,0,0,0,1999
TX,transit,0,0,0,0,0,0,0,1999
TX,elem and sec instruction,0,0,0,0,0,0,0,1999
TX,elem and sec admin/cler,0,0,0,0,0,0,0,1999
TX,elem and sec oper/maint,0,0,0,0,0,0,0,1999
TX,elem and sec cafeteria,0,0,0,0,0,0,0,1999
TX,elem and sec bus transit,0,0,0,0,0,0,0,1999
TX,elem and sec health/rec,0,0,0,0,0,0,0,1999
TX,elem and sec student,0,0,0,0,0,0,0,1999
TX,elem and sec unalloc,0,0,0,0,0,0,0,1999
TX,higher ed - instructional,19199,112741137,21104,30316159,1743782,29052,143057296,1999
TX,education - higher education other,47858,132984312,32365,20708877,2120821,59841,153693189,1999
TX,education - other,4364,12004433,526,847455,58764,4696,12851888,1999
TX,libraries,0,0,0,0,0,0,0,1999
TX,liquor stores,0,0,0,0,0,0,0,1999
TX,other and unallocable,6677,19666872,556,340133,28979,6839,20007005,1999
UT,total,41914,116679769,16775,12256285,1197286,48679,128936054,1999
UT,financial administration,1528,4308694,238,194504,11219,1592,4503198,1999
UT,other government administration,179,683292,27,41876,2545,193,725168,1999
UT,judicial and legal,1493,4804856,191,200312,15820,1582,5005168,1999
UT,police arrest,404,1334190,0,0,0,404,1334190,1999
UT,police other,340,1009335,43,34756,3237,358,1044091,1999
UT,corrections,2709,7130745,370,284824,29223,2874,7415569,1999
UT,streets and highways,1727,5521534,60,79516,7629,1770,5601050,1999
UT,air transportation,0,0,0,0,0,0,0,1999
UT,water transportation,0,0,0,0,0,0,0,1999
UT,public welfare,2989,8171113,314,462083,36945,3198,8633196,1999
UT,health,1443,4388595,145,204235,12046,1511,4592830,1999
UT,hospitals,4902,11159975,329,265422,30247,5073,11425397,1999
UT,social insurance administration,694,1944058,59,102318,9950,750,2046376,1999
UT,solid waste management,0,0,0,0,0,0,0,1999
UT,sewage disposal,0,0,0,0,0,0,0,1999
UT,parks and recreation,291,790471,54,60035,6773,328,850506,1999
UT,housing and community development,0,0,0,0,0,0,0,1999
UT,natural resources,1030,3074556,223,177207,16531,1123,3251763,1999
UT,water transport and terminals,0,0,0,0,0,0,0,1999
UT,electric power,0,0,0,0,0,0,0,1999
UT,gas supply,0,0,0,0,0,0,0,1999
UT,transit,0,0,0,0,0,0,0,1999
UT,elem and sec instruction,0,0,0,0,0,0,0,1999
UT,elem and sec admin/cler,0,0,0,0,0,0,0,1999
UT,elem and sec oper/maint,0,0,0,0,0,0,0,1999
UT,elem and sec cafeteria,0,0,0,0,0,0,0,1999
UT,elem and sec bus transit,0,0,0,0,0,0,0,1999
UT,elem and sec health/rec,0,0,0,0,0,0,0,1999
UT,elem and sec student,0,0,0,0,0,0,0,1999
UT,elem and sec unalloc,0,0,0,0,0,0,0,1999
UT,higher ed - instructional,4584,23224821,3308,3236428,215801,5804,26461249,1999
UT,education - higher education other,14921,31153054,10561,6319469,743963,19125,37472523,1999
UT,education - other,878,2600175,344,285382,25184,1020,2885557,1999
UT,libraries,0,0,0,0,0,0,0,1999
UT,liquor stores,208,455856,212,103746,13762,286,559602,1999
UT,other and unallocable,1594,4924449,297,204172,16411,1688,5128621,1999
VT,total,11608,37317866,2668,2620421,188275,12714,39938287,1999
VT,financial administration,503,1514813,8,12799,901,508,1527612,1999
VT,other government administration,317,851376,204,479955,24362,454,1331331,1999
VT,judicial and legal,539,1748241,60,101829,7182,580,1850070,1999
VT,police arrest,327,1403638,31,14358,1592,337,1417996,1999
VT,police other,168,511899,44,37232,4959,200,549131,1999
VT,corrections,908,2602409,22,36810,2300,921,2639219,1999
VT,streets and highways,995,3299876,10,14823,1007,1001,3314699,1999
VT,air transportation,0,0,0,0,0,0,0,1999
VT,water transportation,0,0,0,0,0,0,0,1999
VT,public welfare,996,2861920,127,253497,18162,1098,3115417,1999
VT,health,484,1481205,69,137173,8105,530,1618378,1999
VT,hospitals,170,446759,6,12212,764,174,458971,1999
VT,social insurance administration,338,937266,13,26440,1880,349,963706,1999
VT,solid waste management,0,0,0,0,0,0,0,1999
VT,sewage disposal,0,0,0,0,0,0,0,1999
VT,parks and recreation,125,362498,8,16880,1127,131,379378,1999
VT,housing and community development,0,0,0,0,0,0,0,1999
VT,natural resources,570,1803026,24,55873,3320,589,1858899,1999
VT,water transport and terminals,0,0,0,0,0,0,0,1999
VT,electric power,0,0,0,0,0,0,0,1999
VT,gas supply,0,0,0,0,0,0,0,1999
VT,transit,0,0,0,0,0,0,0,1999
VT,elem and sec instruction,0,0,0,0,0,0,0,1999
VT,elem and sec admin/cler,0,0,0,0,0,0,0,1999
VT,elem and sec oper/maint,0,0,0,0,0,0,0,1999
VT,elem and sec cafeteria,0,0,0,0,0,0,0,1999
VT,elem and sec bus transit,0,0,0,0,0,0,0,1999
VT,elem and sec health/rec,0,0,0,0,0,0,0,1999
VT,elem and sec student,0,0,0,0,0,0,0,1999
VT,elem and sec unalloc,0,0,0,0,0,0,0,1999
VT,higher ed - instructional,1199,6129147,390,512735,22064,1332,6641882,1999
VT,education - higher education other,2511,7021582,1546,769465,79843,2992,7791047,1999
VT,education - other,400,1247867,43,46658,3746,422,1294525,1999
VT,libraries,0,0,0,0,0,0,0,1999
VT,liquor stores,49,151057,0,0,0,49,151057,1999
VT,other and unallocable,1009,2943287,63,91682,6961,1047,3034969,1999
VA,total,96761,301796056,45708,36406909,2973872,113823,338202965,1999
VA,financial administration,3628,11093716,594,701757,81703,4089,11795473,1999
VA,other government administration,496,1803802,307,469222,28598,660,2273024,1999
VA,judicial and legal,3105,10397410,453,413438,29116,3270,10810848,1999
VA,police arrest,1776,6850356,0,0,0,1776,6850356,1999
VA,police other,712,1802966,148,108096,10754,772,1911062,1999
VA,corrections,15320,35541130,608,577002,45448,15577,36118132,1999
VA,streets and highways,9976,27511304,809,556808,50619,10262,28068112,1999
VA,air transportation,0,0,0,0,0,0,0,1999
VA,water transportation,132,442186,4,3742,424,134,445928,1999
VA,public welfare,1825,5381982,231,336260,23684,1960,5718242,1999
VA,health,4782,14594226,705,783106,66118,5156,15377332,1999
VA,hospitals,12671,32633108,1463,2024012,126171,13384,34657120,1999
VA,social insurance administration,1136,3325178,446,480818,43102,1380,3805996,1999
VA,solid waste management,0,0,0,0,0,0,0,1999
VA,sewage disposal,0,0,0,0,0,0,0,1999
VA,parks and recreation,601,1600344,774,447530,55419,913,2047874,1999
VA,housing and community development,0,0,0,0,0,0,0,1999
VA,natural resources,2825,9115530,631,547346,51638,3116,9662876,1999
VA,water transport and terminals,0,0,0,0,0,0,0,1999
VA,electric power,0,0,0,0,0,0,0,1999
VA,gas supply,0,0,0,0,0,0,0,1999
VA,transit,0,0,0,0,0,0,0,1999
VA,elem and sec instruction,0,0,0,0,0,0,0,1999
VA,elem and sec admin/cler,0,0,0,0,0,0,0,1999
VA,elem and sec oper/maint,0,0,0,0,0,0,0,1999
VA,elem and sec cafeteria,0,0,0,0,0,0,0,1999
VA,elem and sec bus transit,0,0,0,0,0,0,0,1999
VA,elem and sec health/rec,0,0,0,0,0,0,0,1999
VA,elem and sec student,0,0,0,0,0,0,0,1999
VA,elem and sec unalloc,0,0,0,0,0,0,0,1999
VA,higher ed - instructional,11849,67397676,12016,14811604,719903,15968,82209280,1999
VA,education - higher education other,19462,52039352,24452,12387993,1467982,27960,64427345,1999
VA,education - other,2533,7902046,643,559304,47392,2803,8461350,1999
VA,libraries,0,0,0,0,0,0,0,1999
VA,liquor stores,636,1107542,798,625842,76216,1067,1733384,1999
VA,other and unallocable,3296,11256202,626,573029,49585,3576,11829231,1999
WA,total,86030,293130864,53906,47335791,3977815,108514,340466655,1999
WA,financial administration,2479,8283789,176,314290,20355,2594,8598079,1999
WA,other government administration,1246,3928768,395,508468,29808,1415,4437236,1999
WA,judicial and legal,1595,6854488,199,271326,14914,1680,7125814,1999
WA,police arrest,964,4302630,0,0,0,964,4302630,1999
WA,police other,1199,3560426,0,0,0,1199,3560426,1999
WA,corrections,6221,20614782,1984,3042272,226926,7503,23657054,1999
WA,streets and highways,6184,22184724,373,755468,43026,6427,22940192,1999
WA,air transportation,0,0,0,0,0,0,0,1999
WA,water transportation,0,0,0,0,0,0,0,1999
WA,public welfare,4666,14901108,506,943572,50588,4952,15844680,1999
WA,health,5012,17456889,793,1321939,74211,5432,18778828,1999
WA,hospitals,6475,19319892,2473,5115488,199164,7601,24435380,1999
WA,social insurance administration,5902,18795456,699,985322,53054,6202,19780778,1999
WA,solid waste management,143,498296,21,67598,3434,162,565894,1999
WA,sewage disposal,0,0,0,0,0,0,0,1999
WA,parks and recreation,533,1610418,53,54032,5272,563,1664450,1999
WA,housing and community development,0,0,0,0,0,0,0,1999
WA,natural resources,4715,15388098,1104,1361363,115912,5370,16749461,1999
WA,water transport and terminals,0,0,0,0,0,0,0,1999
WA,electric power,0,0,0,0,0,0,0,1999
WA,gas supply,0,0,0,0,0,0,0,1999
WA,transit,0,0,0,0,0,0,0,1999
WA,elem and sec instruction,0,0,0,0,0,0,0,1999
WA,elem and sec admin/cler,0,0,0,0,0,0,0,1999
WA,elem and sec oper/maint,0,0,0,0,0,0,0,1999
WA,elem and sec cafeteria,0,0,0,0,0,0,0,1999
WA,elem and sec bus transit,0,0,0,0,0,0,0,1999
WA,elem and sec health/rec,0,0,0,0,0,0,0,1999
WA,elem and sec student,0,0,0,0,0,0,0,1999
WA,elem and sec unalloc,0,0,0,0,0,0,0,1999
WA,higher ed - instructional,10190,46379828,11306,13064031,694308,14113,59443859,1999
WA,education - higher education other,20135,61981507,29629,15947817,2215986,32655,77929324,1999
WA,education - other,2795,9471634,3302,2353419,137843,3580,11825053,1999
WA,libraries,0,0,0,0,0,0,0,1999
WA,liquor stores,491,1375636,470,640156,53164,791,2015792,1999
WA,other and unallocable,5085,16222495,423,589230,39850,5311,16811725,1999
WV,total,30185,77390498,8900,5990446,445424,32857,83380944,1999
WV,financial administration,1959,4011642,29,23084,2460,1973,4034726,1999
WV,other government administration,274,728312,322,904144,31543,474,1632456,1999
WV,judicial and legal,1106,2963114,38,38160,2720,1123,3001274,1999
WV,police arrest,657,2038272,0,0,0,657,2038272,1999
WV,police other,354,606506,10,4708,768,358,611214,1999
WV,corrections,1186,2400742,3,2806,112,1186,2403548,1999
WV,streets and highways,6184,14933406,30,51037,4685,6210,14984443,1999
WV,air transportation,0,0,0,0,0,0,0,1999
WV,water transportation,0,0,0,0,0,0,0,1999
WV,public welfare,79,111058,0,0,0,79,111058,1999
WV,health,709,1563718,12,16056,968,714,1579774,1999
WV,hospitals,1615,2680316,91,88748,9524,1669,2769064,1999
WV,social insurance administration,808,1748274,26,23694,1856,819,1771968,1999
WV,solid waste management,11,29642,0,0,0,11,29642,1999
WV,sewage disposal,0,0,0,0,0,0,0,1999
WV,parks and recreation,421,675340,317,172056,28676,583,847396,1999
WV,housing and community development,0,0,0,0,0,0,0,1999
WV,natural resources,1869,4887037,169,80980,11602,1938,4968017,1999
WV,water transport and terminals,0,0,0,0,0,0,0,1999
WV,electric power,0,0,0,0,0,0,0,1999
WV,gas supply,0,0,0,0,0,0,0,1999
WV,transit,0,0,0,0,0,0,0,1999
WV,elem and sec instruction,0,0,0,0,0,0,0,1999
WV,elem and sec admin/cler,0,0,0,0,0,0,0,1999
WV,elem and sec oper/maint,0,0,0,0,0,0,0,1999
WV,elem and sec cafeteria,0,0,0,0,0,0,0,1999
WV,elem and sec bus transit,0,0,0,0,0,0,0,1999
WV,elem and sec health/rec,0,0,0,0,0,0,0,1999
WV,elem and sec student,0,0,0,0,0,0,0,1999
WV,elem and sec unalloc,0,0,0,0,0,0,0,1999
WV,higher ed - instructional,3300,14418052,3668,2657595,112317,3976,17075647,1999
WV,education - higher education other,6407,15286746,3964,1757684,221623,7738,17044430,1999
WV,education - other,1380,3552138,131,117402,10320,1442,3669540,1999
WV,libraries,0,0,0,0,0,0,0,1999
WV,liquor stores,55,117480,2,478,72,55,117958,1999
WV,other and unallocable,1811,4638703,88,51814,6178,1852,4690517,1999
WI,total,51907,183598806,23492,31085453,1995759,63185,214684259,1999
WI,financial administration,2346,7342323,1072,1112973,106986,2950,8455296,1999
WI,other government administration,1001,3435364,438,694886,33433,1191,4130250,1999
WI,judicial and legal,1799,9013558,318,702263,32249,1980,9715821,1999
WI,police arrest,567,1830218,0,0,0,567,1830218,1999
WI,police other,274,869282,31,32802,2723,289,902084,1999
WI,corrections,7392,20937700,802,1317063,84153,7869,22254763,1999
WI,streets and highways,1858,6491280,250,246861,20572,1974,6738141,1999
WI,air transportation,0,0,0,0,0,0,0,1999
WI,water transportation,0,0,0,0,0,0,0,1999
WI,public welfare,911,2650211,298,382568,29158,1076,3032779,1999
WI,health,1654,5944681,510,1187656,48197,1927,7132337,1999
WI,hospitals,3293,9236516,1308,1721734,110057,3914,10958250,1999
WI,social insurance administration,758,2265593,48,120885,7176,799,2386478,1999
WI,solid waste management,0,0,0,0,0,0,0,1999
WI,sewage disposal,0,0,0,0,0,0,0,1999
WI,parks and recreation,130,358624,115,113301,8473,178,471925,1999
WI,housing and community development,0,0,0,0,0,0,0,1999
WI,natural resources,2090,6402521,1157,1340251,105877,2689,7742772,1999
WI,water transport and terminals,0,0,0,0,0,0,0,1999
WI,electric power,0,0,0,0,0,0,0,1999
WI,gas supply,0,0,0,0,0,0,0,1999
WI,transit,0,0,0,0,0,0,0,1999
WI,elem and sec instruction,0,0,0,0,0,0,0,1999
WI,elem and sec admin/cler,0,0,0,0,0,0,0,1999
WI,elem and sec oper/maint,0,0,0,0,0,0,0,1999
WI,elem and sec cafeteria,0,0,0,0,0,0,0,1999
WI,elem and sec bus transit,0,0,0,0,0,0,0,1999
WI,elem and sec health/rec,0,0,0,0,0,0,0,1999
WI,elem and sec student,0,0,0,0,0,0,0,1999
WI,elem and sec unalloc,0,0,0,0,0,0,0,1999
WI,higher ed - instructional,7368,37999646,6567,8631411,499234,10189,46631057,1999
WI,education - higher education other,13797,46298566,8954,11269562,771340,18155,57568128,1999
WI,education - other,1085,3485816,316,413976,25011,1226,3899792,1999
WI,libraries,0,0,0,0,0,0,0,1999
WI,liquor stores,0,0,0,0,0,0,0,1999
WI,other and unallocable,5584,19036907,1308,1797261,111120,6212,20834168,1999
WY,total,9885,25121784,3621,2315467,207170,11056,27437251,1999
WY,financial administration,460,1185563,3,2889,274,462,1188452,1999
WY,other government administration,88,260608,169,105072,4113,110,365680,1999
WY,judicial and legal,380,1169518,42,59298,3998,403,1228816,1999
WY,police arrest,107,322184,0,0,0,107,322184,1999
WY,police other,76,222827,0,0,0,76,222827,1999
WY,corrections,742,1609126,5,6233,574,745,1615359,1999
WY,streets and highways,1731,4224723,132,144658,18100,1833,4369381,1999
WY,air transportation,0,0,0,0,0,0,0,1999
WY,water transportation,0,0,0,0,0,0,0,1999
WY,public welfare,739,1640619,75,91548,7849,783,1732167,1999
WY,health,472,1245586,89,166959,12674,544,1412545,1999
WY,hospitals,981,1830884,9,1440,152,982,1832324,1999
WY,social insurance administration,307,739148,28,38038,3348,326,777186,1999
WY,solid waste management,0,0,0,0,0,0,0,1999
WY,sewage disposal,0,0,0,0,0,0,0,1999
WY,parks and recreation,106,256744,7,6404,690,110,263148,1999
WY,housing and community development,0,0,0,0,0,0,0,1999
WY,natural resources,639,1770214,22,22399,2045,651,1792613,1999
WY,water transport and terminals,0,0,0,0,0,0,0,1999
WY,electric power,0,0,0,0,0,0,0,1999
WY,gas supply,0,0,0,0,0,0,0,1999
WY,transit,0,0,0,0,0,0,0,1999
WY,elem and sec instruction,0,0,0,0,0,0,0,1999
WY,elem and sec admin/cler,0,0,0,0,0,0,0,1999
WY,elem and sec oper/maint,0,0,0,0,0,0,0,1999
WY,elem and sec cafeteria,0,0,0,0,0,0,0,1999
WY,elem and sec bus transit,0,0,0,0,0,0,0,1999
WY,elem and sec health/rec,0,0,0,0,0,0,0,1999
WY,elem and sec student,0,0,0,0,0,0,0,1999
WY,elem and sec unalloc,0,0,0,0,0,0,0,1999
WY,higher ed - instructional,770,3204561,775,702150,44808,1023,3906711,1999
WY,education - higher education other,1486,3477240,2205,914743,103830,2073,4391983,1999
WY,education - other,141,373458,16,12645,1355,149,386103,1999
WY,libraries,0,0,0,0,0,0,0,1999
WY,liquor stores,32,52464,0,0,0,32,52464,1999
WY,other and unallocable,628,1536317,44,40991,3360,647,1577308,1999
