state,year,government_function,full_time_employees,full_time_pay,part_time_employees,part_time_pay,part_time_hours,full_time_equivalent_employees,total_march_full_time_and_part_time_employees,total_march_pay
US,2012,total,3729145,18050780015,1555879,2118108335,102091754,4314932,5285024,20168888350
US,2012,financial administration,154737,705568998,9123,18589999,920660,160035,163860,724158997
US,2012,other government administration,46577,219493231,10336,22381486,889221,51701,56913,241874717
US,2012,judicial and legal,167998,894175884,8951,21169693,780989,172456,176949,915345577
US,2012,police protection total,99924,556626317,2791,4478818,203304,101086,102715,561105135
US,2012,police protection - officers,63340,405837819,607,898190,30459,63514,63947,406736009
US,2012,police protection - other,36584,150788498,2184,3580628,172845,37572,38768,154369126
US,2012,fire protection total,0,0,0,0,0,0,0,0
US,2012,fire protection - firefighters,0,0,0,0,0,0,0,0
US,2012,fire protection - other,0,0,0,0,0,0,0,0
US,2012,corrections,443384,1863624512,8991,24598549,896594,448489,452375,1888223061
US,2012,highways,213918,965981808,10472,24332279,1024017,219855,224390,990314087
US,2012,air transportation,3109,16453186,65,132376,5550,3140,3174,16585562
US,2012,water transport and terminals,4633,25030255,122,261800,11727,4702,4755,25292055
US,2012,public welfare,222411,851020329,11394,25551930,1230583,229463,233805,876572259
US,2012,health,175604,772002558,15621,35589379,1358772,183378,191225,807591937
US,2012,hospitals,355972,1653098566,76495,265858649,8100355,402158,432467,1918957215
US,2012,social insurance administration,80141,341300329,7381,16699825,846630,85054,87522,358000154
US,2012,solid waste management,2242,12809974,95,181905,9109,2297,2337,12991879
US,2012,sewerage,1618,9631705,43,202350,3528,1639,1661,9834055
US,2012,parks and recreation,29866,106235064,10285,13573744,953365,35340,40151,119808808
US,2012,housing and community development,477,2327109,72,185382,9576,531,549,2512491
US,2012,natural resources,121274,533111515,24321,36788078,2139305,133541,145595,569899593
US,2012,water transport and terminals,753,4155719,29,82093,2257,766,782,4237812
US,2012,electric power,4083,27534127,51,163843,5617,4115,4134,27697970
US,2012,gas supply,0,0,0,0,0,0,0,0
US,2012,transit,30834,181945613,1616,3054720,157550,31725,32450,185000333
US,2012,education total,1388982,7469129048,1339234,1572860951,80985624,1853886,2728216,9041989999
US,2012,education - elementary and secondary total,41234,201939850,17253,18589294,832755,46354,58487,220529144
US,2012,education - elementary and secondary instructional,30533,165021630,12734,13225788,606645,34233,43267,178247418
US,2012,education - elementary and secondary other,10701,36918220,4519,5363506,226110,12121,15220,42281726
US,2012,education - higher education total,1267834,6912395753,1308463,1531000144,79089689,1721521,2576297,8443395897
US,2012,education - higher education instructional,406257,3047603468,427886,746638441,27479075,564188,834143,3794241909
US,2012,education - higher education other,861577,3864792285,880577,784361703,51610614,1157333,1742154,4649153988
US,2012,education - other,79914,354793445,13518,23271513,1063180,86011,93432,378064958
US,2012,libraries,500,1716434,220,219044,17392,598,720,1935478
US,2012,liquor stores,6703,22176390,4839,7233229,462036,9410,11542,29409619
US,2012,other and unallocable,173405,815631344,13332,23918213,1077993,179567,186737,839549557
AL,2012,total,78928,330807555,30228,29779480,1722192,88902,109156,360587035
AL,2012,financial administration,2446,10674543,61,102014,5476,2477,2507,10776557
AL,2012,other government administration,523,2682953,127,196311,10247,580,650,2879264
AL,2012,judicial and legal,3062,14112752,208,337204,23864,3197,3270,14449956
AL,2012,police protection total,1458,5566626,0,0,0,1458,1458,5566626
AL,2012,police protection - officers,757,3392584,0,0,0,757,757,3392584
AL,2012,police protection - other,701,2174042,0,0,0,701,701,2174042
AL,2012,fire protection total,0,0,0,0,0,0,0,0
AL,2012,fire protection - firefighters,0,0,0,0,0,0,0,0
AL,2012,fire protection - other,0,0,0,0,0,0,0,0
AL,2012,corrections,5085,16378048,83,186044,9750,5140,5168,16564092
AL,2012,highways,4386,15100808,71,51122,5680,4418,4457,15151930
AL,2012,air transportation,0,0,0,0,0,0,0,0
AL,2012,water transport and terminals,580,2771697,1,1650,80,580,581,2773347
AL,2012,public welfare,4025,13767712,95,163904,8092,4071,4120,13931616
AL,2012,health,5576,20154936,279,366548,33934,5768,5855,20521484
AL,2012,hospitals,10930,46301559,1558,3255743,126092,11678,12488,49557302
AL,2012,social insurance administration,877,3237568,63,89146,8902,927,940,3326714
AL,2012,solid waste management,0,0,0,0,0,0,0,0
AL,2012,sewerage,0,0,0,0,0,0,0,0
AL,2012,parks and recreation,380,1017556,243,235632,28308,540,623,1253188
AL,2012,housing and community development,0,0,0,0,0,0,0,0
AL,2012,natural resources,1940,7539212,116,142619,10251,1999,2056,7681831
AL,2012,water transport and terminals,0,0,0,0,0,0,0,0
AL,2012,electric power,0,0,0,0,0,0,0,0
AL,2012,gas supply,0,0,0,0,0,0,0,0
AL,2012,transit,0,0,0,0,0,0,0,0
AL,2012,education total,34911,161296133,26813,24027849,1395257,43003,61724,185323982
AL,2012,education - elementary and secondary total,0,0,0,0,0,0,0,0
AL,2012,education - elementary and secondary instructional,0,0,0,0,0,0,0,0
AL,2012,education - elementary and secondary other,0,0,0,0,0,0,0,0
AL,2012,education - higher education total,32017,150233877,26657,23872837,1389139,40075,58674,174106714
AL,2012,education - higher education instructional,9805,61917328,9860,11797015,495490,12676,19665,73714343
AL,2012,education - higher education other,22212,88316549,16797,12075822,893649,27399,39009,100392371
AL,2012,education - other,2894,11062256,156,155012,6118,2928,3050,11217268
AL,2012,libraries,0,0,0,0,0,0,0,0
AL,2012,liquor stores,734,1948940,10,14782,872,739,744,1963722
AL,2012,other and unallocable,2015,8256512,500,608912,55387,2327,2515,8865424
AK,2012,total,24859,135514230,5809,7879201,407661,27230,30668,143393431
AK,2012,financial administration,1094,6266256,27,48112,2249,1109,1121,6314368
AK,2012,other government administration,808,4327814,49,87628,3768,831,857,4415442
AK,2012,judicial and legal,1456,8783182,55,152448,4460,1483,1511,8935630
AK,2012,police protection total,647,4157356,44,22550,1348,655,691,4179906
AK,2012,police protection - officers,302,2519398,0,0,0,302,302,2519398
AK,2012,police protection - other,345,1637958,44,22550,1348,353,389,1660508
AK,2012,fire protection total,0,0,0,0,0,0,0,0
AK,2012,fire protection - firefighters,0,0,0,0,0,0,0,0
AK,2012,fire protection - other,0,0,0,0,0,0,0,0
AK,2012,corrections,1894,9858134,58,135630,6291,1932,1952,9993764
AK,2012,highways,3162,18143816,44,81346,4774,3191,3206,18225162
AK,2012,air transportation,0,0,0,0,0,0,0,0
AK,2012,water transport and terminals,0,0,0,0,0,0,0,0
AK,2012,public welfare,1784,8082962,127,213066,19926,1904,1911,8296028
AK,2012,health,720,4015826,14,25354,1166,728,734,4041180
AK,2012,hospitals,228,1186416,29,82876,2587,244,257,1269292
AK,2012,social insurance administration,408,1875456,7,15128,644,412,415,1890584
AK,2012,solid waste management,0,0,0,0,0,0,0,0
AK,2012,sewerage,0,0,0,0,0,0,0,0
AK,2012,parks and recreation,100,487744,5,8646,344,102,105,496390
AK,2012,housing and community development,0,0,0,0,0,0,0,0
AK,2012,natural resources,2378,12711462,115,238968,8665,2429,2493,12950430
AK,2012,water transport and terminals,0,0,0,0,0,0,0,0
AK,2012,electric power,0,0,0,0,0,0,0,0
AK,2012,gas supply,0,0,0,0,0,0,0,0
AK,2012,transit,0,0,0,0,0,0,0,0
AK,2012,education total,7330,38945973,5176,6699061,347547,9335,12506,45645034
AK,2012,education - elementary and secondary total,2629,11366897,1096,1503963,85872,3154,3725,12870860
AK,2012,education - elementary and secondary instructional,1991,9036637,549,709752,40655,2239,2540,9746389
AK,2012,education - elementary and secondary other,638,2330260,547,794211,45217,915,1185,3124471
AK,2012,education - higher education total,4447,26191444,4035,5151862,259219,5912,8482,31343306
AK,2012,education - higher education instructional,1488,11615109,1136,1397290,57343,1812,2624,13012399
AK,2012,education - higher education other,2959,14576335,2899,3754572,201876,4100,5858,18330907
AK,2012,education - other,254,1387632,45,43236,2456,269,299,1430868
AK,2012,libraries,0,0,0,0,0,0,0,0
AK,2012,liquor stores,0,0,0,0,0,0,0,0
AK,2012,other and unallocable,2850,16671833,59,68388,3892,2875,2909,16740221
AZ,2012,total,64965,290859404,28060,31804553,2049228,76547,93025,322663957
AZ,2012,financial administration,2726,10567451,40,104773,4362,2751,2766,10672224
AZ,2012,other government administration,745,2882385,87,162054,4734,774,832,3044439
AZ,2012,judicial and legal,2066,9483359,78,248953,7830,2111,2144,9732312
AZ,2012,police protection total,1828,9322149,42,94579,3286,1847,1870,9416728
AZ,2012,police protection - officers,1079,6044555,0,0,0,1079,1079,6044555
AZ,2012,police protection - other,749,3277594,42,94579,3286,768,791,3372173
AZ,2012,fire protection total,0,0,0,0,0,0,0,0
AZ,2012,fire protection - firefighters,0,0,0,0,0,0,0,0
AZ,2012,fire protection - other,0,0,0,0,0,0,0,0
AZ,2012,corrections,10548,37554693,26,99595,2734,10564,10574,37654288
AZ,2012,highways,2791,11500404,28,62279,2325,2804,2819,11562683
AZ,2012,air transportation,0,0,0,0,0,0,0,0
AZ,2012,water transport and terminals,0,0,0,0,0,0,0,0
AZ,2012,public welfare,5462,18203215,116,304146,11756,5529,5578,18507361
AZ,2012,health,2323,9091981,48,125431,5182,2352,2371,9217412
AZ,2012,hospitals,6240,29133457,1122,3668884,123750,6939,7362,32802341
AZ,2012,social insurance administration,1911,5578605,63,91213,6512,1948,1974,5669818
AZ,2012,solid waste management,0,0,0,0,0,0,0,0
AZ,2012,sewerage,0,0,0,0,0,0,0,0
AZ,2012,parks and recreation,311,811401,2,3211,88,311,313,814612
AZ,2012,housing and community development,0,0,0,0,0,0,0,0
AZ,2012,natural resources,1428,5724773,205,300543,19497,1538,1633,6025316
AZ,2012,water transport and terminals,0,0,0,0,0,0,0,0
AZ,2012,electric power,8,60184,0,0,0,8,8,60184
AZ,2012,gas supply,0,0,0,0,0,0,0,0
AZ,2012,transit,0,0,0,0,0,0,0,0
AZ,2012,education total,23508,128639816,26065,26295627,1846972,33942,49573,154935443
AZ,2012,education - elementary and secondary total,0,0,0,0,0,0,0,0
AZ,2012,education - elementary and secondary instructional,0,0,0,0,0,0,0,0
AZ,2012,education - elementary and secondary other,0,0,0,0,0,0,0,0
AZ,2012,education - higher education total,20303,117584545,25773,25881490,1822001,30596,46076,143466035
AZ,2012,education - higher education instructional,6707,50918011,9487,11452086,654299,10403,16194,62370097
AZ,2012,education - higher education other,13596,66666534,16286,14429404,1167702,20193,29882,81095938
AZ,2012,education - other,3205,11055271,292,414137,24971,3346,3497,11469408
AZ,2012,libraries,0,0,0,0,0,0,0,0
AZ,2012,liquor stores,0,0,0,0,0,0,0,0
AZ,2012,other and unallocable,3070,12305531,138,243265,10200,3129,3208,12548796
AR,2012,total,57973,229598791,16286,15556856,1018596,63732,74259,245155647
AR,2012,financial administration,2003,7231466,14,19714,1736,2013,2017,7251180
AR,2012,other government administration,767,3397751,133,182797,9906,823,900,3580548
AR,2012,judicial and legal,1294,4864243,148,421474,12310,1364,1442,5285717
AR,2012,police protection total,1230,4629315,10,13671,939,1235,1240,4642986
AR,2012,police protection - officers,565,2458816,0,0,0,565,565,2458816
AR,2012,police protection - other,665,2170499,10,13671,939,670,675,2184170
AR,2012,fire protection total,0,0,0,0,0,0,0,0
AR,2012,fire protection - firefighters,0,0,0,0,0,0,0,0
AR,2012,fire protection - other,0,0,0,0,0,0,0,0
AR,2012,corrections,5308,18135310,8,9583,702,5312,5316,18144893
AR,2012,highways,3404,12498334,33,54648,3558,3424,3437,12552982
AR,2012,air transportation,0,0,0,0,0,0,0,0
AR,2012,water transport and terminals,0,0,0,0,0,0,0,0
AR,2012,public welfare,3931,12438272,60,70203,5278,3961,3991,12508475
AR,2012,health,3934,14894692,98,252228,10302,3993,4032,15146920
AR,2012,hospitals,6420,23773515,506,943531,59857,6757,6926,24717046
AR,2012,social insurance administration,1628,5487795,0,0,0,1628,1628,5487795
AR,2012,solid waste management,0,0,0,0,0,0,0,0
AR,2012,sewerage,0,0,0,0,0,0,0,0
AR,2012,parks and recreation,1031,2351707,4,1805,354,1033,1035,2353512
AR,2012,housing and community development,0,0,0,0,0,0,0,0
AR,2012,natural resources,1892,6611427,388,312278,26666,2043,2280,6923705
AR,2012,water transport and terminals,0,0,0,0,0,0,0,0
AR,2012,electric power,0,0,0,0,0,0,0,0
AR,2012,gas supply,0,0,0,0,0,0,0,0
AR,2012,transit,0,0,0,0,0,0,0,0
AR,2012,education total,22497,103581556,14837,13215652,883769,27493,37334,116797208
AR,2012,education - elementary and secondary total,0,0,0,0,0,0,0,0
AR,2012,education - elementary and secondary instructional,0,0,0,0,0,0,0,0
AR,2012,education - elementary and secondary other,0,0,0,0,0,0,0,0
AR,2012,education - higher education total,21109,98337314,14817,13178019,882099,26095,35926,111515333
AR,2012,education - higher education instructional,6761,46068941,5258,6897962,306051,8491,12019,52966903
AR,2012,education - higher education other,14348,52268373,9559,6280057,576048,17604,23907,58548430
AR,2012,education - other,1388,5244242,20,37633,1670,1398,1408,5281875
AR,2012,libraries,0,0,0,0,0,0,0,0
AR,2012,liquor stores,0,0,0,0,0,0,0,0
AR,2012,other and unallocable,2634,9703408,47,59272,3219,2653,2681,9762680
CA,2012,total,329267,2092256686,156625,337329898,12233416,398393,485892,2429586584
CA,2012,financial administration,23483,113539168,2720,5142668,289416,25118,26203,118681836
CA,2012,other government administration,3664,20714938,313,924146,30890,3851,3977,21639084
CA,2012,judicial and legal,5822,38434351,418,1314296,37402,6033,6240,39748647
CA,2012,police protection total,11003,78394102,112,183870,6759,11041,11115,78577972
CA,2012,police protection - officers,7803,65365434,59,66164,1494,7811,7862,65431598
CA,2012,police protection - other,3200,13028668,53,117706,5265,3230,3253,13146374
CA,2012,fire protection total,0,0,0,0,0,0,0,0
CA,2012,fire protection - firefighters,0,0,0,0,0,0,0,0
CA,2012,fire protection - other,0,0,0,0,0,0,0,0
CA,2012,corrections,54168,361088047,2598,9680789,309228,55915,56766,370768836
CA,2012,highways,19460,146307175,961,3465963,138059,20240,20421,149773138
CA,2012,air transportation,0,0,0,0,0,0,0,0
CA,2012,water transport and terminals,0,0,0,0,0,0,0,0
CA,2012,public welfare,3602,16820388,383,805436,24131,3738,3985,17625824
CA,2012,health,12189,74151406,1378,4176613,123555,12887,13567,78328019
CA,2012,hospitals,29822,220862555,17565,101573315,2223046,42381,47387,322435870
CA,2012,social insurance administration,14767,71617118,1751,4385511,192598,15855,16518,76002629
CA,2012,solid waste management,564,3192236,37,104973,3461,584,601,3297209
CA,2012,sewerage,0,0,0,0,0,0,0,0
CA,2012,parks and recreation,2283,11485269,1868,2834170,186913,3339,4151,14319439
CA,2012,housing and community development,0,0,0,0,0,0,0,0
CA,2012,natural resources,12892,73582555,2902,5468395,372744,15001,15794,79050950
CA,2012,water transport and terminals,0,0,0,0,0,0,0,0
CA,2012,electric power,0,0,0,0,0,0,0,0
CA,2012,gas supply,0,0,0,0,0,0,0,0
CA,2012,transit,0,0,0,0,0,0,0,0
CA,2012,education total,116232,750874920,121573,192403363,8135096,162192,237805,943278283
CA,2012,education - elementary and secondary total,0,0,0,0,0,0,0,0
CA,2012,education - elementary and secondary instructional,0,0,0,0,0,0,0,0
CA,2012,education - elementary and secondary other,0,0,0,0,0,0,0,0
CA,2012,education - higher education total,112282,730944075,120950,191224131,8081503,157940,233232,922168206
CA,2012,education - higher education instructional,24293,215425743,29979,57373708,1974612,35449,54272,272799451
CA,2012,education - higher education other,87989,515518332,90971,133850423,6106891,122491,178960,649368755
CA,2012,education - other,3950,19930845,623,1179232,53593,4252,4573,21110077
CA,2012,libraries,0,0,0,0,0,0,0,0
CA,2012,liquor stores,0,0,0,0,0,0,0,0
CA,2012,other and unallocable,19316,111192458,2046,4866390,160118,20218,21362,116058848
CO,2012,total,55338,283633738,46162,79089010,3292191,73944,101500,362722748
CO,2012,financial administration,1898,9431834,101,260887,10128,1956,1999,9692721
CO,2012,other government administration,434,1870573,173,465684,22998,564,607,2336257
CO,2012,judicial and legal,4165,20883876,595,1613296,60714,4508,4760,22497172
CO,2012,police protection total,1218,6694422,17,39000,1390,1226,1235,6733422
CO,2012,police protection - officers,754,4558124,0,0,0,754,754,4558124
CO,2012,police protection - other,464,2136298,17,39000,1390,472,481,2175298
CO,2012,fire protection total,0,0,0,0,0,0,0,0
CO,2012,fire protection - firefighters,0,0,0,0,0,0,0,0
CO,2012,fire protection - other,0,0,0,0,0,0,0,0
CO,2012,corrections,7224,30144926,60,235289,8043,7270,7284,30380215
CO,2012,highways,2948,13647770,165,437613,20126,3062,3113,14085383
CO,2012,air transportation,0,0,0,0,0,0,0,0
CO,2012,water transport and terminals,0,0,0,0,0,0,0,0
CO,2012,public welfare,1937,8562257,358,909411,38293,2154,2295,9471668
CO,2012,health,1186,6494606,147,436701,15072,1271,1333,6931307
CO,2012,hospitals,4624,18397406,980,4440333,142317,5428,5604,22837739
CO,2012,social insurance administration,869,4103060,210,548844,22546,996,1079,4651904
CO,2012,solid waste management,0,0,0,0,0,0,0,0
CO,2012,sewerage,0,0,0,0,0,0,0,0
CO,2012,parks and recreation,875,4229582,236,346798,20704,992,1111,4576380
CO,2012,housing and community development,0,0,0,0,0,0,0,0
CO,2012,natural resources,949,4978233,209,470356,18491,1053,1158,5448589
CO,2012,water transport and terminals,0,0,0,0,0,0,0,0
CO,2012,electric power,0,0,0,0,0,0,0,0
CO,2012,gas supply,0,0,0,0,0,0,0,0
CO,2012,transit,0,0,0,0,0,0,0,0
CO,2012,education total,24725,142094123,42848,68691417,2901852,41123,67573,210785540
CO,2012,education - elementary and secondary total,0,0,0,0,0,0,0,0
CO,2012,education - elementary and secondary instructional,0,0,0,0,0,0,0,0
CO,2012,education - elementary and secondary other,0,0,0,0,0,0,0,0
CO,2012,education - higher education total,23725,137097309,41692,67068242,2834942,39745,65417,204165551
CO,2012,education - higher education instructional,8776,69003034,15164,37406314,1379846,16572,23940,106409348
CO,2012,education - higher education other,14949,68094275,26528,29661928,1455096,23173,41477,97756203
CO,2012,education - other,1000,4996814,1156,1623175,66910,1378,2156,6619989
CO,2012,libraries,0,0,0,0,0,0,0,0
CO,2012,liquor stores,0,0,0,0,0,0,0,0
CO,2012,other and unallocable,2286,12101070,63,193381,9517,2341,2349,12294451
CT,2012,total,52301,308837621,25710,41473123,1542449,61499,78011,350310744
CT,2012,financial administration,2193,11828300,110,303917,11538,2260,2303,12132217
CT,2012,other government administration,1337,7065084,246,836733,27035,1491,1583,7901817
CT,2012,judicial and legal,5825,32302307,383,1045458,16432,5917,6208,33347765
CT,2012,police protection total,1843,13033401,230,147487,5323,1873,2073,13180888
CT,2012,police protection - officers,1202,9456311,0,0,0,1202,1202,9456311
CT,2012,police protection - other,641,3577090,230,147487,5323,671,871,3724577
CT,2012,fire protection total,0,0,0,0,0,0,0,0
CT,2012,fire protection - firefighters,0,0,0,0,0,0,0,0
CT,2012,fire protection - other,0,0,0,0,0,0,0,0
CT,2012,corrections,5718,34086373,82,339586,8195,5765,5800,34425959
CT,2012,highways,3038,14514406,7,22911,729,3042,3045,14537317
CT,2012,air transportation,152,842795,0,0,0,152,152,842795
CT,2012,water transport and terminals,0,0,0,0,0,0,0,0
CT,2012,public welfare,5238,28933502,368,1528876,53535,5542,5606,30462378
CT,2012,health,3636,19531528,606,1957072,51884,3931,4242,21488600
CT,2012,hospitals,5099,31506874,1890,7815813,239088,6456,6989,39322687
CT,2012,social insurance administration,687,3891062,3,9167,354,689,690,3900229
CT,2012,solid waste management,47,326038,3,8762,432,50,50,334800
CT,2012,sewerage,0,0,0,0,0,0,0,0
CT,2012,parks and recreation,163,792668,21,33879,1499,171,184,826547
CT,2012,housing and community development,0,0,0,0,0,0,0,0
CT,2012,natural resources,658,3530521,108,209819,7763,702,766,3740340
CT,2012,water transport and terminals,0,0,0,0,0,0,0,0
CT,2012,electric power,0,0,0,0,0,0,0,0
CT,2012,gas supply,0,0,0,0,0,0,0,0
CT,2012,transit,0,0,0,0,0,0,0,0
CT,2012,education total,14284,92653633,21243,26634146,1093653,20934,35527,119287779
CT,2012,education - elementary and secondary total,0,0,0,0,0,0,0,0
CT,2012,education - elementary and secondary instructional,0,0,0,0,0,0,0,0
CT,2012,education - elementary and secondary other,0,0,0,0,0,0,0,0
CT,2012,education - higher education total,12055,80098901,20225,24256175,1006690,18213,32280,104355076
CT,2012,education - higher education instructional,4484,36133998,7924,14672930,441652,7205,12408,50806928
CT,2012,education - higher education other,7571,43964903,12301,9583245,565038,11008,19872,53548148
CT,2012,education - other,2229,12554732,1018,2377971,86963,2721,3247,14932703
CT,2012,libraries,0,0,0,0,0,0,0,0
CT,2012,liquor stores,0,0,0,0,0,0,0,0
CT,2012,other and unallocable,2383,13999129,410,579497,24989,2524,2793,14578626
DE,2012,total,23291,101638353,8552,11673816,546612,26588,31843,113312169
DE,2012,financial administration,817,2724821,14,17112,1127,825,831,2741933
DE,2012,other government administration,379,1627492,95,139862,7218,423,474,1767354
DE,2012,judicial and legal,1732,7972142,56,106414,5185,1762,1788,8078556
DE,2012,police protection total,1003,6494119,11,26669,1364,1012,1014,6520788
DE,2012,police protection - officers,746,5284074,0,0,0,746,746,5284074
DE,2012,police protection - other,257,1210045,11,26669,1364,266,268,1236714
DE,2012,fire protection total,0,0,0,0,0,0,0,0
DE,2012,fire protection - firefighters,0,0,0,0,0,0,0,0
DE,2012,fire protection - other,0,0,0,0,0,0,0,0
DE,2012,corrections,2855,11305756,40,56028,3910,2879,2895,11361784
DE,2012,highways,1536,5102888,0,0,0,1536,1536,5102888
DE,2012,air transportation,0,0,0,0,0,0,0,0
DE,2012,water transport and terminals,273,1114627,0,0,0,273,273,1114627
DE,2012,public welfare,1561,5351617,71,126433,7237,1604,1632,5478050
DE,2012,health,2030,7660636,150,300292,15533,2122,2180,7960928
DE,2012,hospitals,1463,5043409,96,113852,7929,1512,1559,5157261
DE,2012,social insurance administration,321,1067345,18,28321,1317,329,339,1095666
DE,2012,solid waste management,123,487225,18,27617,2137,136,141,514842
DE,2012,sewerage,0,0,0,0,0,0,0,0
DE,2012,parks and recreation,305,782540,29,24204,1790,316,334,806744
DE,2012,housing and community development,0,0,0,0,0,0,0,0
DE,2012,natural resources,483,1877050,102,116880,7998,532,585,1993930
DE,2012,water transport and terminals,0,0,0,0,0,0,0,0
DE,2012,electric power,0,0,0,0,0,0,0,0
DE,2012,gas supply,0,0,0,0,0,0,0,0
DE,2012,transit,848,3454005,4,10529,523,851,852,3464534
DE,2012,education total,5947,33064255,7628,10384583,472337,8794,13575,43448838
DE,2012,education - elementary and secondary total,0,0,0,0,0,0,0,0
DE,2012,education - elementary and secondary instructional,0,0,0,0,0,0,0,0
DE,2012,education - elementary and secondary other,0,0,0,0,0,0,0,0
DE,2012,education - higher education total,5604,31056491,7602,10339982,470131,8437,13206,41396473
DE,2012,education - higher education instructional,1518,12225925,3519,6245005,211057,2790,5037,18470930
DE,2012,education - higher education other,4086,18830566,4083,4094977,259074,5647,8169,22925543
DE,2012,education - other,343,2007764,26,44601,2206,357,369,2052365
DE,2012,libraries,0,0,0,0,0,0,0,0
DE,2012,liquor stores,0,0,0,0,0,0,0,0
DE,2012,other and unallocable,1615,6508426,220,195020,11007,1682,1835,6703446
FL,2012,total,164556,663479824,45869,55733395,2939288,181234,210425,719213219
FL,2012,financial administration,6260,21125488,167,197517,13705,6338,6427,21323005
FL,2012,other government administration,1968,8425670,179,216987,14845,2052,2147,8642657
FL,2012,judicial and legal,18860,75561174,728,1206635,63711,19222,19588,76767809
FL,2012,police protection total,4110,15609839,579,643519,23065,4242,4689,16253358
FL,2012,police protection - officers,2225,9210355,385,445933,12064,2294,2610,9656288
FL,2012,police protection - other,1885,6399484,194,197586,11001,1948,2079,6597070
FL,2012,fire protection total,0,0,0,0,0,0,0,0
FL,2012,fire protection - firefighters,0,0,0,0,0,0,0,0
FL,2012,fire protection - other,0,0,0,0,0,0,0,0
FL,2012,corrections,26279,81550180,246,333775,13665,26356,26525,81883955
FL,2012,highways,6741,27672560,16,17119,1242,6748,6757,27689679
FL,2012,air transportation,0,0,0,0,0,0,0,0
FL,2012,water transport and terminals,0,0,0,0,0,0,0,0
FL,2012,public welfare,9158,27025271,305,324754,23417,9291,9463,27350025
FL,2012,health,18621,59838997,1154,2465466,121496,19308,19775,62304463
FL,2012,hospitals,4137,13296044,54,100679,4615,4163,4191,13396723
FL,2012,social insurance administration,2548,8504064,6,10664,560,2551,2554,8514728
FL,2012,solid waste management,0,0,0,0,0,0,0,0
FL,2012,sewerage,0,0,0,0,0,0,0,0
FL,2012,parks and recreation,1254,3060088,265,268864,16801,1349,1519,3328952
FL,2012,housing and community development,0,0,0,0,0,0,0,0
FL,2012,natural resources,7935,26442152,752,831208,62897,8291,8687,27273360
FL,2012,water transport and terminals,0,0,0,0,0,0,0,0
FL,2012,electric power,0,0,0,0,0,0,0,0
FL,2012,gas supply,0,0,0,0,0,0,0,0
FL,2012,transit,620,2679884,77,147507,11993,688,697,2827391
FL,2012,education total,49684,271659676,40929,48495443,2535212,64073,90613,320155119
FL,2012,education - elementary and secondary total,0,0,0,0,0,0,0,0
FL,2012,education - elementary and secondary instructional,0,0,0,0,0,0,0,0
FL,2012,education - elementary and secondary other,0,0,0,0,0,0,0,0
FL,2012,education - higher education total,46760,261631249,40647,48270984,2521395,61070,87407,309902233
FL,2012,education - higher education instructional,13629,129554218,14726,26787780,1131625,20041,28355,156341998
FL,2012,education - higher education other,33131,132077031,25921,21483204,1389770,41029,59052,153560235
FL,2012,education - other,2924,10028427,282,224459,13817,3003,3206,10252886
FL,2012,libraries,0,0,0,0,0,0,0,0
FL,2012,liquor stores,0,0,0,0,0,0,0,0
FL,2012,other and unallocable,6381,21028737,412,473258,32064,6562,6793,21501995
GA,2012,total,113151,448700292,47101,46799137,2891277,129502,160252,495499429
GA,2012,financial administration,3052,12149888,103,196244,8241,3099,3155,12346132
GA,2012,other government administration,1189,4339733,72,33769,1184,1196,1261,4373502
GA,2012,judicial and legal,3670,16022156,16,48702,1480,3677,3686,16070858
GA,2012,police protection total,2986,10071942,57,90074,6279,3021,3043,10162016
GA,2012,police protection - officers,1753,5806522,3,4198,208,1754,1756,5810720
GA,2012,police protection - other,1233,4265420,54,85876,6071,1267,1287,4351296
GA,2012,fire protection total,0,0,0,0,0,0,0,0
GA,2012,fire protection - firefighters,0,0,0,0,0,0,0,0
GA,2012,fire protection - other,0,0,0,0,0,0,0,0
GA,2012,corrections,16862,44424926,305,794668,28656,17024,17167,45219594
GA,2012,highways,4806,15316718,35,16186,716,4810,4841,15332904
GA,2012,air transportation,2,8426,0,0,0,2,2,8426
GA,2012,water transport and terminals,992,6282998,0,0,0,992,992,6282998
GA,2012,public welfare,6675,21064533,115,91712,2582,6690,6790,21156245
GA,2012,health,3803,15317134,109,168406,7353,3844,3912,15485540
GA,2012,hospitals,7657,27238376,298,786374,40724,7887,7955,28024750
GA,2012,social insurance administration,1837,5413022,55,61370,4040,1860,1892,5474392
GA,2012,solid waste management,0,0,0,0,0,0,0,0
GA,2012,sewerage,0,0,0,0,0,0,0,0
GA,2012,parks and recreation,2250,7275040,932,1183873,128162,2975,3182,8458913
GA,2012,housing and community development,0,0,0,0,0,0,0,0
GA,2012,natural resources,4572,16018554,1191,1305158,91773,5090,5763,17323712
GA,2012,water transport and terminals,0,0,0,0,0,0,0,0
GA,2012,electric power,0,0,0,0,0,0,0,0
GA,2012,gas supply,0,0,0,0,0,0,0,0
GA,2012,transit,0,0,0,0,0,0,0,0
GA,2012,education total,49813,236681669,43599,41834691,2557919,64281,93412,278516360
GA,2012,education - elementary and secondary total,0,0,0,0,0,0,0,0
GA,2012,education - elementary and secondary instructional,0,0,0,0,0,0,0,0
GA,2012,education - elementary and secondary other,0,0,0,0,0,0,0,0
GA,2012,education - higher education total,47033,223832666,43407,41495664,2541596,61408,90440,265328330
GA,2012,education - higher education instructional,14193,89896639,16665,22665456,968278,19671,30858,112562095
GA,2012,education - higher education other,32840,133936027,26742,18830208,1573318,41737,59582,152766235
GA,2012,education - other,2780,12849003,192,339027,16323,2873,2972,13188030
GA,2012,libraries,0,0,0,0,0,0,0,0
GA,2012,liquor stores,0,0,0,0,0,0,0,0
GA,2012,other and unallocable,2985,11075177,214,187910,12168,3054,3199,11263087
HI,2012,total,51888,216628732,20205,19306328,919085,57293,72093,235935060
HI,2012,financial administration,638,2405868,2,4412,198,639,640,2410280
HI,2012,other government administration,644,2646565,167,284781,11254,707,811,2931346
HI,2012,judicial and legal,2447,10614719,58,139262,3683,2467,2505,10753981
HI,2012,police protection total,0,0,0,0,0,0,0,0
HI,2012,police protection - officers,0,0,0,0,0,0,0,0
HI,2012,police protection - other,0,0,0,0,0,0,0,0
HI,2012,fire protection total,0,0,0,0,0,0,0,0
HI,2012,fire protection - firefighters,0,0,0,0,0,0,0,0
HI,2012,fire protection - other,0,0,0,0,0,0,0,0
HI,2012,corrections,2260,9739471,11,45428,817,2264,2271,9784899
HI,2012,highways,847,3720324,15,11948,1172,854,862,3732272
HI,2012,air transportation,939,3778726,10,15922,760,943,949,3794648
HI,2012,water transport and terminals,197,779022,0,0,0,197,197,779022
HI,2012,public welfare,389,1514914,32,19558,2436,403,421,1534472
HI,2012,health,1904,8565488,49,118070,4144,1927,1953,8683558
HI,2012,hospitals,4198,20181817,685,2123937,60281,4539,4883,22305754
HI,2012,social insurance administration,284,1058550,21,37462,1670,293,305,1096012
HI,2012,solid waste management,0,0,0,0,0,0,0,0
HI,2012,sewerage,0,0,0,0,0,0,0,0
HI,2012,parks and recreation,131,464418,511,104814,6896,170,642,569232
HI,2012,housing and community development,0,0,0,0,0,0,0,0
HI,2012,natural resources,763,3151178,5,4732,400,765,768,3155910
HI,2012,water transport and terminals,0,0,0,0,0,0,0,0
HI,2012,electric power,0,0,0,0,0,0,0,0
HI,2012,gas supply,0,0,0,0,0,0,0,0
HI,2012,transit,0,0,0,0,0,0,0,0
HI,2012,education total,32268,132121308,18364,16113322,803748,37025,50632,148234630
HI,2012,education - elementary and secondary total,22238,85904406,12919,11787620,577446,25717,35157,97692026
HI,2012,education - elementary and secondary instructional,17049,71310940,11297,10645484,511404,20130,28346,81956424
HI,2012,education - elementary and secondary other,5189,14593466,1622,1142136,66042,5587,6811,15735602
HI,2012,education - higher education total,9918,45775098,5443,4320946,226142,11195,15361,50096044
HI,2012,education - higher education instructional,4174,26075066,721,885788,29288,4339,4895,26960854
HI,2012,education - higher education other,5744,19700032,4722,3435158,196854,6856,10466,23135190
HI,2012,education - other,112,441804,2,4756,160,113,114,446560
HI,2012,libraries,466,1601564,220,219044,17392,564,686,1820608
HI,2012,liquor stores,0,0,0,0,0,0,0,0
HI,2012,other and unallocable,3513,14284800,55,63636,4234,3536,3568,14348436
ID,2012,total,19347,84978098,10021,10268409,596620,22719,29368,95246507
ID,2012,financial administration,1202,5212529,150,248394,18898,1309,1352,5460923
ID,2012,other government administration,244,1007357,79,172186,10914,305,323,1179543
ID,2012,judicial and legal,455,3627801,60,162345,3238,473,515,3790146
ID,2012,police protection total,455,2134306,35,23153,1326,462,490,2157459
ID,2012,police protection - officers,255,1370413,0,0,0,255,255,1370413
ID,2012,police protection - other,200,763893,35,23153,1326,207,235,787046
ID,2012,fire protection total,0,0,0,0,0,0,0,0
ID,2012,fire protection - firefighters,0,0,0,0,0,0,0,0
ID,2012,fire protection - other,0,0,0,0,0,0,0,0
ID,2012,corrections,1986,7616437,34,66240,3924,2009,2020,7682677
ID,2012,highways,1478,5320683,62,110765,10806,1539,1540,5431448
ID,2012,air transportation,0,0,0,0,0,0,0,0
ID,2012,water transport and terminals,0,0,0,0,0,0,0,0
ID,2012,public welfare,1652,6132723,99,143820,7830,1697,1751,6276543
ID,2012,health,1588,6938957,292,653718,27119,1743,1880,7592675
ID,2012,hospitals,578,1822085,102,122118,9865,634,680,1944203
ID,2012,social insurance administration,519,2426474,165,471286,23078,649,684,2897760
ID,2012,solid waste management,0,0,0,0,0,0,0,0
ID,2012,sewerage,0,0,0,0,0,0,0,0
ID,2012,parks and recreation,166,587450,100,97716,7686,209,266,685166
ID,2012,housing and community development,0,0,0,0,0,0,0,0
ID,2012,natural resources,1509,6977055,658,933109,59822,1848,2167,7910164
ID,2012,water transport and terminals,0,0,0,0,0,0,0,0
ID,2012,electric power,0,0,0,0,0,0,0,0
ID,2012,gas supply,0,0,0,0,0,0,0,0
ID,2012,transit,0,0,0,0,0,0,0,0
ID,2012,education total,6357,29796924,7924,6770157,390917,8564,14281,36567081
ID,2012,education - elementary and secondary total,0,0,0,0,0,0,0,0
ID,2012,education - elementary and secondary instructional,0,0,0,0,0,0,0,0
ID,2012,education - elementary and secondary other,0,0,0,0,0,0,0,0
ID,2012,education - higher education total,6022,28105990,7894,6727897,389105,8220,13916,34833887
ID,2012,education - higher education instructional,2144,12825719,2344,3226908,117939,2811,4488,16052627
ID,2012,education - higher education other,3878,15280271,5550,3500989,271166,5409,9428,18781260
ID,2012,education - other,335,1690934,30,42260,1812,344,365,1733194
ID,2012,libraries,0,0,0,0,0,0,0,0
ID,2012,liquor stores,161,541938,166,148415,13607,238,327,690353
ID,2012,other and unallocable,997,4835379,95,144987,7590,1040,1092,4980366
IL,2012,total,103497,573767355,52787,88556108,4420614,130126,156284,662323463
IL,2012,financial administration,4849,25490789,289,571434,30704,5035,5138,26062223
IL,2012,other government administration,2082,13296317,36,90972,3438,2102,2118,13387289
IL,2012,judicial and legal,2580,22485883,65,201612,4798,2609,2645,22687495
IL,2012,police protection total,3362,23603558,23,81118,1928,3373,3385,23684676
IL,2012,police protection - officers,2016,15352698,0,0,0,2016,2016,15352698
IL,2012,police protection - other,1346,8250860,23,81118,1928,1357,1369,8331978
IL,2012,fire protection total,0,0,0,0,0,0,0,0
IL,2012,fire protection - firefighters,0,0,0,0,0,0,0,0
IL,2012,fire protection - other,0,0,0,0,0,0,0,0
IL,2012,corrections,11156,62619494,3,15982,264,11158,11159,62635476
IL,2012,highways,5966,35052655,1165,4255452,130979,6755,7131,39308107
IL,2012,air transportation,0,0,0,0,0,0,0,0
IL,2012,water transport and terminals,56,353225,0,0,0,56,56,353225
IL,2012,public welfare,9026,51524410,34,106011,1932,9038,9060,51630421
IL,2012,health,2422,15061004,21,90469,1756,2432,2443,15151473
IL,2012,hospitals,10425,53210676,616,1605739,52552,10742,11041,54816415
IL,2012,social insurance administration,2015,11491954,238,933310,34750,2224,2253,12425264
IL,2012,solid waste management,0,0,0,0,0,0,0,0
IL,2012,sewerage,0,0,0,0,0,0,0,0
IL,2012,parks and recreation,421,2015011,26,81321,3591,442,447,2096332
IL,2012,housing and community development,0,0,0,0,0,0,0,0
IL,2012,natural resources,2168,10477625,1514,3064968,194893,3342,3682,13542593
IL,2012,water transport and terminals,0,0,0,0,0,0,0,0
IL,2012,electric power,0,0,0,0,0,0,0,0
IL,2012,gas supply,0,0,0,0,0,0,0,0
IL,2012,transit,0,0,0,0,0,0,0,0
IL,2012,education total,40755,213433039,48539,76957961,3939207,64485,89294,290391e3
IL,2012,education - elementary and secondary total,0,0,0,0,0,0,0,0
IL,2012,education - elementary and secondary instructional,0,0,0,0,0,0,0,0
IL,2012,education - elementary and secondary other,0,0,0,0,0,0,0,0
IL,2012,education - higher education total,38923,203899859,48523,76895756,3937600,62644,87446,280795615
IL,2012,education - higher education instructional,13118,87311304,17716,36874300,1410307,21614,30834,124185604
IL,2012,education - higher education other,25805,116588555,30807,40021456,2527293,41030,56612,156610011
IL,2012,education - other,1832,9533180,16,62205,1607,1841,1848,9595385
IL,2012,libraries,0,0,0,0,0,0,0,0
IL,2012,liquor stores,0,0,0,0,0,0,0,0
IL,2012,other and unallocable,6214,33651715,218,499759,19822,6333,6432,34151474
IN,2012,total,74593,314597495,41376,35692501,2431219,88431,115969,350289996
IN,2012,financial administration,1960,8383980,26,35694,2077,1971,1986,8419674
IN,2012,other government administration,547,2334431,193,506682,20531,670,740,2841113
IN,2012,judicial and legal,1396,9441589,55,90874,5121,1427,1451,9532463
IN,2012,police protection total,1885,7917686,1,1701,151,1886,1886,7919387
IN,2012,police protection - officers,1321,6011936,0,0,0,1321,1321,6011936
IN,2012,police protection - other,564,1905750,1,1701,151,565,565,1907451
IN,2012,fire protection total,0,0,0,0,0,0,0,0
IN,2012,fire protection - firefighters,0,0,0,0,0,0,0,0
IN,2012,fire protection - other,0,0,0,0,0,0,0,0
IN,2012,corrections,6236,19466263,2,2261,186,6237,6238,19468524
IN,2012,highways,3698,12824321,137,287144,18392,3809,3835,13111465
IN,2012,air transportation,0,0,0,0,0,0,0,0
IN,2012,water transport and terminals,24,125603,0,0,0,24,24,125603
IN,2012,public welfare,4513,15282701,34,40825,3133,4532,4547,15323526
IN,2012,health,1674,6682003,9,20442,691,1678,1683,6702445
IN,2012,hospitals,1860,6159406,20,37241,2024,1871,1880,6196647
IN,2012,social insurance administration,1225,3819624,169,209133,18410,1336,1394,4028757
IN,2012,solid waste management,0,0,0,0,0,0,0,0
IN,2012,sewerage,0,0,0,0,0,0,0,0
IN,2012,parks and recreation,131,458191,46,43914,3984,155,177,502105
IN,2012,housing and community development,0,0,0,0,0,0,0,0
IN,2012,natural resources,2080,7568505,314,330698,25137,2231,2394,7899203
IN,2012,water transport and terminals,0,0,0,0,0,0,0,0
IN,2012,electric power,0,0,0,0,0,0,0,0
IN,2012,gas supply,0,0,0,0,0,0,0,0
IN,2012,transit,0,0,0,0,0,0,0,0
IN,2012,education total,45125,205423244,40237,33959543,2321840,58306,85362,239382787
IN,2012,education - elementary and secondary total,0,0,0,0,0,0,0,0
IN,2012,education - elementary and secondary instructional,0,0,0,0,0,0,0,0
IN,2012,education - elementary and secondary other,0,0,0,0,0,0,0,0
IN,2012,education - higher education total,44158,201741679,40133,33889797,2316354,57307,84291,235631476
IN,2012,education - higher education instructional,19147,108000132,12922,18452189,893734,24208,32069,126452321
IN,2012,education - higher education other,25011,93741547,27211,15437608,1422620,33099,52222,109179155
IN,2012,education - other,967,3681565,104,69746,5486,999,1071,3751311
IN,2012,libraries,0,0,0,0,0,0,0,0
IN,2012,liquor stores,0,0,0,0,0,0,0,0
IN,2012,other and unallocable,2239,8709948,133,126349,9542,2298,2372,8836297
IA,2012,total,40562,235486682,26419,22839986,1304216,47929,66981,258326668
IA,2012,financial administration,994,4892149,36,100334,4624,1019,1030,4992483
IA,2012,other government administration,305,1587935,254,470785,19789,417,559,2058720
IA,2012,judicial and legal,2112,11415779,133,326295,14696,2195,2245,11742074
IA,2012,police protection total,936,5342915,18,19658,1007,942,954,5362573
IA,2012,police protection - officers,647,3826729,2,3173,210,648,649,3829902
IA,2012,police protection - other,289,1516186,16,16485,797,294,305,1532671
IA,2012,fire protection total,0,0,0,0,0,0,0,0
IA,2012,fire protection - firefighters,0,0,0,0,0,0,0,0
IA,2012,fire protection - other,0,0,0,0,0,0,0,0
IA,2012,corrections,2864,13769864,189,590481,22284,2989,3053,14360345
IA,2012,highways,2253,11001887,0,0,0,2253,2253,11001887
IA,2012,air transportation,0,0,0,0,0,0,0,0
IA,2012,water transport and terminals,0,0,0,0,0,0,0,0
IA,2012,public welfare,2711,12641906,54,135220,5793,2744,2765,12777126
IA,2012,health,410,2358106,53,92094,4116,433,463,2450200
IA,2012,hospitals,6103,40375974,3916,3231171,166578,7043,10019,43607145
IA,2012,social insurance administration,723,3485819,3,7938,392,725,726,3493757
IA,2012,solid waste management,0,0,0,0,0,0,0,0
IA,2012,sewerage,0,0,0,0,0,0,0,0
IA,2012,parks and recreation,98,566368,11,13797,1523,107,109,580165
IA,2012,housing and community development,0,0,0,0,0,0,0,0
IA,2012,natural resources,1468,7952571,205,246976,18375,1571,1673,8199547
IA,2012,water transport and terminals,0,0,0,0,0,0,0,0
IA,2012,electric power,0,0,0,0,0,0,0,0
IA,2012,gas supply,0,0,0,0,0,0,0,0
IA,2012,transit,0,0,0,0,0,0,0,0
IA,2012,education total,16934,106169818,21264,16978557,1014785,22667,38198,123148375
IA,2012,education - elementary and secondary total,0,0,0,0,0,0,0,0
IA,2012,education - elementary and secondary instructional,0,0,0,0,0,0,0,0
IA,2012,education - elementary and secondary other,0,0,0,0,0,0,0,0
IA,2012,education - higher education total,15845,100308210,21175,16834628,1008482,21543,37020,117142838
IA,2012,education - higher education instructional,3588,35177091,7161,11418186,441013,6079,10749,46595277
IA,2012,education - higher education other,12257,65131119,14014,5416442,567469,15464,26271,70547561
IA,2012,education - other,1089,5861608,89,143929,6303,1124,1178,6005537
IA,2012,libraries,0,0,0,0,0,0,0,0
IA,2012,liquor stores,0,0,0,0,0,0,0,0
IA,2012,other and unallocable,2651,13925591,283,626680,30254,2824,2934,14552271
KS,2012,total,43163,191906491,15941,16778104,886016,48191,59104,208684595
KS,2012,financial administration,1679,6168055,105,197354,7613,1723,1784,6365409
KS,2012,other government administration,469,1607931,185,574627,23084,599,654,2182558
KS,2012,judicial and legal,2040,8699166,102,123544,7047,2079,2142,8822710
KS,2012,police protection total,1023,4409096,60,89731,5093,1052,1083,4498827
KS,2012,police protection - officers,305,1494253,21,35778,1953,316,326,1530031
KS,2012,police protection - other,718,2914843,39,53953,3140,736,757,2968796
KS,2012,fire protection total,0,0,0,0,0,0,0,0
KS,2012,fire protection - firefighters,0,0,0,0,0,0,0,0
KS,2012,fire protection - other,0,0,0,0,0,0,0,0
KS,2012,corrections,3282,10019763,17,25428,1537,3292,3299,10045191
KS,2012,highways,3057,10838618,108,140089,9112,3108,3165,10978707
KS,2012,air transportation,0,0,0,0,0,0,0,0
KS,2012,water transport and terminals,0,0,0,0,0,0,0,0
KS,2012,public welfare,2206,7258743,47,42014,4150,2229,2253,7300757
KS,2012,health,1039,4207316,30,56496,2254,1051,1069,4263812
KS,2012,hospitals,6618,30824153,1418,3341705,110396,7242,8036,34165858
KS,2012,social insurance administration,96,339488,1,204,33,96,97,339692
KS,2012,solid waste management,0,0,0,0,0,0,0,0
KS,2012,sewerage,0,0,0,0,0,0,0,0
KS,2012,parks and recreation,607,1699402,1,1167,128,608,608,1700569
KS,2012,housing and community development,0,0,0,0,0,0,0,0
KS,2012,natural resources,758,3164304,114,123586,8922,809,872,3287890
KS,2012,water transport and terminals,0,0,0,0,0,0,0,0
KS,2012,electric power,0,0,0,0,0,0,0,0
KS,2012,gas supply,0,0,0,0,0,0,0,0
KS,2012,transit,0,0,0,0,0,0,0,0
KS,2012,education total,17390,91405208,13539,11777005,695695,21341,30929,103182213
KS,2012,education - elementary and secondary total,0,0,0,0,0,0,0,0
KS,2012,education - elementary and secondary instructional,0,0,0,0,0,0,0,0
KS,2012,education - elementary and secondary other,0,0,0,0,0,0,0,0
KS,2012,education - higher education total,16751,88739253,13454,11673154,691938,20680,30205,100412407
KS,2012,education - higher education instructional,6306,46270900,3979,6212276,242573,7681,10285,52483176
KS,2012,education - higher education other,10445,42468353,9475,5460878,449365,12999,19920,47929231
KS,2012,education - other,639,2665955,85,103851,3757,661,724,2769806
KS,2012,libraries,0,0,0,0,0,0,0,0
KS,2012,liquor stores,0,0,0,0,0,0,0,0
KS,2012,other and unallocable,2899,11265248,214,285154,10952,2962,3113,11550402
KY,2012,total,74593,300040072,25363,26205443,1825583,85308,99956,326245515
KY,2012,financial administration,2386,9177962,28,32074,1280,2393,2414,9210036
KY,2012,other government administration,681,3344695,188,633586,26596,842,869,3978281
KY,2012,judicial and legal,5579,19762485,178,262739,16960,5681,5757,20025224
KY,2012,police protection total,2386,9474837,6,8460,718,2390,2392,9483297
KY,2012,police protection - officers,1082,4827733,1,482,20,1082,1083,4828215
KY,2012,police protection - other,1304,4647104,5,7978,698,1308,1309,4655082
KY,2012,fire protection total,0,0,0,0,0,0,0,0
KY,2012,fire protection - firefighters,0,0,0,0,0,0,0,0
KY,2012,fire protection - other,0,0,0,0,0,0,0,0
KY,2012,corrections,4329,11412902,6,8001,806,4334,4335,11420903
KY,2012,highways,4481,14817644,12,23863,929,4487,4493,14841507
KY,2012,air transportation,0,0,0,0,0,0,0,0
KY,2012,water transport and terminals,0,0,0,0,0,0,0,0
KY,2012,public welfare,6839,20850013,8,17646,1222,6846,6847,20867659
KY,2012,health,3025,11989512,58,72437,3254,3044,3083,12061949
KY,2012,hospitals,5473,23418299,709,1379344,57701,5799,6182,24797643
KY,2012,social insurance administration,1320,4077192,0,0,0,1320,1320,4077192
KY,2012,solid waste management,0,0,0,0,0,0,0,0
KY,2012,sewerage,0,0,0,0,0,0,0,0
KY,2012,parks and recreation,1189,2712491,11,10493,1103,1195,1200,2722984
KY,2012,housing and community development,0,0,0,0,0,0,0,0
KY,2012,natural resources,2982,10605918,115,197288,10111,3040,3097,10803206
KY,2012,water transport and terminals,0,0,0,0,0,0,0,0
KY,2012,electric power,0,0,0,0,0,0,0,0
KY,2012,gas supply,0,0,0,0,0,0,0,0
KY,2012,transit,0,0,0,0,0,0,0,0
KY,2012,education total,31088,148025102,23815,23452482,1701742,41086,54903,171477584
KY,2012,education - elementary and secondary total,0,0,0,0,0,0,0,0
KY,2012,education - elementary and secondary instructional,0,0,0,0,0,0,0,0
KY,2012,education - elementary and secondary other,0,0,0,0,0,0,0,0
KY,2012,education - higher education total,28836,138750575,23410,23122037,1684580,38731,52246,161872612
KY,2012,education - higher education instructional,9306,66907342,8066,11533135,569857,12657,17372,78440477
KY,2012,education - higher education other,19530,71843233,15344,11588902,1114723,26074,34874,83432135
KY,2012,education - other,2252,9274527,405,330445,17162,2355,2657,9604972
KY,2012,libraries,0,0,0,0,0,0,0,0
KY,2012,liquor stores,0,0,0,0,0,0,0,0
KY,2012,other and unallocable,2835,10371020,229,107030,3161,2851,3064,10478050
LA,2012,total,71082,310285203,21709,20615565,1321578,78694,92791,330900768
LA,2012,financial administration,2103,8693999,133,187835,13063,2175,2236,8881834
LA,2012,other government administration,2070,10106948,498,717064,43335,2313,2568,10824012
LA,2012,judicial and legal,1670,7335509,52,52216,3045,1688,1722,7387725
LA,2012,police protection total,1711,9252324,64,149024,6650,1749,1775,9401348
LA,2012,police protection - officers,1153,7008152,31,81200,3122,1171,1184,7089352
LA,2012,police protection - other,558,2244172,33,67824,3528,578,591,2311996
LA,2012,fire protection total,0,0,0,0,0,0,0,0
LA,2012,fire protection - firefighters,0,0,0,0,0,0,0,0
LA,2012,fire protection - other,0,0,0,0,0,0,0,0
LA,2012,corrections,6280,24363106,123,208898,20588,6396,6403,24572004
LA,2012,highways,4615,17951688,42,59760,3602,4636,4657,18011448
LA,2012,air transportation,0,0,0,0,0,0,0,0
LA,2012,water transport and terminals,268,1405301,0,0,0,268,268,1405301
LA,2012,public welfare,4950,18726139,148,205391,12725,5022,5098,18931530
LA,2012,health,2539,12001013,61,91436,4475,2565,2600,12092449
LA,2012,hospitals,11271,43170469,1228,1694128,96576,11817,12499,44864597
LA,2012,social insurance administration,1135,4263643,86,113378,7898,1180,1221,4377021
LA,2012,solid waste management,0,0,0,0,0,0,0,0
LA,2012,sewerage,0,0,0,0,0,0,0,0
LA,2012,parks and recreation,873,2830825,225,255362,23545,1006,1098,3086187
LA,2012,housing and community development,0,0,0,0,0,0,0,0
LA,2012,natural resources,3834,16308230,731,738432,54274,4154,4565,17046662
LA,2012,water transport and terminals,0,0,0,0,0,0,0,0
LA,2012,electric power,0,0,0,0,0,0,0,0
LA,2012,gas supply,0,0,0,0,0,0,0,0
LA,2012,transit,0,0,0,0,0,0,0,0
LA,2012,education total,25077,122526387,18152,15984696,1022295,30987,43229,138511083
LA,2012,education - elementary and secondary total,1001,4338466,13,29664,830,1006,1014,4368130
LA,2012,education - elementary and secondary instructional,865,3669541,10,18170,538,868,875,3687711
LA,2012,education - elementary and secondary other,136,668925,3,11494,292,138,139,680419
LA,2012,education - higher education total,21394,106360084,17564,15192375,987149,27104,38958,121552459
LA,2012,education - higher education instructional,7151,51249857,6177,8650768,402030,9470,13328,59900625
LA,2012,education - higher education other,14243,55110227,11387,6541607,585119,17634,25630,61651834
LA,2012,education - other,2682,11827837,575,762657,34316,2877,3257,12590494
LA,2012,libraries,0,0,0,0,0,0,0,0
LA,2012,liquor stores,0,0,0,0,0,0,0,0
LA,2012,other and unallocable,2686,11349622,166,157945,9507,2738,2852,11507567
ME,2012,total,18580,77626490,8635,8606896,443412,21100,27215,86233386
ME,2012,financial administration,1223,4671650,95,248053,9497,1277,1318,4919703
ME,2012,other government administration,305,1417561,200,618768,26471,455,505,2036329
ME,2012,judicial and legal,636,3633630,115,228760,9086,688,751,3862390
ME,2012,police protection total,522,2671246,2,4767,213,523,524,2676013
ME,2012,police protection - officers,301,1799185,0,0,0,301,301,1799185
ME,2012,police protection - other,221,872061,2,4767,213,222,223,876828
ME,2012,fire protection total,0,0,0,0,0,0,0,0
ME,2012,fire protection - firefighters,0,0,0,0,0,0,0,0
ME,2012,fire protection - other,0,0,0,0,0,0,0,0
ME,2012,corrections,1134,4612096,36,76305,3667,1154,1170,4688401
ME,2012,highways,2033,7499319,100,188097,9776,2088,2133,7687416
ME,2012,air transportation,0,0,0,0,0,0,0,0
ME,2012,water transport and terminals,67,252723,25,42262,3494,87,92,294985
ME,2012,public welfare,2662,9516309,59,130913,6023,2696,2721,9647222
ME,2012,health,998,4203890,51,185308,5416,1028,1049,4389198
ME,2012,hospitals,452,1905072,46,123457,5170,481,498,2028529
ME,2012,social insurance administration,369,1349459,7,14840,621,371,376,1364299
ME,2012,solid waste management,0,0,0,0,0,0,0,0
ME,2012,sewerage,0,0,0,0,0,0,0,0
ME,2012,parks and recreation,144,533673,21,36000,1375,153,165,569673
ME,2012,housing and community development,0,0,0,0,0,0,0,0
ME,2012,natural resources,958,4021967,201,299564,10343,1017,1159,4321531
ME,2012,water transport and terminals,0,0,0,0,0,0,0,0
ME,2012,electric power,0,0,0,0,0,0,0,0
ME,2012,gas supply,0,0,0,0,0,0,0,0
ME,2012,transit,0,0,0,0,0,0,0,0
ME,2012,education total,5734,25100975,7554,6120950,341648,7679,13288,31221925
ME,2012,education - elementary and secondary total,21,72722,37,68728,4586,47,58,141450
ME,2012,education - elementary and secondary instructional,16,59264,14,18402,2078,28,30,77666
ME,2012,education - elementary and secondary other,5,13458,23,50326,2508,19,28,63784
ME,2012,education - higher education total,5498,24136695,7517,6052222,337062,7417,13015,30188917
ME,2012,education - higher education instructional,1714,10222202,2671,3444559,132814,2475,4385,13666761
ME,2012,education - higher education other,3784,13914493,4846,2607663,204248,4942,8630,16522156
ME,2012,education - other,215,891558,0,0,0,215,215,891558
ME,2012,libraries,0,0,0,0,0,0,0,0
ME,2012,liquor stores,1,4444,0,0,0,1,1,4444
ME,2012,other and unallocable,1342,6232476,123,288852,10612,1402,1465,6521328
MD,2012,total,78112,376102490,13828,39256879,1550068,86873,91940,415359369
MD,2012,financial administration,2978,13293342,157,341617,18575,3084,3135,13634959
MD,2012,other government administration,1449,7834402,288,522566,17480,1548,1737,8356968
MD,2012,judicial and legal,4710,25983355,472,1141579,65651,5082,5182,27124934
MD,2012,police protection total,2306,11920833,34,89393,4911,2334,2340,12010226
MD,2012,police protection - officers,1484,8405787,0,0,0,1484,1484,8405787
MD,2012,police protection - other,822,3515046,34,89393,4911,850,856,3604439
MD,2012,fire protection total,0,0,0,0,0,0,0,0
MD,2012,fire protection - firefighters,0,0,0,0,0,0,0,0
MD,2012,fire protection - other,0,0,0,0,0,0,0,0
MD,2012,corrections,11988,51010354,366,853548,54493,12296,12354,51863902
MD,2012,highways,4544,20541063,0,0,0,4544,4544,20541063
MD,2012,air transportation,470,2330137,0,0,0,470,470,2330137
MD,2012,water transport and terminals,271,1505628,0,0,0,271,271,1505628
MD,2012,public welfare,6371,25843051,137,335131,19922,6484,6508,26178182
MD,2012,health,5530,25193529,790,1678805,98718,6087,6320,26872334
MD,2012,hospitals,3461,14751955,504,902218,41753,3696,3965,15654173
MD,2012,social insurance administration,929,4090702,153,342499,20728,1046,1082,4433201
MD,2012,solid waste management,0,0,0,0,0,0,0,0
MD,2012,sewerage,0,0,0,0,0,0,0,0
MD,2012,parks and recreation,348,1517665,120,178644,9699,403,468,1696309
MD,2012,housing and community development,0,0,0,0,0,0,0,0
MD,2012,natural resources,1810,9370917,304,713215,36946,2019,2114,10084132
MD,2012,water transport and terminals,0,0,0,0,0,0,0,0
MD,2012,electric power,0,0,0,0,0,0,0,0
MD,2012,gas supply,0,0,0,0,0,0,0,0
MD,2012,transit,717,3764069,0,0,0,717,717,3764069
MD,2012,education total,23912,128168301,9731,30316023,1064811,29928,33643,158484324
MD,2012,education - elementary and secondary total,0,0,0,0,0,0,0,0
MD,2012,education - elementary and secondary instructional,0,0,0,0,0,0,0,0
MD,2012,education - elementary and secondary other,0,0,0,0,0,0,0,0
MD,2012,education - higher education total,22096,119511611,9395,29292104,1023660,27880,31491,148803715
MD,2012,education - higher education instructional,7024,53656689,4591,23181803,649897,10696,11615,76838492
MD,2012,education - higher education other,15072,65854922,4804,6110301,373763,17184,19876,71965223
MD,2012,education - other,1816,8656690,336,1023919,41151,2048,2152,9680609
MD,2012,libraries,0,0,0,0,0,0,0,0
MD,2012,liquor stores,0,0,0,0,0,0,0,0
MD,2012,other and unallocable,6318,28983187,772,1841641,96381,6864,7090,30824828
MA,2012,total,84612,448621372,34249,46227716,1688221,94699,118861,494849088
MA,2012,financial administration,3748,19394095,278,958841,15435,3840,4026,20352936
MA,2012,other government administration,1914,8039084,285,1274037,25569,2060,2199,9313121
MA,2012,judicial and legal,8709,46940781,471,1562610,25940,8864,9180,48503391
MA,2012,police protection total,2910,26067141,14,60374,647,2913,2924,26127515
MA,2012,police protection - officers,2143,21878912,1,2004,49,2143,2144,21880916
MA,2012,police protection - other,767,4188229,13,58370,598,770,780,4246599
MA,2012,fire protection total,0,0,0,0,0,0,0,0
MA,2012,fire protection - firefighters,0,0,0,0,0,0,0,0
MA,2012,fire protection - other,0,0,0,0,0,0,0,0
MA,2012,corrections,11699,57274168,147,404044,7458,11744,11846,57678212
MA,2012,highways,3081,16418222,48,174346,3224,3100,3129,16592568
MA,2012,air transportation,1002,6967219,0,0,0,1002,1002,6967219
MA,2012,water transport and terminals,160,1106138,0,0,0,160,160,1106138
MA,2012,public welfare,6647,34156261,480,1541048,27205,6810,7127,35697309
MA,2012,health,6790,32586234,961,2373203,82600,7288,7751,34959437
MA,2012,hospitals,5344,22313771,645,1946900,55557,5658,5989,24260671
MA,2012,social insurance administration,1496,7156140,44,193327,3078,1515,1540,7349467
MA,2012,solid waste management,0,0,0,0,0,0,0,0
MA,2012,sewerage,775,4909240,34,179689,2489,790,809,5088929
MA,2012,parks and recreation,931,4096694,145,165272,10540,991,1076,4261966
MA,2012,housing and community development,0,0,0,0,0,0,0,0
MA,2012,natural resources,1120,6396252,136,423306,10256,1182,1256,6819558
MA,2012,water transport and terminals,539,3129111,16,64559,1092,545,555,3193670
MA,2012,electric power,0,0,0,0,0,0,0,0
MA,2012,gas supply,0,0,0,0,0,0,0,0
MA,2012,transit,0,0,0,0,0,0,0,0
MA,2012,education total,23651,128040783,30305,34019763,1398038,32028,53956,162060546
MA,2012,education - elementary and secondary total,91,481098,19,19230,1096,97,110,500328
MA,2012,education - elementary and secondary instructional,62,342526,2,722,60,62,64,343248
MA,2012,education - elementary and secondary other,29,138572,17,18508,1036,35,46,157080
MA,2012,education - higher education total,22469,121201572,30190,33707678,1391976,30810,52659,154909250
MA,2012,education - higher education instructional,6497,43116427,12200,21398738,708197,10756,18697,64515165
MA,2012,education - higher education other,15972,78085145,17990,12308940,683779,20054,33962,90394085
MA,2012,education - other,1091,6358113,96,292855,4966,1121,1187,6650968
MA,2012,libraries,0,0,0,0,0,0,0,0
MA,2012,liquor stores,0,0,0,0,0,0,0,0
MA,2012,other and unallocable,4096,23630038,240,886397,19093,4209,4336,24516435
MI,2012,total,111206,608002266,72877,113063632,6226179,146542,184083,721065898
MI,2012,financial administration,3696,20049941,343,1331373,49142,3973,4039,21381314
MI,2012,other government administration,1450,6734580,28,101140,3711,1471,1478,6835720
MI,2012,judicial and legal,1384,9624954,59,177610,6256,1419,1443,9802564
MI,2012,police protection total,2276,13444817,59,222855,7863,2320,2335,13667672
MI,2012,police protection - officers,1533,10224920,0,0,0,1533,1533,10224920
MI,2012,police protection - other,743,3219897,59,222855,7863,787,802,3442752
MI,2012,fire protection total,0,0,0,0,0,0,0,0
MI,2012,fire protection - firefighters,0,0,0,0,0,0,0,0
MI,2012,fire protection - other,0,0,0,0,0,0,0,0
MI,2012,corrections,13328,65828823,173,773428,24003,13464,13501,66602251
MI,2012,highways,2375,12384398,276,783264,35796,2577,2651,13167662
MI,2012,air transportation,0,0,0,0,0,0,0,0
MI,2012,water transport and terminals,0,0,0,0,0,0,0,0
MI,2012,public welfare,10714,46776766,805,3133152,137487,11491,11519,49909918
MI,2012,health,4335,19968437,929,3577189,147465,5168,5264,23545626
MI,2012,hospitals,11450,58715315,5294,21320207,855619,16284,16744,80035522
MI,2012,social insurance administration,1105,5392572,104,365652,18281,1208,1209,5758224
MI,2012,solid waste management,0,0,0,0,0,0,0,0
MI,2012,sewerage,0,0,0,0,0,0,0,0
MI,2012,parks and recreation,154,771141,86,268185,10728,215,240,1039326
MI,2012,housing and community development,268,1451571,71,184962,9564,322,339,1636533
MI,2012,natural resources,3110,15310644,694,1200977,69550,3503,3804,16511621
MI,2012,water transport and terminals,0,0,0,0,0,0,0,0
MI,2012,electric power,0,0,0,0,0,0,0,0
MI,2012,gas supply,0,0,0,0,0,0,0,0
MI,2012,transit,0,0,0,0,0,0,0,0
MI,2012,education total,51076,309595775,63206,77699651,4757126,78113,114282,387295426
MI,2012,education - elementary and secondary total,0,0,0,0,0,0,0,0
MI,2012,education - elementary and secondary instructional,0,0,0,0,0,0,0,0
MI,2012,education - elementary and secondary other,0,0,0,0,0,0,0,0
MI,2012,education - higher education total,50575,306799992,63089,77249108,4739361,77512,113664,384049100
MI,2012,education - higher education instructional,16336,145777180,13874,35879325,1475261,24772,30210,181656505
MI,2012,education - higher education other,34239,161022812,49215,41369783,3264100,52740,83454,202392595
MI,2012,education - other,501,2795783,117,450543,17765,601,618,3246326
MI,2012,libraries,0,0,0,0,0,0,0,0
MI,2012,liquor stores,0,0,0,0,0,0,0,0
MI,2012,other and unallocable,4485,21952532,750,1923987,93588,5014,5235,23876519
MN,2012,total,66223,358029193,35422,50173607,2439318,80006,101645,408202800
MN,2012,financial administration,3105,16006261,102,285257,14601,3189,3207,16291518
MN,2012,other government administration,830,4432243,146,381264,16429,924,976,4813507
MN,2012,judicial and legal,3166,16424525,509,1567439,62868,3522,3675,17991964
MN,2012,police protection total,972,4801612,37,82013,3897,994,1009,4883625
MN,2012,police protection - officers,548,3158955,0,0,0,548,548,3158955
MN,2012,police protection - other,424,1642657,37,82013,3897,446,461,1724670
MN,2012,fire protection total,0,0,0,0,0,0,0,0
MN,2012,fire protection - firefighters,0,0,0,0,0,0,0,0
MN,2012,fire protection - other,0,0,0,0,0,0,0,0
MN,2012,corrections,4111,17815702,134,416822,19572,4222,4245,18232524
MN,2012,highways,4498,21794229,211,330608,17767,4598,4709,22124837
MN,2012,air transportation,0,0,0,0,0,0,0,0
MN,2012,water transport and terminals,0,0,0,0,0,0,0,0
MN,2012,public welfare,1587,7567611,1345,3303460,230797,2891,2932,10871071
MN,2012,health,2914,14937228,2164,1503451,58297,3243,5078,16440679
MN,2012,hospitals,3339,16631507,1378,4078938,243571,4715,4717,20710445
MN,2012,social insurance administration,1128,4924523,78,192632,8678,1177,1206,5117155
MN,2012,solid waste management,0,0,0,0,0,0,0,0
MN,2012,sewerage,593,3485111,9,22661,1039,599,602,3507772
MN,2012,parks and recreation,522,2448745,161,204308,11917,590,683,2653053
MN,2012,housing and community development,0,0,0,0,0,0,0,0
MN,2012,natural resources,2654,13130082,659,1249317,74588,3074,3313,14379399
MN,2012,water transport and terminals,0,0,0,0,0,0,0,0
MN,2012,electric power,0,0,0,0,0,0,0,0
MN,2012,gas supply,0,0,0,0,0,0,0,0
MN,2012,transit,2252,11038403,366,919473,42120,2490,2618,11957876
MN,2012,education total,31533,187898988,27924,35195112,1612536,40643,59457,223094100
MN,2012,education - elementary and secondary total,0,0,0,0,0,0,0,0
MN,2012,education - elementary and secondary instructional,0,0,0,0,0,0,0,0
MN,2012,education - elementary and secondary other,0,0,0,0,0,0,0,0
MN,2012,education - higher education total,28146,169334762,26496,32289820,1495609,36597,54642,201624582
MN,2012,education - higher education instructional,11661,76244215,10729,17138763,585811,14970,22390,93382978
MN,2012,education - higher education other,16485,93090547,15767,15151057,909798,21627,32252,108241604
MN,2012,education - other,3387,18564226,1428,2905292,116927,4046,4815,21469518
MN,2012,libraries,0,0,0,0,0,0,0,0
MN,2012,liquor stores,0,0,0,0,0,0,0,0
MN,2012,other and unallocable,3019,14692423,199,440852,20641,3135,3218,15133275
MS,2012,total,52319,195684179,13670,13974832,938129,57709,65989,209659011
MS,2012,financial administration,1348,4776876,54,114170,5885,1382,1402,4891046
MS,2012,other government administration,521,2032858,15,33392,2011,532,536,2066250
MS,2012,judicial and legal,732,4236846,8,13124,280,734,740,4249970
MS,2012,police protection total,1197,3911351,0,0,0,1197,1197,3911351
MS,2012,police protection - officers,708,2739775,0,0,0,708,708,2739775
MS,2012,police protection - other,489,1171576,0,0,0,489,489,1171576
MS,2012,fire protection total,0,0,0,0,0,0,0,0
MS,2012,fire protection - firefighters,0,0,0,0,0,0,0,0
MS,2012,fire protection - other,0,0,0,0,0,0,0,0
MS,2012,corrections,3122,8018514,100,142848,10801,3183,3222,8161362
MS,2012,highways,3327,9760890,9,16639,1034,3333,3336,9777529
MS,2012,air transportation,0,0,0,0,0,0,0,0
MS,2012,water transport and terminals,39,211874,1,2000,76,39,40,213874
MS,2012,public welfare,2877,9681178,0,0,0,2877,2877,9681178
MS,2012,health,3315,11057996,83,61664,2790,3331,3398,11119660
MS,2012,hospitals,11487,39404845,1325,1834881,87359,11981,12812,41239726
MS,2012,social insurance administration,707,2276809,243,557520,40336,950,950,2834329
MS,2012,solid waste management,0,0,0,0,0,0,0,0
MS,2012,sewerage,0,0,0,0,0,0,0,0
MS,2012,parks and recreation,329,816100,72,51435,5768,363,401,867535
MS,2012,housing and community development,0,0,0,0,0,0,0,0
MS,2012,natural resources,2735,8706093,812,717414,55474,3050,3547,9423507
MS,2012,water transport and terminals,47,120070,9,9912,820,52,56,129982
MS,2012,electric power,0,0,0,0,0,0,0,0
MS,2012,gas supply,0,0,0,0,0,0,0,0
MS,2012,transit,0,0,0,0,0,0,0,0
MS,2012,education total,17125,79535939,10777,10169737,707900,21194,27902,89705676
MS,2012,education - elementary and secondary total,0,0,0,0,0,0,0,0
MS,2012,education - elementary and secondary instructional,0,0,0,0,0,0,0,0
MS,2012,education - elementary and secondary other,0,0,0,0,0,0,0,0
MS,2012,education - higher education total,15610,74663006,10747,10123291,705322,19664,26357,84786297
MS,2012,education - higher education instructional,5835,30888793,1423,1899371,91512,6356,7258,32788164
MS,2012,education - higher education other,9775,43774213,9324,8223920,613810,13308,19099,51998133
MS,2012,education - other,1515,4872933,30,46446,2578,1530,1545,4919379
MS,2012,libraries,0,0,0,0,0,0,0,0
MS,2012,liquor stores,114,298563,0,0,0,114,114,298563
MS,2012,other and unallocable,3297,10837377,162,250096,17595,3397,3459,11087473
MO,2012,total,77449,285329144,28098,25887294,1646692,86765,105547,311216438
MO,2012,financial administration,3056,10836201,149,191962,15320,3141,3205,11028163
MO,2012,other government administration,751,2667573,376,853251,41569,989,1127,3520824
MO,2012,judicial and legal,3938,14899598,317,452858,35164,4137,4255,15352456
MO,2012,police protection total,2378,9592076,133,150386,16578,2472,2511,9742462
MO,2012,police protection - officers,1309,6265832,0,0,0,1309,1309,6265832
MO,2012,police protection - other,1069,3326244,133,150386,16578,1163,1202,3476630
MO,2012,fire protection total,0,0,0,0,0,0,0,0
MO,2012,fire protection - firefighters,0,0,0,0,0,0,0,0
MO,2012,fire protection - other,0,0,0,0,0,0,0,0
MO,2012,corrections,12046,31276364,138,136090,10318,12105,12184,31412454
MO,2012,highways,5360,18333222,0,0,0,5360,5360,18333222
MO,2012,air transportation,0,0,0,0,0,0,0,0
MO,2012,water transport and terminals,0,0,0,0,0,0,0,0
MO,2012,public welfare,7063,18165652,309,326924,21424,7184,7372,18492576
MO,2012,health,2773,9641480,161,290907,12652,2845,2934,9932387
MO,2012,hospitals,9865,31134440,1355,1844314,105694,10462,11220,32978754
MO,2012,social insurance administration,665,1825922,40,58106,3278,684,705,1884028
MO,2012,solid waste management,0,0,0,0,0,0,0,0
MO,2012,sewerage,0,0,0,0,0,0,0,0
MO,2012,parks and recreation,470,1397256,186,46226,5160,499,656,1443482
MO,2012,housing and community development,0,0,0,0,0,0,0,0
MO,2012,natural resources,1937,6740588,482,482548,49771,2217,2419,7223136
MO,2012,water transport and terminals,0,0,0,0,0,0,0,0
MO,2012,electric power,0,0,0,0,0,0,0,0
MO,2012,gas supply,0,0,0,0,0,0,0,0
MO,2012,transit,0,0,0,0,0,0,0,0
MO,2012,education total,23318,115631659,24192,20737400,1308994,30723,47510,136369059
MO,2012,education - elementary and secondary total,0,0,0,0,0,0,0,0
MO,2012,education - elementary and secondary instructional,0,0,0,0,0,0,0,0
MO,2012,education - elementary and secondary other,0,0,0,0,0,0,0,0
MO,2012,education - higher education total,22268,112028639,23194,18977992,1200606,29061,45462,131006631
MO,2012,education - higher education instructional,8233,55399249,7975,10185273,476792,10928,16208,65584522
MO,2012,education - higher education other,14035,56629390,15219,8792719,723814,18133,29254,65422109
MO,2012,education - other,1050,3603020,998,1759408,108388,1662,2048,5362428
MO,2012,libraries,0,0,0,0,0,0,0,0
MO,2012,liquor stores,0,0,0,0,0,0,0,0
MO,2012,other and unallocable,3829,13187113,260,316322,20770,3947,4089,13503435
MT,2012,total,16670,70844319,9731,10655819,633814,20251,26401,81500138
MT,2012,financial administration,999,3774199,86,159015,9567,1053,1085,3933214
MT,2012,other government administration,356,1602662,61,88937,5136,385,417,1691599
MT,2012,judicial and legal,662,2932032,89,168837,8609,710,751,3100869
MT,2012,police protection total,448,2122698,31,76537,3107,464,479,2199235
MT,2012,police protection - officers,209,1147746,8,36821,1103,215,217,1184567
MT,2012,police protection - other,239,974952,23,39716,2004,249,262,1014668
MT,2012,fire protection total,0,0,0,0,0,0,0,0
MT,2012,fire protection - firefighters,0,0,0,0,0,0,0,0
MT,2012,fire protection - other,0,0,0,0,0,0,0,0
MT,2012,corrections,1147,4789502,23,49693,2343,1160,1170,4839195
MT,2012,highways,2008,8834391,182,291597,15245,2094,2190,9125988
MT,2012,air transportation,0,0,0,0,0,0,0,0
MT,2012,water transport and terminals,0,0,0,0,0,0,0,0
MT,2012,public welfare,1500,5182511,266,540141,35106,1698,1766,5722652
MT,2012,health,837,3294669,161,291573,14905,922,998,3586242
MT,2012,hospitals,501,1711521,213,284301,18438,605,714,1995822
MT,2012,social insurance administration,717,3184294,36,79404,4519,743,753,3263698
MT,2012,solid waste management,0,0,0,0,0,0,0,0
MT,2012,sewerage,0,0,0,0,0,0,0,0
MT,2012,parks and recreation,48,203624,61,93159,3716,69,109,296783
MT,2012,housing and community development,0,0,0,0,0,0,0,0
MT,2012,natural resources,1339,5401349,376,551153,29726,1507,1715,5952502
MT,2012,water transport and terminals,0,0,0,0,0,0,0,0
MT,2012,electric power,0,0,0,0,0,0,0,0
MT,2012,gas supply,0,0,0,0,0,0,0,0
MT,2012,transit,0,0,0,0,0,0,0,0
MT,2012,education total,4985,22843523,8010,7662691,469712,7640,12995,30506214
MT,2012,education - elementary and secondary total,0,0,0,0,0,0,0,0
MT,2012,education - elementary and secondary instructional,0,0,0,0,0,0,0,0
MT,2012,education - elementary and secondary other,0,0,0,0,0,0,0,0
MT,2012,education - higher education total,4683,21559815,7850,7403110,455859,7260,12533,28962925
MT,2012,education - higher education instructional,1317,8946053,1414,2476960,106452,1919,2731,11423013
MT,2012,education - higher education other,3366,12613762,6436,4926150,349407,5341,9802,17539912
MT,2012,education - other,302,1283708,160,259581,13853,380,462,1543289
MT,2012,libraries,0,0,0,0,0,0,0,0
MT,2012,liquor stores,26,97615,4,7657,534,29,30,105272
MT,2012,other and unallocable,1097,4869729,132,311124,13151,1172,1229,5180853
NE,2012,total,26690,109652619,10484,11948666,956305,32095,37174,121601285
NE,2012,financial administration,782,2996394,17,27692,1387,790,799,3024086
NE,2012,other government administration,264,1117212,96,111631,6270,300,360,1228843
NE,2012,judicial and legal,722,3512571,42,42557,2679,737,764,3555128
NE,2012,police protection total,748,3283435,10,10724,987,753,758,3294159
NE,2012,police protection - officers,467,2312601,0,0,0,467,467,2312601
NE,2012,police protection - other,281,970834,10,10724,987,286,291,981558
NE,2012,fire protection total,0,0,0,0,0,0,0,0
NE,2012,fire protection - firefighters,0,0,0,0,0,0,0,0
NE,2012,fire protection - other,0,0,0,0,0,0,0,0
NE,2012,corrections,2821,9543956,78,105606,7027,2861,2899,9649562
NE,2012,highways,2067,7572979,11,30931,1269,2074,2078,7603910
NE,2012,air transportation,23,114532,0,0,0,23,23,114532
NE,2012,water transport and terminals,0,0,0,0,0,0,0,0
NE,2012,public welfare,2414,7166812,261,390299,22962,2544,2675,7557111
NE,2012,health,628,2491918,17,28673,1797,638,645,2520591
NE,2012,hospitals,3182,12327557,740,1812973,113254,3822,3922,14140530
NE,2012,social insurance administration,232,882435,6,9121,617,236,238,891556
NE,2012,solid waste management,0,0,0,0,0,0,0,0
NE,2012,sewerage,0,0,0,0,0,0,0,0
NE,2012,parks and recreation,203,701367,160,130502,13400,279,363,831869
NE,2012,housing and community development,0,0,0,0,0,0,0,0
NE,2012,natural resources,1517,5755875,751,1619560,110804,2143,2268,7375435
NE,2012,water transport and terminals,0,0,0,0,0,0,0,0
NE,2012,electric power,0,0,0,0,0,0,0,0
NE,2012,gas supply,0,0,0,0,0,0,0,0
NE,2012,transit,0,0,0,0,0,0,0,0
NE,2012,education total,9255,45056728,8088,7479287,664706,13010,17343,52536015
NE,2012,education - elementary and secondary total,0,0,0,0,0,0,0,0
NE,2012,education - elementary and secondary instructional,0,0,0,0,0,0,0,0
NE,2012,education - elementary and secondary other,0,0,0,0,0,0,0,0
NE,2012,education - higher education total,8739,42827373,8059,7435118,662372,12481,16798,50262491
NE,2012,education - higher education instructional,2762,19595218,1145,2132986,99965,3327,3907,21728204
NE,2012,education - higher education other,5977,23232155,6914,5302132,562407,9154,12891,28534287
NE,2012,education - other,516,2229355,29,44169,2334,529,545,2273524
NE,2012,libraries,0,0,0,0,0,0,0,0
NE,2012,liquor stores,0,0,0,0,0,0,0,0
NE,2012,other and unallocable,1832,7128848,207,149110,9146,1885,2039,7277958
NV,2012,total,23808,115870194,9790,11882323,519748,26743,33598,127752517
NV,2012,financial administration,1323,5014319,9,17264,461,1326,1332,5031583
NV,2012,other government administration,910,4177827,44,52491,1898,921,954,4230318
NV,2012,judicial and legal,722,4596507,12,22222,432,724,734,4618729
NV,2012,police protection total,852,5535921,3,8408,297,854,855,5544329
NV,2012,police protection - officers,452,3642237,0,0,0,452,452,3642237
NV,2012,police protection - other,400,1893684,3,8408,297,402,403,1902092
NV,2012,fire protection total,0,0,0,0,0,0,0,0
NV,2012,fire protection - firefighters,0,0,0,0,0,0,0,0
NV,2012,fire protection - other,0,0,0,0,0,0,0,0
NV,2012,corrections,3458,14836522,51,162772,2451,3472,3509,14999294
NV,2012,highways,1736,7688252,4,8822,299,1738,1740,7697074
NV,2012,air transportation,0,0,0,0,0,0,0,0
NV,2012,water transport and terminals,0,0,0,0,0,0,0,0
NV,2012,public welfare,1820,6451558,7,14732,419,1822,1827,6466290
NV,2012,health,1307,5768570,27,82485,1825,1317,1334,5851055
NV,2012,hospitals,1290,5941185,51,162688,3321,1309,1341,6103873
NV,2012,social insurance administration,689,2280185,1,879,40,689,690,2281064
NV,2012,solid waste management,0,0,0,0,0,0,0,0
NV,2012,sewerage,0,0,0,0,0,0,0,0
NV,2012,parks and recreation,108,420883,59,178945,6384,144,167,599828
NV,2012,housing and community development,0,0,0,0,0,0,0,0
NV,2012,natural resources,807,3952795,104,149284,7864,852,911,4102079
NV,2012,water transport and terminals,17,108775,0,0,0,17,17,108775
NV,2012,electric power,17,108775,0,0,0,17,17,108775
NV,2012,gas supply,0,0,0,0,0,0,0,0
NV,2012,transit,0,0,0,0,0,0,0,0
NV,2012,education total,6774,39730221,9353,10901288,489266,9538,16127,50631509
NV,2012,education - elementary and secondary total,0,0,0,0,0,0,0,0
NV,2012,education - elementary and secondary instructional,0,0,0,0,0,0,0,0
NV,2012,education - elementary and secondary other,0,0,0,0,0,0,0,0
NV,2012,education - higher education total,6636,39062755,9351,10897198,489175,9399,15987,49959953
NV,2012,education - higher education instructional,1885,15646771,4320,6330687,222005,3139,6205,21977458
NV,2012,education - higher education other,4751,23415984,5031,4566511,267170,6260,9782,27982495
NV,2012,education - other,138,667466,2,4090,91,139,140,671556
NV,2012,libraries,0,0,0,0,0,0,0,0
NV,2012,liquor stores,0,0,0,0,0,0,0,0
NV,2012,other and unallocable,1978,9257899,65,120043,4791,2003,2043,9377942
NH,2012,total,14910,70094241,10273,11770174,611154,18591,25183,81864415
NH,2012,financial administration,692,3333915,44,66334,4477,718,736,3400249
NH,2012,other government administration,310,1357237,89,117872,7735,356,399,1475109
NH,2012,judicial and legal,879,3564541,13,30360,1079,886,892,3594901
NH,2012,police protection total,449,2597915,15,25464,1802,460,464,2623379
NH,2012,police protection - officers,300,1948436,0,0,0,300,300,1948436
NH,2012,police protection - other,149,649479,15,25464,1802,160,164,674943
NH,2012,fire protection total,0,0,0,0,0,0,0,0
NH,2012,fire protection - firefighters,0,0,0,0,0,0,0,0
NH,2012,fire protection - other,0,0,0,0,0,0,0,0
NH,2012,corrections,1054,4856914,81,143733,7097,1097,1135,5000647
NH,2012,highways,1568,6115941,186,237303,24202,1714,1754,6353244
NH,2012,air transportation,28,118710,15,34401,2248,41,43,153111
NH,2012,water transport and terminals,7,38850,9,8284,673,11,16,47134
NH,2012,public welfare,1511,5836632,134,235228,10319,1572,1645,6071860
NH,2012,health,802,3791566,71,84826,5901,838,873,3876392
NH,2012,hospitals,542,2205566,79,121662,1814,553,621,2327228
NH,2012,social insurance administration,286,1076384,47,74965,3705,308,333,1151349
NH,2012,solid waste management,0,0,0,0,0,0,0,0
NH,2012,sewerage,0,0,0,0,0,0,0,0
NH,2012,parks and recreation,75,291241,273,209095,21801,206,348,500336
NH,2012,housing and community development,0,0,0,0,0,0,0,0
NH,2012,natural resources,332,1547084,131,107269,7737,379,463,1654353
NH,2012,water transport and terminals,26,130953,4,7622,345,28,30,138575
NH,2012,electric power,0,0,0,0,0,0,0,0
NH,2012,gas supply,0,0,0,0,0,0,0,0
NH,2012,transit,0,0,0,0,0,0,0,0
NH,2012,education total,4432,25035550,8072,9264329,433639,7048,12504,34299879
NH,2012,education - elementary and secondary total,0,0,0,0,0,0,0,0
NH,2012,education - elementary and secondary instructional,0,0,0,0,0,0,0,0
NH,2012,education - elementary and secondary other,0,0,0,0,0,0,0,0
NH,2012,education - higher education total,4132,23740029,8048,9221163,431387,6735,12180,32961192
NH,2012,education - higher education instructional,1484,11219213,2190,4562974,140744,2334,3674,15782187
NH,2012,education - higher education other,2648,12520816,5858,4658189,290643,4401,8506,17179005
NH,2012,education - other,300,1295521,24,43166,2252,313,324,1338687
NH,2012,libraries,0,0,0,0,0,0,0,0
NH,2012,liquor stores,285,1116574,552,512510,45366,558,837,1629084
NH,2012,other and unallocable,1632,7078668,458,488917,31214,1818,2090,7567585
NJ,2012,total,132467,794906691,29722,50142675,2126533,145670,162189,845049366
NJ,2012,financial administration,5233,27411160,368,834376,40606,5495,5601,28245536
NJ,2012,other government administration,1189,7135233,36,61426,3016,1208,1225,7196659
NJ,2012,judicial and legal,13013,81141223,224,384977,18046,13130,13237,81526200
NJ,2012,police protection total,3999,30436360,46,99590,3133,4019,4045,30535950
NJ,2012,police protection - officers,2744,24182241,0,0,0,2744,2744,24182241
NJ,2012,police protection - other,1255,6254119,46,99590,3133,1275,1301,6353709
NJ,2012,fire protection total,0,0,0,0,0,0,0,0
NJ,2012,fire protection - firefighters,0,0,0,0,0,0,0,0
NJ,2012,fire protection - other,0,0,0,0,0,0,0,0
NJ,2012,corrections,9021,54316170,12,29986,1063,9028,9033,54346156
NJ,2012,highways,5603,33238294,441,654098,36449,5810,6044,33892392
NJ,2012,air transportation,0,0,0,0,0,0,0,0
NJ,2012,water transport and terminals,83,416910,6,11364,744,87,89,428274
NJ,2012,public welfare,8580,47763137,186,333188,15684,8682,8766,48096325
NJ,2012,health,4200,25767977,729,2237629,31379,4403,4929,28005606
NJ,2012,hospitals,16004,75370471,2476,5070467,237699,17537,18480,80440938
NJ,2012,social insurance administration,1583,7951203,233,669622,33019,1796,1816,8620825
NJ,2012,solid waste management,517,3709885,13,14351,910,523,530,3724236
NJ,2012,sewerage,0,0,0,0,0,0,0,0
NJ,2012,parks and recreation,828,4493707,495,477160,26879,986,1323,4970867
NJ,2012,housing and community development,0,0,0,0,0,0,0,0
NJ,2012,natural resources,1778,10765612,331,502692,23369,1923,2109,11268304
NJ,2012,water transport and terminals,113,600151,0,0,0,113,113,600151
NJ,2012,electric power,0,0,0,0,0,0,0,0
NJ,2012,gas supply,0,0,0,0,0,0,0,0
NJ,2012,transit,11111,53208361,1007,1658440,84363,11588,12118,54866801
NJ,2012,education total,43851,295495469,22979,36895580,1560524,53520,66830,332391049
NJ,2012,education - elementary and secondary total,14650,96996315,3051,5062785,157600,15689,17701,102059100
NJ,2012,education - elementary and secondary instructional,10112,78197372,814,1759582,50046,10454,10926,79956954
NJ,2012,education - elementary and secondary other,4538,18798943,2237,3303203,107554,5235,6775,22102146
NJ,2012,education - higher education total,26843,184230036,19254,30601986,1336402,35044,46097,214832022
NJ,2012,education - higher education instructional,7587,80955348,6349,13636569,403682,10085,13936,94591917
NJ,2012,education - higher education other,19256,103274688,12905,16965417,932720,24959,32161,120240105
NJ,2012,education - other,2358,14269118,674,1230809,66522,2787,3032,15499927
NJ,2012,libraries,0,0,0,0,0,0,0,0
NJ,2012,liquor stores,0,0,0,0,0,0,0,0
NJ,2012,other and unallocable,5761,35685368,140,207729,9650,5822,5901,35893097
NM,2012,total,39388,177871232,14732,18205443,986845,45065,54120,196076675
NM,2012,financial administration,1079,4582086,8,23555,1136,1086,1087,4605641
NM,2012,other government administration,160,817642,3,8667,415,162,163,826309
NM,2012,judicial and legal,3131,13526664,113,170165,10216,3191,3244,13696829
NM,2012,police protection total,650,2474708,0,0,0,650,650,2474708
NM,2012,police protection - officers,504,2091873,0,0,0,504,504,2091873
NM,2012,police protection - other,146,382835,0,0,0,146,146,382835
NM,2012,fire protection total,0,0,0,0,0,0,0,0
NM,2012,fire protection - firefighters,0,0,0,0,0,0,0,0
NM,2012,fire protection - other,0,0,0,0,0,0,0,0
NM,2012,corrections,3616,12169915,32,80325,4008,3639,3648,12250240
NM,2012,highways,2059,7286563,0,0,0,2059,2059,7286563
NM,2012,air transportation,3,13822,0,0,0,3,3,13822
NM,2012,water transport and terminals,0,0,0,0,0,0,0,0
NM,2012,public welfare,1668,5725428,3,8007,443,1671,1671,5733435
NM,2012,health,2007,6692296,80,310521,12522,2078,2087,7002817
NM,2012,hospitals,6834,30606513,935,2354948,132046,7675,7769,32961461
NM,2012,social insurance administration,527,1760372,0,0,0,527,527,1760372
NM,2012,solid waste management,0,0,0,0,0,0,0,0
NM,2012,sewerage,0,0,0,0,0,0,0,0
NM,2012,parks and recreation,605,1855460,36,62239,4853,633,641,1917699
NM,2012,housing and community development,0,0,0,0,0,0,0,0
NM,2012,natural resources,929,3771243,37,40893,2811,945,966,3812136
NM,2012,water transport and terminals,0,0,0,0,0,0,0,0
NM,2012,electric power,0,0,0,0,0,0,0,0
NM,2012,gas supply,0,0,0,0,0,0,0,0
NM,2012,transit,0,0,0,0,0,0,0,0
NM,2012,education total,13765,77931112,13476,15129203,817385,18385,27241,93060315
NM,2012,education - elementary and secondary total,0,0,0,0,0,0,0,0
NM,2012,education - elementary and secondary instructional,0,0,0,0,0,0,0,0
NM,2012,education - elementary and secondary other,0,0,0,0,0,0,0,0
NM,2012,education - higher education total,12940,74651247,13417,15085838,814707,17544,26357,89737085
NM,2012,education - higher education instructional,3765,30593648,3782,6726869,208752,4945,7547,37320517
NM,2012,education - higher education other,9175,44057599,9635,8358969,605955,12599,18810,52416568
NM,2012,education - other,825,3279865,59,43365,2678,841,884,3323230
NM,2012,libraries,0,0,0,0,0,0,0,0
NM,2012,liquor stores,0,0,0,0,0,0,0,0
NM,2012,other and unallocable,2355,8657408,9,16920,1010,2361,2364,8674328
NY,2012,total,221736,1271227222,47989,74750874,2529835,236826,269725,1345978096
NY,2012,financial administration,12893,68402275,153,361055,12456,12963,13046,68763330
NY,2012,other government administration,3732,15732790,532,652709,38978,3952,4264,16385499
NY,2012,judicial and legal,18644,130298692,563,2191589,71379,19050,19207,132490281
NY,2012,police protection total,5822,49713529,192,327333,25652,5967,6014,50040862
NY,2012,police protection - officers,4469,43341767,0,0,0,4469,4469,43341767
NY,2012,police protection - other,1353,6371762,192,327333,25652,1498,1545,6699095
NY,2012,fire protection total,0,0,0,0,0,0,0,0
NY,2012,fire protection - firefighters,0,0,0,0,0,0,0,0
NY,2012,fire protection - other,0,0,0,0,0,0,0,0
NY,2012,corrections,29450,160988889,342,1105625,35072,29648,29792,162094514
NY,2012,highways,10883,55090404,1044,1415898,83062,11354,11927,56506302
NY,2012,air transportation,185,759376,0,0,0,185,185,759376
NY,2012,water transport and terminals,605,3556471,13,30900,1100,612,618,3587371
NY,2012,public welfare,4130,20317994,485,1183611,56594,4451,4615,21501605
NY,2012,health,8524,48631300,326,1259254,33909,8719,8850,49890554
NY,2012,hospitals,39807,208454842,4880,15893552,517092,42765,44687,224348394
NY,2012,social insurance administration,8276,42132804,65,197155,7980,8322,8341,42329959
NY,2012,solid waste management,0,0,0,0,0,0,0,0
NY,2012,sewerage,0,0,0,0,0,0,0,0
NY,2012,parks and recreation,2629,9554180,16,39647,2533,2643,2645,9593827
NY,2012,housing and community development,0,0,0,0,0,0,0,0
NY,2012,natural resources,2982,15592160,57,84270,2941,2999,3039,15676430
NY,2012,water transport and terminals,0,0,0,0,0,0,0,0
NY,2012,electric power,1697,13517116,29,106545,3153,1715,1726,13623661
NY,2012,gas supply,0,0,0,0,0,0,0,0
NY,2012,transit,14503,104204008,129,228309,13684,14581,14632,104432317
NY,2012,education total,46658,266376678,38704,48255226,1586572,56360,85362,314631904
NY,2012,education - elementary and secondary total,0,0,0,0,0,0,0,0
NY,2012,education - elementary and secondary instructional,0,0,0,0,0,0,0,0
NY,2012,education - elementary and secondary other,0,0,0,0,0,0,0,0
NY,2012,education - higher education total,42044,246193044,38579,47985491,1575708,51685,80623,294178535
NY,2012,education - higher education instructional,15165,112270832,19752,29641277,724964,19620,34917,141912109
NY,2012,education - higher education other,26879,133922212,18827,18344214,850744,32065,45706,152266426
NY,2012,education - other,4614,20183634,125,269735,10864,4675,4739,20453369
NY,2012,libraries,0,0,0,0,0,0,0,0
NY,2012,liquor stores,0,0,0,0,0,0,0,0
NY,2012,other and unallocable,10316,57903714,459,1418196,37678,10540,10775,59321910
NC,2012,total,131481,574839804,43410,59117349,3192640,149543,174891,633957153
NC,2012,financial administration,3370,14613471,109,68872,1538,3378,3479,14682343
NC,2012,other government administration,772,4218249,410,836116,39099,993,1182,5054365
NC,2012,judicial and legal,6695,31330860,488,376534,6133,6730,7183,31707394
NC,2012,police protection total,3660,16449630,53,48558,1618,3669,3713,16498188
NC,2012,police protection - officers,2486,12080026,0,0,0,2486,2486,12080026
NC,2012,police protection - other,1174,4369604,53,48558,1618,1183,1227,4418162
NC,2012,fire protection total,0,0,0,0,0,0,0,0
NC,2012,fire protection - firefighters,0,0,0,0,0,0,0,0
NC,2012,fire protection - other,0,0,0,0,0,0,0,0
NC,2012,corrections,20736,63554775,193,116036,1479,20744,20929,63670811
NC,2012,highways,10876,40157543,82,87878,9543,10930,10958,40245421
NC,2012,air transportation,0,0,0,0,0,0,0,0
NC,2012,water transport and terminals,234,994611,4,6200,407,236,238,1000811
NC,2012,public welfare,1111,4015773,37,58533,2047,1123,1148,4074306
NC,2012,health,2561,10348552,157,307963,13659,2638,2718,10656515
NC,2012,hospitals,18028,72516762,1754,4410188,88886,18530,19782,76926950
NC,2012,social insurance administration,2695,11327481,94,100513,1293,2702,2789,11427994
NC,2012,solid waste management,294,1489249,0,0,0,294,294,1489249
NC,2012,sewerage,0,0,0,0,0,0,0,0
NC,2012,parks and recreation,1453,4809418,52,59580,6399,1489,1505,4868998
NC,2012,housing and community development,0,0,0,0,0,0,0,0
NC,2012,natural resources,4663,17884794,25,45075,2883,4679,4688,17929869
NC,2012,water transport and terminals,0,0,0,0,0,0,0,0
NC,2012,electric power,0,0,0,0,0,0,0,0
NC,2012,gas supply,0,0,0,0,0,0,0,0
NC,2012,transit,0,0,0,0,0,0,0,0
NC,2012,education total,49482,259235840,39676,52383289,3005037,66484,89158,311619129
NC,2012,education - elementary and secondary total,0,0,0,0,0,0,0,0
NC,2012,education - elementary and secondary instructional,0,0,0,0,0,0,0,0
NC,2012,education - elementary and secondary other,0,0,0,0,0,0,0,0
NC,2012,education - higher education total,46333,245350341,39460,52222799,3003475,63326,85793,297573140
NC,2012,education - higher education instructional,15044,114351780,13863,29623055,1268102,22218,28907,143974835
NC,2012,education - higher education other,31289,130998561,25597,22599744,1735373,41108,56886,153598305
NC,2012,education - other,3149,13885499,216,160490,1562,3158,3365,14045989
NC,2012,libraries,0,0,0,0,0,0,0,0
NC,2012,liquor stores,0,0,0,0,0,0,0,0
NC,2012,other and unallocable,4851,21892796,276,212014,12619,4924,5127,22104810
ND,2012,total,15622,67739890,9453,8778391,562980,18804,25075,76518281
ND,2012,financial administration,646,2582087,29,47648,2396,659,675,2629735
ND,2012,other government administration,191,820122,152,107194,3741,212,343,927316
ND,2012,judicial and legal,556,2802653,42,31438,1870,566,598,2834091
ND,2012,police protection total,195,900208,5,7886,496,198,200,908094
ND,2012,police protection - officers,148,737123,0,0,0,148,148,737123
ND,2012,police protection - other,47,163085,5,7886,496,50,52,170971
ND,2012,fire protection total,0,0,0,0,0,0,0,0
ND,2012,fire protection - firefighters,0,0,0,0,0,0,0,0
ND,2012,fire protection - other,0,0,0,0,0,0,0,0
ND,2012,corrections,782,2811679,73,179866,6100,817,855,2991545
ND,2012,highways,993,4598088,6,10409,471,996,999,4608497
ND,2012,air transportation,0,0,0,0,0,0,0,0
ND,2012,water transport and terminals,0,0,0,0,0,0,0,0
ND,2012,public welfare,457,1523905,115,200098,12641,528,572,1724003
ND,2012,health,1252,4561284,265,282339,21158,1371,1517,4843623
ND,2012,hospitals,877,2546432,146,204659,7751,921,1023,2751091
ND,2012,social insurance administration,326,1252239,77,96428,5635,358,403,1348667
ND,2012,solid waste management,0,0,0,0,0,0,0,0
ND,2012,sewerage,0,0,0,0,0,0,0,0
ND,2012,parks and recreation,168,507753,12,17226,1001,174,180,524979
ND,2012,housing and community development,0,0,0,0,0,0,0,0
ND,2012,natural resources,579,2529828,38,47736,2377,593,617,2577564
ND,2012,water transport and terminals,0,0,0,0,0,0,0,0
ND,2012,electric power,0,0,0,0,0,0,0,0
ND,2012,gas supply,0,0,0,0,0,0,0,0
ND,2012,transit,0,0,0,0,0,0,0,0
ND,2012,education total,7172,33934601,8367,7400868,489409,9938,15539,41335469
ND,2012,education - elementary and secondary total,0,0,0,0,0,0,0,0
ND,2012,education - elementary and secondary instructional,0,0,0,0,0,0,0,0
ND,2012,education - elementary and secondary other,0,0,0,0,0,0,0,0
ND,2012,education - higher education total,6846,32755966,8324,7335597,486612,9597,15170,40091563
ND,2012,education - higher education instructional,2233,14820422,2571,3939010,175930,3226,4804,18759432
ND,2012,education - higher education other,4613,17935544,5753,3396587,310682,6371,10366,21332131
ND,2012,education - other,326,1178635,43,65271,2797,341,369,1243906
ND,2012,libraries,0,0,0,0,0,0,0,0
ND,2012,liquor stores,0,0,0,0,0,0,0,0
ND,2012,other and unallocable,1428,6369011,126,144596,7934,1473,1554,6513607
OH,2012,total,109216,557401814,78130,90483908,4883371,136861,187346,647885722
OH,2012,financial administration,6342,33851284,251,630257,29484,6510,6593,34481541
OH,2012,other government administration,713,3198141,148,110449,9986,769,861,3308590
OH,2012,judicial and legal,2805,16478108,537,1335124,39938,3031,3342,17813232
OH,2012,police protection total,2606,13148960,8,27191,1395,2614,2614,13176151
OH,2012,police protection - officers,1433,8283847,0,0,0,1433,1433,8283847
OH,2012,police protection - other,1173,4865113,8,27191,1395,1181,1181,4892304
OH,2012,fire protection total,0,0,0,0,0,0,0,0
OH,2012,fire protection - firefighters,0,0,0,0,0,0,0,0
OH,2012,fire protection - other,0,0,0,0,0,0,0,0
OH,2012,corrections,13218,58666898,27,75392,3773,13239,13245,58742290
OH,2012,highways,5746,27447292,743,1714554,105571,6342,6489,29161846
OH,2012,air transportation,0,0,0,0,0,0,0,0
OH,2012,water transport and terminals,0,0,0,0,0,0,0,0
OH,2012,public welfare,2430,13486249,325,667693,48506,2714,2755,14153942
OH,2012,health,3042,17094137,207,490621,26565,3193,3249,17584758
OH,2012,hospitals,12614,61667630,5902,13336109,576888,15873,18516,75003739
OH,2012,social insurance administration,1988,8506918,213,324845,18996,2110,2201,8831763
OH,2012,solid waste management,0,0,0,0,0,0,0,0
OH,2012,sewerage,0,0,0,0,0,0,0,0
OH,2012,parks and recreation,393,1663188,268,368287,24189,530,661,2031475
OH,2012,housing and community development,0,0,0,0,0,0,0,0
OH,2012,natural resources,2223,9842544,384,706478,42067,2461,2607,10549022
OH,2012,water transport and terminals,0,0,0,0,0,0,0,0
OH,2012,electric power,0,0,0,0,0,0,0,0
OH,2012,gas supply,0,0,0,0,0,0,0,0
OH,2012,transit,0,0,0,0,0,0,0,0
OH,2012,education total,50712,269919442,68793,70161914,3930899,72949,119505,340081356
OH,2012,education - elementary and secondary total,0,0,0,0,0,0,0,0
OH,2012,education - elementary and secondary instructional,0,0,0,0,0,0,0,0
OH,2012,education - elementary and secondary other,0,0,0,0,0,0,0,0
OH,2012,education - higher education total,48791,259936774,68618,69867111,3917758,70953,117409,329803885
OH,2012,education - higher education instructional,16246,118262140,22771,34505291,1286511,23529,39017,152767431
OH,2012,education - higher education other,32545,141674634,45847,35361820,2631247,47424,78392,177036454
OH,2012,education - other,1921,9982668,175,294803,13141,1996,2096,10277471
OH,2012,libraries,0,0,0,0,0,0,0,0
OH,2012,liquor stores,0,0,0,0,0,0,0,0
OH,2012,other and unallocable,4384,22431023,324,534994,25114,4526,4708,22966017
OK,2012,total,57749,225106044,25929,22730006,1298605,65104,83678,247836050
OK,2012,financial administration,1459,5556421,26,31885,1710,1466,1485,5588306
OK,2012,other government administration,614,2316702,121,244937,15327,701,735,2561639
OK,2012,judicial and legal,2591,11291351,102,127507,7515,2633,2693,11418858
OK,2012,police protection total,1795,8232615,73,73281,5842,1828,1868,8305896
OK,2012,police protection - officers,969,5281160,3,5371,193,970,972,5286531
OK,2012,police protection - other,826,2951455,70,67910,5649,858,896,3019365
OK,2012,fire protection total,0,0,0,0,0,0,0,0
OK,2012,fire protection - firefighters,0,0,0,0,0,0,0,0
OK,2012,fire protection - other,0,0,0,0,0,0,0,0
OK,2012,corrections,4719,16567025,55,123706,4934,4747,4774,16690731
OK,2012,highways,2870,9658674,0,0,0,2870,2870,9658674
OK,2012,air transportation,10,43349,1,630,63,10,11,43979
OK,2012,water transport and terminals,0,0,0,0,0,0,0,0
OK,2012,public welfare,5682,16109100,4,9510,327,5683,5686,16118610
OK,2012,health,4963,18267894,294,617909,27010,5115,5257,18885803
OK,2012,hospitals,1706,4796e3,65,132139,6185,1741,1771,4928139
OK,2012,social insurance administration,1310,4574663,93,259541,8825,1360,1403,4834204
OK,2012,solid waste management,69,302899,12,7281,660,73,81,310180
OK,2012,sewerage,0,0,0,0,0,0,0,0
OK,2012,parks and recreation,595,1608936,267,285521,28180,754,862,1894457
OK,2012,housing and community development,0,0,0,0,0,0,0,0
OK,2012,natural resources,1628,5758102,833,722140,43713,1876,2461,6480242
OK,2012,water transport and terminals,0,0,0,0,0,0,0,0
OK,2012,electric power,549,3102498,9,16103,757,553,558,3118601
OK,2012,gas supply,0,0,0,0,0,0,0,0
OK,2012,transit,0,0,0,0,0,0,0,0
OK,2012,education total,24244,105969460,23839,19871629,1136493,30685,48083,125841089
OK,2012,education - elementary and secondary total,0,0,0,0,0,0,0,0
OK,2012,education - elementary and secondary instructional,0,0,0,0,0,0,0,0
OK,2012,education - elementary and secondary other,0,0,0,0,0,0,0,0
OK,2012,education - higher education total,22523,99941471,23751,19792435,1131761,28937,46274,119733906
OK,2012,education - higher education instructional,6449,42336309,6583,8545534,292318,8107,13032,50881843
OK,2012,education - higher education other,16074,57605162,17168,11246901,839443,20830,33242,68852063
OK,2012,education - other,1721,6027989,88,79194,4732,1748,1809,6107183
OK,2012,libraries,0,0,0,0,0,0,0,0
OK,2012,liquor stores,0,0,0,0,0,0,0,0
OK,2012,other and unallocable,2945,10950355,135,206287,11064,3009,3080,11156642
OR,2012,total,56559,275360675,24739,42892704,1609661,65653,81298,318253379
OR,2012,financial administration,3669,16150589,176,420341,15228,3756,3845,16570930
OR,2012,other government administration,860,4059158,188,432621,18961,968,1048,4491779
OR,2012,judicial and legal,2860,13623132,170,419807,15829,2949,3030,14042939
OR,2012,police protection total,1330,6626008,44,107870,5161,1359,1374,6733878
OR,2012,police protection - officers,672,3839558,30,81736,3690,693,702,3921294
OR,2012,police protection - other,658,2786450,14,26134,1471,666,672,2812584
OR,2012,fire protection total,0,0,0,0,0,0,0,0
OR,2012,fire protection - firefighters,0,0,0,0,0,0,0,0
OR,2012,fire protection - other,0,0,0,0,0,0,0,0
OR,2012,corrections,5034,22068073,106,363199,7807,5078,5140,22431272
OR,2012,highways,3587,17056526,194,483351,26125,3735,3781,17539877
OR,2012,air transportation,12,55820,1,3132,80,12,13,58952
OR,2012,water transport and terminals,0,0,0,0,0,0,0,0
OR,2012,public welfare,6989,24214561,382,663244,30586,7162,7371,24877805
OR,2012,health,2141,9231408,99,206991,8058,2187,2240,9438399
OR,2012,hospitals,5119,26638891,3658,17935134,447857,7650,8777,44574025
OR,2012,social insurance administration,2169,12221643,46,245429,5349,2199,2215,12467072
OR,2012,solid waste management,0,0,0,0,0,0,0,0
OR,2012,sewerage,0,0,0,0,0,0,0,0
OR,2012,parks and recreation,454,1759933,0,0,0,454,454,1759933
OR,2012,housing and community development,0,0,0,0,0,0,0,0
OR,2012,natural resources,2371,10161775,242,592732,21721,2493,2613,10754507
OR,2012,water transport and terminals,0,0,0,0,0,0,0,0
OR,2012,electric power,0,0,0,0,0,0,0,0
OR,2012,gas supply,0,0,0,0,0,0,0,0
OR,2012,transit,0,0,0,0,0,0,0,0
OR,2012,education total,18327,104163259,19347,20868943,1001617,23987,37674,125032202
OR,2012,education - elementary and secondary total,0,0,0,0,0,0,0,0
OR,2012,education - elementary and secondary instructional,0,0,0,0,0,0,0,0
OR,2012,education - elementary and secondary other,0,0,0,0,0,0,0,0
OR,2012,education - higher education total,17685,101280909,19298,20797586,998966,23329,36983,122078495
OR,2012,education - higher education instructional,10040,70574513,3347,8022808,205540,11201,13387,78597321
OR,2012,education - higher education other,7645,30706396,15951,12774778,793426,12128,23596,43481174
OR,2012,education - other,642,2882350,49,71357,2651,658,691,2953707
OR,2012,libraries,0,0,0,0,0,0,0,0
OR,2012,liquor stores,200,819865,7,9475,560,203,207,829340
OR,2012,other and unallocable,1437,6510034,79,140435,4722,1461,1516,6650469
PA,2012,total,141209,660558331,64863,102891598,3467764,161537,206072,763449929
PA,2012,financial administration,6627,28551168,1032,2270238,100380,7230,7659,30821406
PA,2012,other government administration,2864,12133372,482,2121933,49908,3161,3346,14255305
PA,2012,judicial and legal,2959,21837685,4,3313,219,2960,2963,21840998
PA,2012,police protection total,6411,38798875,236,657127,12239,6485,6647,39456002
PA,2012,police protection - officers,5074,30691246,7,12017,824,5079,5081,30703263
PA,2012,police protection - other,1337,8107629,229,645110,11415,1406,1566,8752739
PA,2012,fire protection total,0,0,0,0,0,0,0,0
PA,2012,fire protection - firefighters,0,0,0,0,0,0,0,0
PA,2012,fire protection - other,0,0,0,0,0,0,0,0
PA,2012,corrections,18261,78845713,746,2393194,52508,18578,19007,81238907
PA,2012,highways,12435,47549576,3130,6993611,223628,13775,15565,54543187
PA,2012,air transportation,119,433389,34,74398,2305,133,153,507787
PA,2012,water transport and terminals,184,796113,50,144524,4429,211,234,940637
PA,2012,public welfare,10726,40771192,1712,3516470,117816,11436,12438,44287662
PA,2012,health,1725,8227341,327,915817,8381,1776,2052,9143158
PA,2012,hospitals,10706,36308714,1753,3015107,103965,11320,12459,39323821
PA,2012,social insurance administration,3848,15565758,777,2254409,78344,4320,4625,17820167
PA,2012,solid waste management,0,0,0,0,0,0,0,0
PA,2012,sewerage,0,0,0,0,0,0,0,0
PA,2012,parks and recreation,1602,6579677,1343,3337148,151038,2512,2945,9916825
PA,2012,housing and community development,0,0,0,0,0,0,0,0
PA,2012,natural resources,5112,23615585,2653,5320564,174888,6131,7765,28936149
PA,2012,water transport and terminals,0,0,0,0,0,0,0,0
PA,2012,electric power,0,0,0,0,0,0,0,0
PA,2012,gas supply,0,0,0,0,0,0,0,0
PA,2012,transit,0,0,0,0,0,0,0,0
PA,2012,education total,48724,263578202,47448,64296790,2129556,61050,96172,327874992
PA,2012,education - elementary and secondary total,0,0,0,0,0,0,0,0
PA,2012,education - elementary and secondary instructional,0,0,0,0,0,0,0,0
PA,2012,education - elementary and secondary other,0,0,0,0,0,0,0,0
PA,2012,education - higher education total,44491,246551649,47041,63372888,2099127,56636,91532,309924537
PA,2012,education - higher education instructional,15094,121760714,13048,37077953,768120,19498,28142,158838667
PA,2012,education - higher education other,29397,124790935,33993,26294935,1331007,37138,63390,151085870
PA,2012,education - other,4233,17026553,407,923902,30429,4414,4640,17950455
PA,2012,libraries,0,0,0,0,0,0,0,0
PA,2012,liquor stores,3113,10578380,2303,4509287,215038,4408,5416,15087667
PA,2012,other and unallocable,5793,26387591,833,1067668,43122,6051,6626,27455259
RI,2012,total,17110,94369032,7116,6914516,247282,18705,24226,101283548
RI,2012,financial administration,840,4490857,4,15556,467,843,844,4506413
RI,2012,other government administration,725,3798165,332,346534,7218,772,1057,4144699
RI,2012,judicial and legal,1136,6669656,15,41016,1537,1146,1151,6710672
RI,2012,police protection total,345,2335104,2,2491,120,346,347,2337595
RI,2012,police protection - officers,262,1877787,0,0,0,262,262,1877787
RI,2012,police protection - other,83,457317,2,2491,120,84,85,459808
RI,2012,fire protection total,0,0,0,0,0,0,0,0
RI,2012,fire protection - firefighters,0,0,0,0,0,0,0,0
RI,2012,fire protection - other,0,0,0,0,0,0,0,0
RI,2012,corrections,1570,10128430,0,0,0,1570,1570,10128430
RI,2012,highways,735,4021559,47,43637,2755,751,782,4065196
RI,2012,air transportation,150,921001,1,1063,18,150,151,922064
RI,2012,water transport and terminals,0,0,0,0,0,0,0,0
RI,2012,public welfare,1211,7052653,12,37563,1466,1220,1223,7090216
RI,2012,health,887,4973334,26,15416,1809,899,913,4988750
RI,2012,hospitals,789,4231349,3,16423,368,791,792,4247772
RI,2012,social insurance administration,439,2179911,19,65262,2321,454,458,2245173
RI,2012,solid waste management,95,534400,3,3073,97,96,98,537473
RI,2012,sewerage,250,1237354,0,0,0,250,250,1237354
RI,2012,parks and recreation,52,198451,0,0,0,52,52,198451
RI,2012,housing and community development,0,0,0,0,0,0,0,0
RI,2012,natural resources,373,2142992,0,0,0,373,373,2142992
RI,2012,water transport and terminals,0,0,0,0,0,0,0,0
RI,2012,electric power,0,0,0,0,0,0,0,0
RI,2012,gas supply,0,0,0,0,0,0,0,0
RI,2012,transit,776,3571067,33,90462,4867,803,809,3661529
RI,2012,education total,5031,26006288,6562,6131354,219615,6454,11593,32137642
RI,2012,education - elementary and secondary total,586,2692056,114,114100,5197,625,700,2806156
RI,2012,education - elementary and secondary instructional,425,2344298,48,73676,1864,439,473,2417974
RI,2012,education - elementary and secondary other,161,347758,66,40424,3333,186,227,388182
RI,2012,education - higher education total,3953,20412191,6435,5991524,213244,5329,10388,26403715
RI,2012,education - higher education instructional,1339,8503933,2206,3685986,76011,1829,3545,12189919
RI,2012,education - higher education other,2614,11908258,4229,2305538,137233,3500,6843,14213796
RI,2012,education - other,492,2902041,13,25730,1174,500,505,2927771
RI,2012,libraries,0,0,0,0,0,0,0,0
RI,2012,liquor stores,0,0,0,0,0,0,0,0
RI,2012,other and unallocable,1706,9876461,57,104666,4624,1735,1763,9981127
SC,2012,total,70749,269293937,21156,22379714,1312184,78585,91905,291673651
SC,2012,financial administration,3299,11010026,138,243484,14484,3385,3437,11253510
SC,2012,other government administration,603,2405830,507,573456,33993,807,1110,2979286
SC,2012,judicial and legal,774,3740334,16,27138,1538,783,790,3767472
SC,2012,police protection total,1955,6871516,13,29368,1580,1965,1968,6900884
SC,2012,police protection - officers,1271,4703014,9,20130,1134,1278,1280,4723144
SC,2012,police protection - other,684,2168502,4,9238,446,687,688,2177740
SC,2012,fire protection total,0,0,0,0,0,0,0,0
SC,2012,fire protection - firefighters,0,0,0,0,0,0,0,0
SC,2012,fire protection - other,0,0,0,0,0,0,0,0
SC,2012,corrections,8365,22872666,61,87458,4374,8391,8426,22960124
SC,2012,highways,4555,14546216,9,20798,1042,4561,4564,14567014
SC,2012,air transportation,11,53766,3,2830,76,11,14,56596
SC,2012,water transport and terminals,482,2657003,5,9663,321,484,487,2666666
SC,2012,public welfare,4651,12691846,11,17526,1060,4656,4662,12709372
SC,2012,health,5427,18361038,413,897173,42731,5684,5840,19258211
SC,2012,hospitals,6898,20236170,220,632024,22541,7029,7118,20868194
SC,2012,social insurance administration,1397,4259150,109,178254,12176,1470,1506,4437404
SC,2012,solid waste management,0,0,0,0,0,0,0,0
SC,2012,sewerage,0,0,0,0,0,0,0,0
SC,2012,parks and recreation,741,1653122,44,27666,3046,760,785,1680788
SC,2012,housing and community development,135,529976,1,420,12,135,136,530396
SC,2012,natural resources,1868,5970272,215,232967,21293,1996,2083,6203239
SC,2012,water transport and terminals,11,66659,0,0,0,11,11,66659
SC,2012,electric power,1812,10745554,13,41195,1707,1822,1825,10786749
SC,2012,gas supply,0,0,0,0,0,0,0,0
SC,2012,transit,0,0,0,0,0,0,0,0
SC,2012,education total,26362,125799357,19324,19287748,1146877,33211,45686,145087105
SC,2012,education - elementary and secondary total,0,0,0,0,0,0,0,0
SC,2012,education - elementary and secondary instructional,0,0,0,0,0,0,0,0
SC,2012,education - elementary and secondary other,0,0,0,0,0,0,0,0
SC,2012,education - higher education total,23484,115644477,19149,19035830,1133463,30253,42633,134680307
SC,2012,education - higher education instructional,8383,53721073,7894,10254855,447702,11057,16277,63975928
SC,2012,education - higher education other,15101,61923404,11255,8780975,685761,19196,26356,70704379
SC,2012,education - other,2878,10154880,175,251918,13414,2958,3053,10406798
SC,2012,libraries,34,114870,0,0,0,34,34,114870
SC,2012,liquor stores,0,0,0,0,0,0,0,0
SC,2012,other and unallocable,1369,4708566,54,70546,3333,1390,1423,4779112
SD,2012,total,12556,49373710,6178,5025672,325688,14401,18734,54399382
SD,2012,financial administration,426,1846557,12,22130,1519,434,438,1868687
SD,2012,other government administration,302,1194157,51,37531,2666,317,353,1231688
SD,2012,judicial and legal,574,2529767,103,139349,8922,625,677,2669116
SD,2012,police protection total,324,1192392,11,18420,1016,331,335,1210812
SD,2012,police protection - officers,197,830098,1,3892,132,198,198,833990
SD,2012,police protection - other,127,362294,10,14528,884,133,137,376822
SD,2012,fire protection total,0,0,0,0,0,0,0,0
SD,2012,fire protection - firefighters,0,0,0,0,0,0,0,0
SD,2012,fire protection - other,0,0,0,0,0,0,0,0
SD,2012,corrections,849,2709291,30,43491,3228,867,879,2752782
SD,2012,highways,941,3609483,42,70162,4595,967,983,3679645
SD,2012,air transportation,0,0,0,0,0,0,0,0
SD,2012,water transport and terminals,0,0,0,0,0,0,0,0
SD,2012,public welfare,1653,5614996,131,225711,14342,1734,1784,5840707
SD,2012,health,566,2274238,145,393253,18775,673,711,2667491
SD,2012,hospitals,349,1103232,58,72956,5671,381,407,1176188
SD,2012,social insurance administration,277,906323,5,4922,323,279,282,911245
SD,2012,solid waste management,0,0,0,0,0,0,0,0
SD,2012,sewerage,0,0,0,0,0,0,0,0
SD,2012,parks and recreation,122,428455,41,48967,4699,149,163,477422
SD,2012,housing and community development,0,0,0,0,0,0,0,0
SD,2012,natural resources,889,3565841,483,500261,34494,1084,1372,4066102
SD,2012,water transport and terminals,0,0,0,0,0,0,0,0
SD,2012,electric power,0,0,0,0,0,0,0,0
SD,2012,gas supply,0,0,0,0,0,0,0,0
SD,2012,transit,0,0,0,0,0,0,0,0
SD,2012,education total,4498,19306917,5017,3389966,220914,5748,9515,22696883
SD,2012,education - elementary and secondary total,0,0,0,0,0,0,0,0
SD,2012,education - elementary and secondary instructional,0,0,0,0,0,0,0,0
SD,2012,education - elementary and secondary other,0,0,0,0,0,0,0,0
SD,2012,education - higher education total,4146,17869233,4998,3362697,218690,5383,9144,21231930
SD,2012,education - higher education instructional,1446,8889473,917,1349640,49287,1725,2363,10239113
SD,2012,education - higher education other,2700,8979760,4081,2013057,169403,3658,6781,10992817
SD,2012,education - other,352,1437684,19,27269,2224,365,371,1464953
SD,2012,libraries,0,0,0,0,0,0,0,0
SD,2012,liquor stores,0,0,0,0,0,0,0,0
SD,2012,other and unallocable,786,3092061,49,58553,4524,812,835,3150614
TN,2012,total,71158,279785428,27121,25748464,1534228,80215,98279,305533892
TN,2012,financial administration,3278,13670297,43,77964,5360,3310,3321,13748261
TN,2012,other government administration,808,3267903,16,11637,537,811,824,3279540
TN,2012,judicial and legal,2446,12849596,35,47251,1914,2457,2481,12896847
TN,2012,police protection total,1538,6762795,5,15500,660,1542,1543,6778295
TN,2012,police protection - officers,1067,5230534,0,0,0,1067,1067,5230534
TN,2012,police protection - other,471,1532261,5,15500,660,475,476,1547761
TN,2012,fire protection total,0,0,0,0,0,0,0,0
TN,2012,fire protection - firefighters,0,0,0,0,0,0,0,0
TN,2012,fire protection - other,0,0,0,0,0,0,0,0
TN,2012,corrections,6876,20216272,51,111140,6792,6917,6927,20327412
TN,2012,highways,3790,12291550,0,0,0,3790,3790,12291550
TN,2012,air transportation,0,0,0,0,0,0,0,0
TN,2012,water transport and terminals,0,0,0,0,0,0,0,0
TN,2012,public welfare,7340,24123036,0,0,0,7340,7340,24123036
TN,2012,health,4147,16914270,119,349418,14640,4231,4266,17263688
TN,2012,hospitals,4154,14469620,118,448417,18238,4258,4272,14918037
TN,2012,social insurance administration,1266,4092690,310,581600,41826,1518,1576,4674290
TN,2012,solid waste management,0,0,0,0,0,0,0,0
TN,2012,sewerage,0,0,0,0,0,0,0,0
TN,2012,parks and recreation,979,2463442,201,151248,17348,1084,1180,2614690
TN,2012,housing and community development,0,0,0,0,0,0,0,0
TN,2012,natural resources,3502,13862467,521,729243,59893,3851,4023,14591710
TN,2012,water transport and terminals,0,0,0,0,0,0,0,0
TN,2012,electric power,0,0,0,0,0,0,0,0
TN,2012,gas supply,0,0,0,0,0,0,0,0
TN,2012,transit,0,0,0,0,0,0,0,0
TN,2012,education total,28348,124821691,25607,23138278,1363914,36401,53955,147959969
TN,2012,education - elementary and secondary total,0,0,0,0,0,0,0,0
TN,2012,education - elementary and secondary instructional,0,0,0,0,0,0,0,0
TN,2012,education - elementary and secondary other,0,0,0,0,0,0,0,0
TN,2012,education - higher education total,26358,117630727,25355,22856276,1349799,34325,51713,140487003
TN,2012,education - higher education instructional,8654,53235525,10698,12262568,544594,11895,19352,65498093
TN,2012,education - higher education other,17704,64395202,14657,10593708,805205,22430,32361,74988910
TN,2012,education - other,1990,7190964,252,282002,14115,2076,2242,7472966
TN,2012,libraries,0,0,0,0,0,0,0,0
TN,2012,liquor stores,0,0,0,0,0,0,0,0
TN,2012,other and unallocable,2686,9979799,95,86768,3106,2705,2781,10066567
TX,2012,total,266065,1230448275,84850,116700852,6228610,301260,350915,1347149127
TX,2012,financial administration,6789,30763232,142,121544,5288,6819,6931,30884776
TX,2012,other government administration,1952,8938115,436,472553,26393,2102,2388,9410668
TX,2012,judicial and legal,5508,27782457,121,534109,16965,5605,5629,28316566
TX,2012,police protection total,6535,28664122,88,97626,7832,6579,6623,28761748
TX,2012,police protection - officers,3455,17851646,0,0,0,3455,3455,17851646
TX,2012,police protection - other,3080,10812476,88,97626,7832,3124,3168,10910102
TX,2012,fire protection total,0,0,0,0,0,0,0,0
TX,2012,fire protection - firefighters,0,0,0,0,0,0,0,0
TX,2012,fire protection - other,0,0,0,0,0,0,0,0
TX,2012,corrections,40557,119811758,622,844064,52166,40852,41179,120655822
TX,2012,highways,12428,52819913,261,579035,23947,12564,12689,53398948
TX,2012,air transportation,0,0,0,0,0,0,0,0
TX,2012,water transport and terminals,0,0,0,0,0,0,0,0
TX,2012,public welfare,22478,69452737,51,115717,5085,22507,22529,69568454
TX,2012,health,18485,80624966,800,2258132,77236,18921,19285,82883098
TX,2012,hospitals,23242,106649343,2725,10833649,299476,24934,25967,117482992
TX,2012,social insurance administration,4407,15408477,38,65352,3150,4425,4445,15473829
TX,2012,solid waste management,0,0,0,0,0,0,0,0
TX,2012,sewerage,0,0,0,0,0,0,0,0
TX,2012,parks and recreation,1088,3400634,144,162602,16191,1179,1232,3563236
TX,2012,housing and community development,0,0,0,0,0,0,0,0
TX,2012,natural resources,10111,45651784,2074,2136741,89024,10614,12185,47788525
TX,2012,water transport and terminals,0,0,0,0,0,0,0,0
TX,2012,electric power,0,0,0,0,0,0,0,0
TX,2012,gas supply,0,0,0,0,0,0,0,0
TX,2012,transit,0,0,0,0,0,0,0,0
TX,2012,education total,105333,609397114,77162,98070597,5586141,136896,182495,707467711
TX,2012,education - elementary and secondary total,18,87890,4,3204,128,19,22,91094
TX,2012,education - elementary and secondary instructional,13,61052,0,0,0,13,13,61052
TX,2012,education - elementary and secondary other,5,26838,4,3204,128,6,9,30042
TX,2012,education - higher education total,101098,590723421,76840,97129014,5544589,132427,177938,687852435
TX,2012,education - higher education instructional,25327,252669824,26155,44496478,1867175,35877,51482,297166302
TX,2012,education - higher education other,75771,338053597,50685,52632536,3677414,96550,126456,390686133
TX,2012,education - other,4217,18585803,318,938379,41424,4450,4535,19524182
TX,2012,libraries,0,0,0,0,0,0,0,0
TX,2012,liquor stores,0,0,0,0,0,0,0,0
TX,2012,other and unallocable,7152,31083623,186,409131,19716,7263,7338,31492754
UT,2012,total,44247,198228797,25991,29318575,1591396,53236,70238,227547372
UT,2012,financial administration,2344,10652070,202,219157,15215,2429,2546,10871227
UT,2012,other government administration,381,1902516,157,166981,9853,436,538,2069497
UT,2012,judicial and legal,1547,6888243,99,270182,11683,1613,1646,7158425
UT,2012,police protection total,807,3242072,36,34138,2225,820,843,3276210
UT,2012,police protection - officers,417,1888756,0,0,0,417,417,1888756
UT,2012,police protection - other,390,1353316,36,34138,2225,403,426,1387454
UT,2012,fire protection total,0,0,0,0,0,0,0,0
UT,2012,fire protection - firefighters,0,0,0,0,0,0,0,0
UT,2012,fire protection - other,0,0,0,0,0,0,0,0
UT,2012,corrections,2935,10623885,216,170843,12985,3008,3151,10794728
UT,2012,highways,1588,6651710,3,4072,299,1590,1591,6655782
UT,2012,air transportation,0,0,0,0,0,0,0,0
UT,2012,water transport and terminals,0,0,0,0,0,0,0,0
UT,2012,public welfare,2396,8272970,180,299491,17141,2493,2576,8572461
UT,2012,health,1850,7331490,294,515496,25651,1995,2144,7846986
UT,2012,hospitals,6841,27174955,1235,1947327,83763,7314,8076,29122282
UT,2012,social insurance administration,1040,3895538,34,88308,3840,1062,1074,3983846
UT,2012,solid waste management,0,0,0,0,0,0,0,0
UT,2012,sewerage,0,0,0,0,0,0,0,0
UT,2012,parks and recreation,247,791625,54,50929,4409,272,301,842554
UT,2012,housing and community development,0,0,0,0,0,0,0,0
UT,2012,natural resources,1261,4709526,161,121858,9785,1316,1422,4831384
UT,2012,water transport and terminals,0,0,0,0,0,0,0,0
UT,2012,electric power,0,0,0,0,0,0,0,0
UT,2012,gas supply,0,0,0,0,0,0,0,0
UT,2012,transit,0,0,0,0,0,0,0,0
UT,2012,education total,19212,99345560,22961,25237401,1377378,26994,42173,124582961
UT,2012,education - elementary and secondary total,0,0,0,0,0,0,0,0
UT,2012,education - elementary and secondary instructional,0,0,0,0,0,0,0,0
UT,2012,education - elementary and secondary other,0,0,0,0,0,0,0,0
UT,2012,education - higher education total,17807,93310149,21751,23705952,1287749,25081,39558,117016101
UT,2012,education - higher education instructional,6038,46835322,8223,12711561,436697,8505,14261,59546883
UT,2012,education - higher education other,11769,46474827,13528,10994391,851052,16576,25297,57469218
UT,2012,education - other,1405,6035411,1210,1531449,89629,1913,2615,7566860
UT,2012,libraries,0,0,0,0,0,0,0,0
UT,2012,liquor stores,250,662696,300,177739,16503,343,550,840435
UT,2012,other and unallocable,1548,6083941,59,14653,666,1551,1607,6098594
VT,2012,total,12994,59622459,3716,5516197,206543,14197,16710,65138656
VT,2012,financial administration,579,2468457,14,11220,782,584,593,2479677
VT,2012,other government administration,473,1876019,216,510891,2287,486,689,2386910
VT,2012,judicial and legal,678,2906427,21,12061,718,682,699,2918488
VT,2012,police protection total,619,3061440,50,27300,1670,629,669,3088740
VT,2012,police protection - officers,309,1773986,6,1318,91,310,315,1775304
VT,2012,police protection - other,310,1287454,44,25982,1579,319,354,1313436
VT,2012,fire protection total,0,0,0,0,0,0,0,0
VT,2012,fire protection - firefighters,0,0,0,0,0,0,0,0
VT,2012,fire protection - other,0,0,0,0,0,0,0,0
VT,2012,corrections,1102,4419581,5,3102,213,1103,1107,4422683
VT,2012,highways,1024,4163125,4,1349,109,1025,1028,4164474
VT,2012,air transportation,0,0,0,0,0,0,0,0
VT,2012,water transport and terminals,0,0,0,0,0,0,0,0
VT,2012,public welfare,1312,5393796,38,32099,1356,1320,1350,5425895
VT,2012,health,463,1982485,25,10281,864,468,488,1992766
VT,2012,hospitals,233,1046427,4,2622,159,234,237,1049049
VT,2012,social insurance administration,269,1054478,0,0,0,269,269,1054478
VT,2012,solid waste management,0,0,0,0,0,0,0,0
VT,2012,sewerage,0,0,0,0,0,0,0,0
VT,2012,parks and recreation,113,475115,4,2256,157,114,117,477371
VT,2012,housing and community development,0,0,0,0,0,0,0,0
VT,2012,natural resources,561,2635333,6,12486,346,564,567,2647819
VT,2012,water transport and terminals,0,0,0,0,0,0,0,0
VT,2012,electric power,0,0,0,0,0,0,0,0
VT,2012,gas supply,0,0,0,0,0,0,0,0
VT,2012,transit,0,0,0,0,0,0,0,0
VT,2012,education total,4375,22818812,3265,4829176,194560,5508,7640,27647988
VT,2012,education - elementary and secondary total,0,0,0,0,0,0,0,0
VT,2012,education - elementary and secondary instructional,0,0,0,0,0,0,0,0
VT,2012,education - elementary and secondary other,0,0,0,0,0,0,0,0
VT,2012,education - higher education total,3953,20894091,3242,4793885,192961,5076,7195,25687976
VT,2012,education - higher education instructional,1067,8799611,1245,2176001,62445,1423,2312,10975612
VT,2012,education - higher education other,2886,12094480,1997,2617884,130516,3653,4883,14712364
VT,2012,education - other,422,1924721,23,35291,1599,432,445,1960012
VT,2012,libraries,0,0,0,0,0,0,0,0
VT,2012,liquor stores,53,234559,0,0,0,53,53,234559
VT,2012,other and unallocable,1140,5086405,64,61354,3322,1158,1204,5147759
VA,2012,total,107097,483101801,55602,68156850,3369737,126238,162699,551258651
VA,2012,financial administration,3896,16944828,501,804578,56084,4214,4397,17749406
VA,2012,other government administration,501,2608026,513,860505,40220,739,1014,3468531
VA,2012,judicial and legal,3578,17159794,381,486622,15914,3670,3959,17646416
VA,2012,police protection total,2964,14028438,155,277270,14952,3048,3119,14305708
VA,2012,police protection - officers,2252,11422260,7,22540,930,2257,2259,11444800
VA,2012,police protection - other,712,2606178,148,254730,14022,791,860,2860908
VA,2012,fire protection total,0,0,0,0,0,0,0,0
VA,2012,fire protection - firefighters,0,0,0,0,0,0,0,0
VA,2012,fire protection - other,0,0,0,0,0,0,0,0
VA,2012,corrections,13511,43577064,320,541306,35132,13710,13831,44118370
VA,2012,highways,7136,32173486,171,305348,14538,7218,7307,32478834
VA,2012,air transportation,0,0,0,0,0,0,0,0
VA,2012,water transport and terminals,106,638709,2,4353,297,108,108,643062
VA,2012,public welfare,2705,11121640,359,704078,37962,2919,3064,11825718
VA,2012,health,5066,20539082,722,1204812,70518,5464,5788,21743894
VA,2012,hospitals,13799,53242126,2394,4729874,177051,14800,16193,57972e3
VA,2012,social insurance administration,1234,4728436,562,1214851,76881,1668,1796,5943287
VA,2012,solid waste management,0,0,0,0,0,0,0,0
VA,2012,sewerage,0,0,0,0,0,0,0,0
VA,2012,parks and recreation,665,2749386,894,904180,77824,1105,1559,3653566
VA,2012,housing and community development,0,0,0,0,0,0,0,0
VA,2012,natural resources,2334,11094116,615,948866,63691,2694,2949,12042982
VA,2012,water transport and terminals,0,0,0,0,0,0,0,0
VA,2012,electric power,0,0,0,0,0,0,0,0
VA,2012,gas supply,0,0,0,0,0,0,0,0
VA,2012,transit,0,0,0,0,0,0,0,0
VA,2012,education total,45114,231388438,46021,52525562,2473407,59175,91135,283914e3
VA,2012,education - elementary and secondary total,0,0,0,0,0,0,0,0
VA,2012,education - elementary and secondary instructional,0,0,0,0,0,0,0,0
VA,2012,education - elementary and secondary other,0,0,0,0,0,0,0,0
VA,2012,education - higher education total,42671,219970134,45505,51683788,2429261,56484,88176,271653922
VA,2012,education - higher education instructional,14825,110986773,16256,26676161,700650,18799,31081,137662934
VA,2012,education - higher education other,27846,108983361,29249,25007627,1728611,37685,57095,133990988
VA,2012,education - other,2443,11418304,516,841774,44146,2691,2959,12260078
VA,2012,libraries,0,0,0,0,0,0,0,0
VA,2012,liquor stores,845,2940130,1490,1842516,168864,1799,2335,4782646
VA,2012,other and unallocable,3643,18168102,502,802129,46402,3907,4145,18970231
WA,2012,total,103107,490860532,48589,65136320,3148040,120886,151696,555996852
WA,2012,financial administration,2687,13384664,61,189923,3525,2705,2748,13574587
WA,2012,other government administration,1002,4685976,691,2439659,79526,1451,1693,7125635
WA,2012,judicial and legal,1892,10507236,79,294044,5018,1919,1971,10801280
WA,2012,police protection total,2160,12355568,78,183684,6638,2198,2238,12539252
WA,2012,police protection - officers,830,5349284,27,50560,2268,843,857,5399844
WA,2012,police protection - other,1330,7006284,51,133124,4370,1355,1381,7139408
WA,2012,fire protection total,0,0,0,0,0,0,0,0
WA,2012,fire protection - firefighters,0,0,0,0,0,0,0,0
WA,2012,fire protection - other,0,0,0,0,0,0,0,0
WA,2012,corrections,8465,33591932,218,250530,10612,8525,8683,33842462
WA,2012,highways,7039,34591056,175,389901,8651,7088,7214,34980957
WA,2012,air transportation,0,0,0,0,0,0,0,0
WA,2012,water transport and terminals,2,9864,6,600,106,3,8,10464
WA,2012,public welfare,10287,44017838,695,1370068,66132,10660,10982,45387906
WA,2012,health,6437,25177118,99,334108,8347,6485,6536,25511226
WA,2012,hospitals,8294,43727076,3123,12439798,254000,9729,11417,56166874
WA,2012,social insurance administration,3973,17263686,982,1303095,109020,4588,4955,18566781
WA,2012,solid waste management,519,2715026,9,15848,1412,527,528,2730874
WA,2012,sewerage,0,0,0,0,0,0,0,0
WA,2012,parks and recreation,547,2363120,12,24131,491,549,559,2387251
WA,2012,housing and community development,74,345562,0,0,0,74,74,345562
WA,2012,natural resources,4479,19356182,125,253835,9750,4534,4604,19610017
WA,2012,water transport and terminals,0,0,0,0,0,0,0,0
WA,2012,electric power,0,0,0,0,0,0,0,0
WA,2012,gas supply,0,0,0,0,0,0,0,0
WA,2012,transit,0,0,0,0,0,0,0,0
WA,2012,education total,40480,206727374,42152,45442786,2578831,55049,82632,252170160
WA,2012,education - elementary and secondary total,0,0,0,0,0,0,0,0
WA,2012,education - elementary and secondary instructional,0,0,0,0,0,0,0,0
WA,2012,education - elementary and secondary other,0,0,0,0,0,0,0,0
WA,2012,education - higher education total,38495,198018372,41831,45080412,2560222,52959,80326,243098784
WA,2012,education - higher education instructional,12770,81994965,9336,18284973,639238,16380,22106,100279938
WA,2012,education - higher education other,25725,116023407,32495,26795439,1920984,36579,58220,142818846
WA,2012,education - other,1985,8709002,321,362374,18609,2090,2306,9071376
WA,2012,libraries,0,0,0,0,0,0,0,0
WA,2012,liquor stores,831,2641544,5,7596,422,833,836,2649140
WA,2012,other and unallocable,3939,17399710,79,196714,5559,3969,4018,17596424
WV,2012,total,36421,134074423,12495,11118374,647495,40295,48916,145192797
WV,2012,financial administration,1906,5718762,46,69284,3736,1927,1952,5788046
WV,2012,other government administration,220,815614,245,692988,25816,376,465,1508602
WV,2012,judicial and legal,1539,6989706,38,67292,2758,1554,1577,7056998
WV,2012,police protection total,1038,4171144,22,12642,906,1043,1060,4183786
WV,2012,police protection - officers,626,3114946,0,0,0,626,626,3114946
WV,2012,police protection - other,412,1056198,22,12642,906,417,434,1068840
WV,2012,fire protection total,0,0,0,0,0,0,0,0
WV,2012,fire protection - firefighters,0,0,0,0,0,0,0,0
WV,2012,fire protection - other,0,0,0,0,0,0,0,0
WV,2012,corrections,3412,8867300,6,6932,636,3416,3418,8874232
WV,2012,highways,5237,16574014,28,47875,3662,5259,5265,16621889
WV,2012,air transportation,3,12118,0,0,0,3,3,12118
WV,2012,water transport and terminals,3,12888,0,0,0,3,3,12888
WV,2012,public welfare,3430,8816055,50,50928,3740,3453,3480,8866983
WV,2012,health,783,2579018,67,76474,3918,807,850,2655492
WV,2012,hospitals,1712,4628696,103,128446,8508,1763,1815,4757142
WV,2012,social insurance administration,584,1736758,69,70980,5586,617,653,1807738
WV,2012,solid waste management,14,53016,0,0,0,14,14,53016
WV,2012,sewerage,0,0,0,0,0,0,0,0
WV,2012,parks and recreation,401,854386,416,329856,43714,648,817,1184242
WV,2012,housing and community development,0,0,0,0,0,0,0,0
WV,2012,natural resources,1857,6538995,187,146386,13615,1936,2044,6685381
WV,2012,water transport and terminals,0,0,0,0,0,0,0,0
WV,2012,electric power,0,0,0,0,0,0,0,0
WV,2012,gas supply,0,0,0,0,0,0,0,0
WV,2012,transit,7,25816,0,0,0,7,7,25816
WV,2012,education total,11904,57384553,11120,9337422,526191,15072,23024,66721975
WV,2012,education - elementary and secondary total,0,0,0,0,0,0,0,0
WV,2012,education - elementary and secondary instructional,0,0,0,0,0,0,0,0
WV,2012,education - elementary and secondary other,0,0,0,0,0,0,0,0
WV,2012,education - higher education total,10717,52099495,10929,9053928,516445,13827,21646,61153423
WV,2012,education - higher education instructional,3772,24703809,4459,5502889,179565,4853,8231,30206698
WV,2012,education - higher education other,6945,27395686,6470,3551039,336880,8974,13415,30946725
WV,2012,education - other,1187,5285058,191,283494,9746,1245,1378,5568552
WV,2012,libraries,0,0,0,0,0,0,0,0
WV,2012,liquor stores,49,133198,2,3252,270,51,51,136450
WV,2012,other and unallocable,2322,8162386,96,77617,4439,2346,2418,8240003
WI,2012,total,55795,273628155,49313,47973070,2610814,70543,105108,321601225
WI,2012,financial administration,2073,9952430,342,602000,37954,2288,2415,10554430
WI,2012,other government administration,455,2078870,306,726436,28799,618,761,2805306
WI,2012,judicial and legal,2053,12824420,261,800821,28614,2215,2314,13625241
WI,2012,police protection total,738,3730772,27,66358,3241,757,765,3797130
WI,2012,police protection - officers,542,2908739,6,24873,974,548,548,2933612
WI,2012,police protection - other,196,822033,21,41485,2267,209,217,863518
WI,2012,fire protection total,0,0,0,0,0,0,0,0
WI,2012,fire protection - firefighters,0,0,0,0,0,0,0,0
WI,2012,fire protection - other,0,0,0,0,0,0,0,0
WI,2012,corrections,9288,38387413,654,1966959,62461,9641,9942,40354372
WI,2012,highways,1346,7086565,70,159026,6809,1384,1416,7245591
WI,2012,air transportation,0,0,0,0,0,0,0,0
WI,2012,water transport and terminals,0,0,0,0,0,0,0,0
WI,2012,public welfare,1767,7670430,338,793009,49652,2048,2105,8463439
WI,2012,health,1320,6444980,361,1010600,36733,1527,1681,7455580
WI,2012,hospitals,3150,12191129,499,1451898,52439,3446,3649,13643027
WI,2012,social insurance administration,920,3851035,32,70540,4039,943,952,3921575
WI,2012,solid waste management,0,0,0,0,0,0,0,0
WI,2012,sewerage,0,0,0,0,0,0,0,0
WI,2012,parks and recreation,114,461391,54,48947,3144,132,168,510338
WI,2012,housing and community development,0,0,0,0,0,0,0,0
WI,2012,natural resources,1799,7772541,917,1057982,56697,2118,2716,8830523
WI,2012,water transport and terminals,0,0,0,0,0,0,0,0
WI,2012,electric power,0,0,0,0,0,0,0,0
WI,2012,gas supply,0,0,0,0,0,0,0,0
WI,2012,transit,0,0,0,0,0,0,0,0
WI,2012,education total,26347,139050698,44650,37693762,2168975,38600,70997,176744460
WI,2012,education - elementary and secondary total,0,0,0,0,0,0,0,0
WI,2012,education - elementary and secondary instructional,0,0,0,0,0,0,0,0
WI,2012,education - elementary and secondary other,0,0,0,0,0,0,0,0
WI,2012,education - higher education total,25520,135048742,44347,36937668,2133672,37574,69867,171986410
WI,2012,education - higher education instructional,8618,57171968,12314,13945715,675865,12436,20932,71117683
WI,2012,education - higher education other,16902,77876774,32033,22991953,1457807,25138,48935,100868727
WI,2012,education - other,827,4001956,303,756094,35303,1026,1130,4758050
WI,2012,libraries,0,0,0,0,0,0,0,0
WI,2012,liquor stores,0,0,0,0,0,0,0,0
WI,2012,other and unallocable,4425,22125481,802,1524732,71257,4826,5227,23650213
WY,2012,total,12486,54108634,3505,3298032,210622,13672,15991,57406666
WY,2012,financial administration,569,2854538,6,12865,530,571,575,2867403
WY,2012,other government administration,144,810820,92,114260,6437,179,236,925080
WY,2012,judicial and legal,528,2846067,44,147631,4243,551,572,2993698
WY,2012,police protection total,291,1373023,0,0,0,291,291,1373023
WY,2012,police protection - officers,194,845455,0,0,0,194,194,845455
WY,2012,police protection - other,97,527568,0,0,0,97,97,527568
WY,2012,fire protection total,0,0,0,0,0,0,0,0
WY,2012,fire protection - firefighters,0,0,0,0,0,0,0,0
WY,2012,fire protection - other,0,0,0,0,0,0,0,0
WY,2012,corrections,1375,5033175,4,6800,441,1377,1379,5039975
WY,2012,highways,1783,7094566,94,191462,11948,1851,1877,7286028
WY,2012,air transportation,0,0,0,0,0,0,0,0
WY,2012,water transport and terminals,0,0,0,0,0,0,0,0
WY,2012,public welfare,583,2339374,23,65932,2871,599,606,2405306
WY,2012,health,910,4087692,95,267815,9257,962,1005,4355507
WY,2012,hospitals,757,2546964,22,53590,2244,769,779,2600554
WY,2012,social insurance administration,120,453502,5,7699,442,122,125,461201
WY,2012,solid waste management,0,0,0,0,0,0,0,0
WY,2012,sewerage,0,0,0,0,0,0,0,0
WY,2012,parks and recreation,170,737545,52,64717,3363,189,222,802262
WY,2012,housing and community development,0,0,0,0,0,0,0,0
WY,2012,natural resources,967,4334852,23,35253,2209,980,990,4370105
WY,2012,water transport and terminals,0,0,0,0,0,0,0,0
WY,2012,electric power,0,0,0,0,0,0,0,0
WY,2012,gas supply,0,0,0,0,0,0,0,0
WY,2012,transit,0,0,0,0,0,0,0,0
WY,2012,education total,3323,15446957,3007,2271671,163110,4245,6330,17718628
WY,2012,education - elementary and secondary total,0,0,0,0,0,0,0,0
WY,2012,education - elementary and secondary instructional,0,0,0,0,0,0,0,0
WY,2012,education - elementary and secondary other,0,0,0,0,0,0,0,0
WY,2012,education - higher education total,3102,14328416,3002,2262659,162624,4021,6104,16591075
WY,2012,education - higher education instructional,1059,6877119,781,992713,49483,1339,1840,7869832
WY,2012,education - higher education other,2043,7451297,2221,1269946,113141,2682,4264,8721243
WY,2012,education - other,221,1118541,5,9012,486,224,226,1127553
WY,2012,libraries,0,0,0,0,0,0,0,0
WY,2012,liquor stores,41,157944,0,0,0,41,41,157944
WY,2012,other and unallocable,925,3991615,38,58337,3527,945,963,4049952
