state,government_function,full_time_equivalent_employees,total_march_pay,full_time_employees,part_time_employees,full_time_pay,part_time_pay,part_time_hours,year
US,total,10227429,27998605994,9155605,2844746,26087584797,1911021197,184610515,1997
US,financial administration,193799,503890918,183592,37870,482091382,21799536,1929456,1997
US,other government administration,195945,537065493,177285,146204,489095879,47969614,3520075,1997
US,judicial and legal,208363,603617850,197583,29970,577621147,25996703,1932358,1997
US,police protection - officers,546501,1957404578,537076,29522,1941022888,16381690,1675628,1997
US,police protection - other,159677,380666257,138623,56970,348077253,32589004,3699551,1997
US,fire protection - firefighters,256374,929435722,244920,84426,912095870,17339852,2062205,1997
US,fire protection - other,20778,60323381,18965,7627,57163053,3160328,331437,1997
US,corrections,212885,592369224,205494,14851,578679040,13690184,1278296,1997
US,streets and highways,282860,718905485,273495,23320,703250989,15654496,1710055,1997
US,air transportation,34069,102534723,32658,2713,100246971,2287752,248363,1997
US,water transport and terminals,7949,25806609,7481,946,24970307,836302,82160,1997
US,public welfare,254125,611639928,234549,38817,578109193,33530735,3373721,1997
US,health,214824,554246182,189701,52831,501721042,52525140,4358205,1997
US,hospitals,515721,1363654533,446036,119100,1197506439,166148094,12173134,1997
US,solid waste management,106463,266043247,100956,12183,257508367,8534880,995518,1997
US,sewerage,121726,348728609,118970,8815,343163450,5565159,516947,1997
US,parks and recreation,195457,419677396,142374,148342,343644116,76033280,9302794,1997
US,housing and community development,115062,291681806,108720,13854,279681765,12000041,1092883,1997
US,natural resources,34216,86289131,31438,8921,81668306,4620825,496091,1997
US,water transport and terminals,152619,433082380,148383,15059,424900579,8181801,800823,1997
US,electric power,72873,274444257,71607,2289,271601527,2842730,223787,1997
US,gas supply,9764,26491708,9642,208,26288596,203112,21526,1997
US,transit,171918,596866921,163284,14403,578553757,18313164,1503718,1997
US,education - elementary and secondary instructional,3836878,11572990847,3555178,730864,11033955158,539035689,47876106,1997
US,education - elementary and secondary other,1643328,3021318417,1310646,761230,2525422444,495895973,56201755,1997
US,education - higher education instructional,129713,448861688,79357,156172,320831878,128029810,8705849,1997
US,education - higher education other,156467,357605363,111990,138860,293230354,64375009,7714082,1997
US,libraries,109243,232301583,77212,77817,184058608,48242975,5554745,1997
US,other and unallocable,267832,680661758,238390,110562,631424439,49237319,5229247,1997
AL,total,175369,365407830,165077,26161,348809288,16598542,1791619,1997
AL,financial administration,3358,7223234,3282,218,7102087,121147,14596,1997
AL,other government administration,2352,5248924,2169,1624,4609775,639149,34613,1997
AL,judicial and legal,1500,3397968,1377,493,3088745,309223,23721,1997
AL,police protection - officers,8492,21290528,8392,259,21135551,154977,18677,1997
AL,police protection - other,2113,3724739,1886,677,3413797,310942,41611,1997
AL,fire protection - firefighters,4648,11911455,4485,683,11703695,207760,29253,1997
AL,fire protection - other,190,416860,184,32,407889,8971,1148,1997
AL,corrections,2564,5355122,2469,147,5243181,111941,17062,1997
AL,streets and highways,6980,12541869,6815,305,12307571,234298,29812,1997
AL,air transportation,445,960871,406,65,900263,60608,6820,1997
AL,water transport and terminals,174,278822,174,0,278822,0,0,1997
AL,public welfare,1204,1724259,1044,289,1527737,196522,28387,1997
AL,health,4381,8945219,4032,818,8370888,574331,62001,1997
AL,hospitals,22859,50305934,19072,5936,42756010,7549924,662371,1997
AL,solid waste management,3562,6028743,3478,161,5911939,116804,15114,1997
AL,sewerage,1210,2716734,1200,30,2703451,13283,2183,1997
AL,parks and recreation,3309,5722837,2645,1535,4968184,754653,118166,1997
AL,housing and community development,2460,5382907,2355,220,5226841,156066,17653,1997
AL,natural resources,264,444656,233,48,414101,30555,4528,1997
AL,water transport and terminals,3351,7494509,3261,272,7361303,133206,17385,1997
AL,electric power,1130,3197134,1105,33,3163302,33832,4300,1997
AL,gas supply,843,2178803,818,40,2149714,29089,4465,1997
AL,transit,134,225454,105,46,191161,34293,5344,1997
AL,education - elementary and secondary instructional,65776,154728843,64528,5536,152959587,1769256,206970,1997
AL,education - elementary and secondary other,26253,33333549,24353,5364,31111216,2222333,319353,1997
AL,libraries,950,1712635,752,457,1442185,270450,34851,1997
AL,other and unallocable,4867,8915222,4457,873,8360293,554929,71235,1997
AK,total,23132,83188328,20734,7347,78173856,5014472,409168,1997
AK,financial administration,798,2902745,773,66,2835462,67283,4836,1997
AK,other government administration,775,2711470,695,443,2513076,198394,14338,1997
AK,judicial and legal,97,411005,97,1,409899,1106,36,1997
AK,police protection - officers,731,3637121,708,56,3594211,42910,3563,1997
AK,police protection - other,446,1740060,431,46,1709408,30652,2982,1997
AK,fire protection - firefighters,545,2627429,512,171,2566626,60803,5831,1997
AK,fire protection - other,22,66214,18,11,57668,8546,806,1997
AK,corrections,37,132891,36,3,127938,4953,310,1997
AK,streets and highways,666,2562277,641,86,2507771,54506,4395,1997
AK,air transportation,77,277091,75,6,270389,6702,489,1997
AK,water transport and terminals,114,417985,103,22,387105,30880,1847,1997
AK,public welfare,163,544538,141,44,511005,33533,3946,1997
AK,health,449,1225260,394,80,1111881,113379,9350,1997
AK,hospitals,386,1320017,313,114,1136319,183698,12465,1997
AK,solid waste management,394,1504654,376,56,1464227,40427,3403,1997
AK,sewerage,331,1293341,312,66,1250229,43112,3487,1997
AK,parks and recreation,480,1098249,255,414,754787,343462,38991,1997
AK,housing and community development,594,1986225,375,247,1357321,628904,36482,1997
AK,natural resources,28,125075,27,2,123144,1931,133,1997
AK,water transport and terminals,378,1127082,359,71,1086491,40591,3193,1997
AK,electric power,563,2638227,555,14,2616381,21846,1174,1997
AK,gas supply,0,0,0,0,0,0,0,1997
AK,transit,241,819257,219,24,765743,53514,3677,1997
AK,education - elementary and secondary instructional,9316,35899123,8584,2105,34385310,1513813,121891,1997
AK,education - elementary and secondary other,4003,11919174,3529,2251,10976734,942440,81093,1997
AK,libraries,282,720101,200,148,576694,143407,14277,1997
AK,other and unallocable,1216,3481717,1006,800,3078037,403680,36173,1997
AZ,total,165331,423699773,143542,50787,388219535,35480238,3822047,1997
AZ,financial administration,3218,8590590,3128,195,8437323,153267,16193,1997
AZ,other government administration,3848,11941098,3629,540,11488457,452641,38939,1997
AZ,judicial and legal,6701,17747620,6416,785,17127912,619708,50990,1997
AZ,police protection - officers,9893,33138671,9872,48,33097741,40930,3419,1997
AZ,police protection - other,3101,8395666,2928,315,8088152,307514,30074,1997
AZ,fire protection - firefighters,3878,13990698,3640,1288,13618689,372009,41862,1997
AZ,fire protection - other,694,2274443,620,153,2135303,139140,13309,1997
AZ,corrections,3911,8971268,3742,421,8669796,301472,30073,1997
AZ,streets and highways,4147,11019341,4063,133,10867284,152057,14405,1997
AZ,air transportation,931,2611797,901,46,2566455,45342,4840,1997
AZ,water transport and terminals,0,0,0,0,0,0,0,1997
AZ,public welfare,1573,3665962,1304,455,3240680,425282,47525,1997
AZ,health,2516,5288352,2385,291,5076296,212056,23357,1997
AZ,hospitals,3380,6499546,2338,2601,4648023,1851523,184484,1997
AZ,solid waste management,1983,5388264,1924,93,5288044,100220,10197,1997
AZ,sewerage,1236,3326789,1219,44,3296111,30678,2597,1997
AZ,parks and recreation,3646,7771234,2574,2894,6264326,1506908,189731,1997
AZ,housing and community development,910,2603443,879,49,2552840,50603,5276,1997
AZ,natural resources,1021,2810025,1001,68,2766988,43037,4088,1997
AZ,water transport and terminals,2842,8702972,2802,76,8635598,67374,7076,1997
AZ,electric power,4502,20608571,4412,130,20329257,279314,16067,1997
AZ,gas supply,18,43286,18,0,43286,0,0,1997
AZ,transit,106,298536,90,32,267515,31021,2858,1997
AZ,education - elementary and secondary instructional,58194,151382236,52035,11803,141432682,9949554,1083795,1997
AZ,education - elementary and secondary other,28508,48674505,21653,14312,39378335,9296170,1198093,1997
AZ,education - higher education instructional,4055,11616152,1961,6718,6737461,4878691,365343,1997
AZ,education - higher education other,5597,13443937,3672,5952,10186488,3257449,333825,1997
AZ,libraries,1487,3320408,1099,836,2748518,571890,68677,1997
AZ,other and unallocable,3435,9574363,3237,509,9229975,344388,34954,1997
AR,total,90806,174178070,84777,21309,165896911,8281159,1063155,1997
AR,financial administration,1945,3412781,1885,236,3317963,94818,12103,1997
AR,other government administration,2008,3674856,1806,2359,3150225,524631,40301,1997
AR,judicial and legal,1623,3108521,1434,548,2778728,329793,33799,1997
AR,police protection - officers,4453,10347346,4360,287,10210458,136888,17325,1997
AR,police protection - other,1224,1797590,1144,245,1701181,96409,14221,1997
AR,fire protection - firefighters,2093,5300830,2034,1547,5198604,102226,12625,1997
AR,fire protection - other,83,131942,71,54,118500,13442,2418,1997
AR,corrections,1371,2179655,1322,106,2120198,59457,7983,1997
AR,streets and highways,3464,5801450,3355,254,5664246,137204,19481,1997
AR,air transportation,193,334729,185,20,325711,9018,1391,1997
AR,water transport and terminals,10,30458,10,0,30458,0,0,1997
AR,public welfare,274,432920,242,68,397001,35919,5980,1997
AR,health,221,376679,206,37,361957,14722,2402,1997
AR,hospitals,4331,7737821,3750,1073,6707669,1030152,100227,1997
AR,solid waste management,1319,2086975,1263,148,2016261,70714,10194,1997
AR,sewerage,871,1704325,854,57,1675045,29280,3557,1997
AR,parks and recreation,833,1278809,653,395,1082964,195845,32117,1997
AR,housing and community development,904,1585630,820,189,1468454,117176,15371,1997
AR,natural resources,273,374220,222,189,306110,68110,8844,1997
AR,water transport and terminals,1808,3489333,1756,196,3387284,102049,11503,1997
AR,electric power,303,817033,302,3,815832,1201,126,1997
AR,gas supply,3,4002,2,1,3418,584,97,1997
AR,transit,176,405888,169,10,396213,9675,1063,1997
AR,education - elementary and secondary instructional,39985,90336488,38735,4626,88741319,1595169,214206,1997
AR,education - elementary and secondary other,18070,22665164,15715,7223,19768372,2896792,409601,1997
AR,libraries,753,1136022,593,419,959896,176126,27901,1997
AR,other and unallocable,2215,3626603,1889,1019,3192844,433759,58319,1997
CA,total,1194169,4030696337,1010604,428781,3657603876,373092461,31867727,1997
CA,financial administration,20873,71949148,20086,1434,70130998,1818150,138357,1997
CA,other government administration,22629,85764644,21128,4323,81521751,4242893,265558,1997
CA,judicial and legal,36764,147764923,35536,2299,144162432,3602491,214506,1997
CA,police protection - officers,57551,289189586,56998,1998,287849205,1340381,97279,1997
CA,police protection - other,22756,71180049,20447,4984,67121732,4058317,406297,1997
CA,fire protection - firefighters,27162,150098468,26491,3628,148786941,1311527,120835,1997
CA,fire protection - other,2646,9675530,2439,511,9279117,396413,37755,1997
CA,corrections,28543,96317997,27246,2370,93071172,3246825,225662,1997
CA,streets and highways,20925,74966971,20094,1456,73153806,1813165,145820,1997
CA,air transportation,4999,18223020,4788,359,17821270,401750,36893,1997
CA,water transport and terminals,1937,8021343,1842,204,7786720,234623,16577,1997
CA,public welfare,49019,139292227,47722,2498,136512532,2779695,225757,1997
CA,health,34231,115820703,31168,5323,107189441,8631262,534377,1997
CA,hospitals,63636,210557460,54448,15975,181911304,28646156,1614663,1997
CA,solid waste management,6661,22441567,6298,542,21764085,677482,63228,1997
CA,sewerage,12308,48221508,11949,767,47261670,959838,64440,1997
CA,parks and recreation,30529,74379653,21156,23250,59460621,14919032,1654481,1997
CA,housing and community development,11618,40034024,10792,1501,38096533,1937491,145178,1997
CA,natural resources,7697,26350702,7298,925,25469729,880973,70913,1997
CA,water transport and terminals,23863,96357859,23121,1752,94433701,1924158,131052,1997
CA,electric power,14102,65772209,13778,541,64880466,891743,57285,1997
CA,gas supply,264,924116,264,0,924116,0,0,1997
CA,transit,28868,109159926,27563,1945,106059926,3100000,229924,1997
CA,education - elementary and secondary instructional,373235,1311142489,303819,151080,1164823431,146319058,11946561,1997
CA,education - elementary and secondary other,173676,381338743,130684,102127,311533837,69804906,7395818,1997
CA,education - higher education instructional,36032,129906056,20381,39797,90459210,39446846,2754128,1997
CA,education - higher education other,33833,80204229,22255,41759,63935457,16268772,2039863,1997
CA,libraries,11270,30009186,7771,8502,23143961,6865225,616912,1997
CA,other and unallocable,36542,125632001,33042,6931,119058712,6573289,617608,1997
CO,total,153146,401029469,135132,53273,371488370,29541099,3170220,1997
CO,financial administration,3270,8855345,3151,286,8632527,222818,21353,1997
CO,other government administration,4130,11224138,3892,7732,10644488,579650,44115,1997
CO,judicial and legal,2089,6816651,1994,361,6527235,289416,19356,1997
CO,police protection - officers,7542,27078105,7518,91,27029988,48117,4324,1997
CO,police protection - other,2755,6707239,2598,406,6435496,271743,27984,1997
CO,fire protection - firefighters,3778,14660059,3668,585,14486351,173708,19563,1997
CO,fire protection - other,379,1053489,344,203,982066,71423,6776,1997
CO,corrections,2950,8346220,2910,87,8272197,74023,7371,1997
CO,streets and highways,4939,13333052,4772,333,13045740,287312,30341,1997
CO,air transportation,1103,3645993,1038,130,3534721,111272,11284,1997
CO,water transport and terminals,0,0,0,0,0,0,0,1997
CO,public welfare,4912,11350244,4648,516,10911097,439147,46500,1997
CO,health,2327,5428388,1889,1214,4573601,854787,76926,1997
CO,hospitals,8063,19308459,7134,1873,17295085,2013374,162699,1997
CO,solid waste management,648,1587002,604,90,1515778,71224,8064,1997
CO,sewerage,2134,6463996,2070,304,6335870,128126,11635,1997
CO,parks and recreation,5742,12443218,3399,6248,9239017,3204201,413978,1997
CO,housing and community development,1477,3967541,1348,368,3736145,231396,22694,1997
CO,natural resources,520,1180232,431,240,1039638,140594,17118,1997
CO,water transport and terminals,3807,11477040,3712,458,11290790,186250,17526,1997
CO,electric power,1398,5179563,1377,29,5146527,33036,3515,1997
CO,gas supply,323,1090636,323,0,1090636,0,0,1997
CO,transit,2520,6678841,2291,340,6279065,399776,40194,1997
CO,education - elementary and secondary instructional,54549,150955667,49056,15092,140777283,10178384,958442,1997
CO,education - elementary and secondary other,24119,43879035,18722,11988,36863312,7015723,945349,1997
CO,education - higher education instructional,441,1384854,310,914,981579,403275,23169,1997
CO,education - higher education other,848,1801545,635,667,1537047,264498,37396,1997
CO,libraries,1978,4363786,1402,1458,3339195,1024591,101509,1997
CO,other and unallocable,4405,10769131,3896,1260,9945896,823235,91039,1997
CT,total,104338,360715121,94546,24804,341624319,19090802,1617921,1997
CT,financial administration,2295,7128159,2147,429,6764965,363194,25979,1997
CT,other government administration,2055,6407682,1812,806,5825742,581940,40923,1997
CT,judicial and legal,180,754860,164,29,705889,48971,2286,1997
CT,police protection - officers,6636,29453287,6520,317,29229504,223783,19470,1997
CT,police protection - other,1436,3772191,1109,914,3149051,623140,56790,1997
CT,fire protection - firefighters,4144,17300126,4056,473,17120002,180124,15402,1997
CT,fire protection - other,269,785381,232,147,688110,97271,6819,1997
CT,corrections,0,0,0,0,0,0,0,1997
CT,streets and highways,3615,11983928,3550,172,11860968,122960,11008,1997
CT,air transportation,44,116931,44,0,116931,0,0,1997
CT,water transport and terminals,0,0,0,0,0,0,0,1997
CT,public welfare,1794,5186603,1482,718,4554974,631629,52964,1997
CT,health,1460,4174299,1264,475,3671738,502561,33670,1997
CT,hospitals,0,0,0,0,0,0,0,1997
CT,solid waste management,1038,3406896,980,139,3305705,101191,9934,1997
CT,sewerage,1119,3848605,1100,53,3808807,39798,3122,1997
CT,parks and recreation,2069,5298059,1466,2032,4316550,981509,103372,1997
CT,housing and community development,1511,4625858,1383,294,4391383,234475,20441,1997
CT,natural resources,70,245153,64,10,237746,7407,915,1997
CT,water transport and terminals,1030,3587465,1016,54,3556647,30818,2711,1997
CT,electric power,214,1013324,214,1,1012899,425,71,1997
CT,gas supply,33,138942,33,0,138942,0,0,1997
CT,transit,455,1332621,413,101,1260083,72538,7120,1997
CT,education - elementary and secondary instructional,53207,204960523,49306,8893,196554763,8405760,627648,1997
CT,education - elementary and secondary other,16092,35435975,13448,6344,31099429,4336546,435467,1997
CT,education - higher education instructional,0,0,0,0,0,0,0,1997
CT,education - higher education other,0,0,0,0,0,0,0,1997
CT,libraries,1415,3571291,993,1287,2835008,736283,71844,1997
CT,other and unallocable,2157,6186962,1750,1116,5418483,768479,69965,1997
DE,total,18865,51476203,17372,3489,49371066,2105137,250152,1997
DE,financial administration,413,1091576,403,26,1073670,17906,1921,1997
DE,other government administration,388,1037718,370,90,988907,48811,3528,1997
DE,judicial and legal,137,369720,132,15,356357,13363,907,1997
DE,police protection - officers,932,3446598,922,21,3434277,12321,1317,1997
DE,police protection - other,341,674886,165,265,394498,280388,28348,1997
DE,fire protection - firefighters,194,678966,194,0,678966,0,0,1997
DE,fire protection - other,90,310069,89,2,309232,837,93,1997
DE,corrections,0,0,0,0,0,0,0,1997
DE,streets and highways,350,831186,324,43,786679,44507,4647,1997
DE,air transportation,24,64864,23,1,63737,1127,108,1997
DE,water transport and terminals,198,557835,156,75,472180,85655,7514,1997
DE,public welfare,45,78254,17,55,45108,33146,4393,1997
DE,health,168,498539,168,0,498539,0,0,1997
DE,hospitals,0,0,0,0,0,0,0,1997
DE,solid waste management,115,208230,110,13,201887,6343,957,1997
DE,sewerage,368,914370,367,1,912962,1408,142,1997
DE,parks and recreation,300,666280,225,459,564765,101515,12739,1997
DE,housing and community development,279,572433,270,15,563265,9168,1375,1997
DE,natural resources,12,30319,12,0,30319,0,0,1997
DE,water transport and terminals,166,352259,165,4,350577,1682,246,1997
DE,electric power,140,422411,139,1,419373,3038,177,1997
DE,gas supply,0,0,0,0,0,0,0,1997
DE,transit,0,0,0,0,0,0,0,1997
DE,education - elementary and secondary instructional,9438,28154620,9058,950,27512636,641984,63144,1997
DE,education - elementary and secondary other,4046,8635546,3406,1276,7925749,709797,107199,1997
DE,education - higher education instructional,0,0,0,0,0,0,0,1997
DE,education - higher education other,0,0,0,0,0,0,0,1997
DE,libraries,185,373227,136,133,309723,63504,8310,1997
DE,other and unallocable,536,1506297,521,44,1477660,28637,3087,1997
DC,total,46246,177629245,44905,2366,174129482,3499763,230497,1997
DC,financial administration,737,2500589,707,67,2399786,100803,5258,1997
DC,other government administration,590,2127809,578,20,2083775,44034,2161,1997
DC,judicial and legal,1792,6284247,1777,31,6231341,52906,2670,1997
DC,police protection - officers,3657,15921131,3655,3,15913322,7809,317,1997
DC,police protection - other,687,2102047,634,133,1939130,162917,9427,1997
DC,fire protection - firefighters,1191,4427088,1191,0,4427088,0,0,1997
DC,fire protection - other,434,1606204,434,0,1606204,0,0,1997
DC,corrections,3749,14135430,3729,17,14061524,73906,3469,1997
DC,streets and highways,546,1698842,546,0,1698842,0,0,1997
DC,public welfare,1187,3586445,1187,0,3586445,0,0,1997
DC,health,1387,4477788,1352,68,4363411,114377,6274,1997
DC,hospitals,4027,14133892,3840,194,13477014,656878,33124,1997
DC,solid waste management,389,1045092,389,0,1045092,0,0,1997
DC,sewerage,577,2152245,577,0,2152245,0,0,1997
DC,parks and recreation,617,1628557,571,117,1506512,122045,8187,1997
DC,housing and community development,1500,4201065,1500,0,4201065,0,0,1997
DC,water transport and terminals,576,2147715,576,0,2147715,0,0,1997
DC,transit,7787,44444130,7666,241,44050263,393867,21348,1997
DC,education - elementary and secondary instructional,6242,25821904,6118,321,25429530,392374,20662,1997
DC,education - elementary and secondary other,4465,9179144,3951,664,8336268,842876,85366,1997
DC,education - higher education instructional,424,2051254,327,127,1706286,344968,17256,1997
DC,education - higher education other,325,1004605,283,105,951761,52844,7373,1997
DC,libraries,380,1116332,368,24,1079828,36504,2203,1997
DC,other and unallocable,2980,9835690,2949,234,9735035,100655,5402,1997
FL,total,543525,1358677227,511167,120423,1303204965,55472262,5670623,1997
FL,financial administration,13822,35464431,13458,646,34841097,623334,62115,1997
FL,other government administration,11023,32400343,10608,1437,31450830,949513,72334,1997
FL,judicial and legal,10696,27055390,10444,448,26547747,507643,44114,1997
FL,police protection - officers,32172,113970230,31964,758,113579127,391103,37202,1997
FL,police protection - other,14266,32565852,12680,4105,30203703,2362149,279263,1997
FL,fire protection - firefighters,16679,59186183,16471,636,58862075,324108,36911,1997
FL,fire protection - other,1899,5534992,1831,117,5424032,110960,10836,1997
FL,corrections,13567,38037123,13506,120,37925388,111735,10336,1997
FL,streets and highways,13487,30675764,13256,338,30270244,405520,40270,1997
FL,air transportation,2799,8654639,2741,79,8550017,104622,9870,1997
FL,water transport and terminals,940,3058085,888,85,2988314,69771,9152,1997
FL,public welfare,5293,11628934,4753,1161,11041298,587636,94467,1997
FL,health,5585,14917795,5399,374,14524401,393394,32512,1997
FL,hospitals,31562,91453021,28335,4958,82527767,8925254,570834,1997
FL,solid waste management,6915,14804956,6786,204,14620096,184860,22219,1997
FL,sewerage,8507,21361783,8445,101,21244896,116887,11010,1997
FL,parks and recreation,15107,29374572,11805,8408,24635171,4739401,582125,1997
FL,housing and community development,4540,10990883,4310,357,10648825,342058,38787,1997
FL,natural resources,4066,11812845,3979,196,11659235,153610,15271,1997
FL,water transport and terminals,9941,25761885,9862,140,25617186,144699,13643,1997
FL,electric power,5235,18493276,5220,36,18454620,38656,2597,1997
FL,gas supply,603,1244659,598,9,1236067,8592,803,1997
FL,transit,5335,16129471,5086,389,15688439,441032,43855,1997
FL,education - elementary and secondary instructional,147460,426584188,143465,36394,419327381,7256807,707121,1997
FL,education - elementary and secondary other,118379,168797011,109359,33140,157354836,11442175,1595465,1997
FL,education - higher education instructional,7625,26980408,5025,11878,19156156,7824252,445915,1997
FL,education - higher education other,13573,27781386,10052,10231,23183734,4597652,599582,1997
FL,libraries,4609,9569679,3839,1530,8565978,1003701,135652,1997
FL,other and unallocable,17840,44387443,17002,2148,43076305,1311138,146362,1997
GA,total,324480,725536871,302637,56947,686455412,39081459,3842970,1997
GA,financial administration,5968,13247234,5697,643,12786139,461095,47030,1997
GA,other government administration,3940,9556007,3670,2101,8732329,823678,50570,1997
GA,judicial and legal,6566,16647757,6163,1396,15540708,1107049,73332,1997
GA,police protection - officers,15676,39397182,15439,610,39072466,324716,41023,1997
GA,police protection - other,3954,7552821,3493,1225,6877042,675779,81049,1997
GA,fire protection - firefighters,8254,22423992,8020,1308,22083359,340633,42918,1997
GA,fire protection - other,484,958169,467,64,931648,26521,2971,1997
GA,corrections,6211,14011156,6091,197,13796372,214784,21464,1997
GA,streets and highways,7757,14833079,7645,218,14679034,154045,20046,1997
GA,air transportation,533,1379344,509,54,1321374,57970,4458,1997
GA,water transport and terminals,5,13294,5,0,13294,0,0,1997
GA,public welfare,581,1053479,481,179,898194,155285,17380,1997
GA,health,11865,24164386,10071,3682,21277602,2886784,316685,1997
GA,hospitals,39477,95693268,33844,9209,83229754,12463514,996518,1997
GA,solid waste management,4499,7924630,4245,488,7531728,392902,45141,1997
GA,sewerage,3030,6858824,2978,74,6778693,80131,9055,1997
GA,parks and recreation,4408,8071355,3602,1902,7045891,1025464,141796,1997
GA,housing and community development,3390,6734028,3234,356,6454151,279877,27092,1997
GA,natural resources,275,381696,201,230,261933,119763,13125,1997
GA,water transport and terminals,4830,10611389,4743,234,10490112,121277,15397,1997
GA,electric power,743,2078222,739,7,2073147,5075,557,1997
GA,gas supply,415,897146,413,3,893793,3353,412,1997
GA,transit,4538,12475969,4177,608,11796574,679395,63728,1997
GA,education - elementary and secondary instructional,126062,315731962,122237,15363,308883098,6848864,664587,1997
GA,education - elementary and secondary other,50307,71883871,45303,12556,64528511,7355360,878221,1997
GA,education - higher education instructional,498,1687225,256,678,1091674,595551,40410,1997
GA,education - higher education other,304,481862,185,609,324482,157380,19755,1997
GA,libraries,2285,4753569,1780,1241,4016027,737542,89312,1997
GA,other and unallocable,7625,14033955,6949,1712,13046283,987672,118938,1997
HI,total,14319,45471636,13906,1342,44712118,759518,72862,1997
HI,financial administration,791,2236816,788,8,2231540,5276,532,1997
HI,other government administration,873,2883290,858,32,2846770,36520,2526,1997
HI,judicial and legal,567,1982444,560,18,1969442,13002,1194,1997
HI,police protection - officers,2615,11332632,2615,0,11332632,0,0,1997
HI,police protection - other,799,2140426,755,213,2073726,66700,7618,1997
HI,fire protection - firefighters,1596,5810408,1596,0,5810408,0,0,1997
HI,fire protection - other,69,204162,69,0,204162,0,0,1997
HI,streets and highways,1014,2616544,1010,11,2608916,7628,716,1997
HI,public welfare,100,236696,99,1,235814,882,146,1997
HI,health,201,711258,199,5,704900,6358,294,1997
HI,solid waste management,603,1697664,603,0,1697664,0,0,1997
HI,sewerage,894,2751528,892,3,2749330,2198,274,1997
HI,parks and recreation,1869,4314612,1602,884,3808334,506278,47212,1997
HI,housing and community development,118,351828,117,3,349506,2322,170,1997
HI,natural resources,14,48858,14,5,43964,4894,284,1997
HI,water transport and terminals,1028,2990360,1018,33,2975126,15234,1840,1997
HI,transit,69,176754,69,1,176432,322,28,1997
HI,other and unallocable,1099,2985356,1042,125,2893452,91904,10028,1997
ID,total,46035,100458277,40028,19081,90282151,10176126,1052319,1997
ID,financial administration,1063,2251800,1019,136,2171683,80117,9434,1997
ID,other government administration,884,1929326,803,789,1682533,246793,17006,1997
ID,judicial and legal,844,1822568,811,101,1753617,68951,5895,1997
ID,police protection - officers,1839,5037286,1815,102,4998806,38480,4642,1997
ID,police protection - other,680,1298865,621,188,1213202,85663,10781,1997
ID,fire protection - firefighters,917,2805887,827,1332,2657247,148640,16579,1997
ID,fire protection - other,55,113130,43,128,88523,24607,2772,1997
ID,corrections,787,1556232,740,137,1484812,71420,8500,1997
ID,streets and highways,1539,3508960,1481,218,3408943,100017,10804,1997
ID,air transportation,97,225402,90,19,215943,9459,1224,1997
ID,water transport and terminals,2,7232,2,1,6712,520,65,1997
ID,public welfare,181,300440,151,74,256800,43640,5312,1997
ID,health,727,1605661,553,402,1288905,316756,30735,1997
ID,hospitals,4689,11038608,3739,1605,8647957,2390651,165352,1997
ID,solid waste management,333,649496,306,60,611807,37689,4897,1997
ID,sewerage,390,959678,368,88,914271,45407,4360,1997
ID,parks and recreation,625,1212438,398,787,906414,306024,39915,1997
ID,housing and community development,111,215613,95,36,193557,22056,2862,1997
ID,natural resources,459,810410,382,252,693601,116809,13676,1997
ID,water transport and terminals,396,936172,377,91,896823,39349,3996,1997
ID,electric power,89,322212,88,2,318152,4060,219,1997
ID,gas supply,0,0,0,0,0,0,0,1997
ID,transit,26,39192,8,35,18717,20475,3162,1997
ID,education - elementary and secondary instructional,20342,46732712,18365,6092,43653681,3079031,336319,1997
ID,education - elementary and secondary other,6896,10679411,5484,4222,8826474,1852937,244662,1997
ID,education - higher education instructional,322,976980,250,298,773675,203305,12632,1997
ID,education - higher education other,551,1102883,354,714,765837,337046,34905,1997
ID,libraries,443,778766,229,600,471307,307459,37250,1997
ID,other and unallocable,748,1540917,629,572,1362152,178765,24363,1997
IL,total,459893,1369809237,414415,147693,1287733876,82075361,7921916,1997
IL,financial administration,7315,20124540,6930,2065,19200416,924124,82981,1997
IL,other government administration,9538,25190967,8595,13535,22171566,3019401,195448,1997
IL,judicial and legal,13019,34760387,12799,596,34298719,461668,38394,1997
IL,police protection - officers,30349,131458078,29773,1952,130505702,952376,106715,1997
IL,police protection - other,8986,25707171,8007,3033,24242632,1464539,173264,1997
IL,fire protection - firefighters,14166,54176731,12893,10222,52279989,1896742,226192,1997
IL,fire protection - other,1039,2352651,888,1014,2086825,265826,28430,1997
IL,corrections,8857,24640957,8743,233,24494150,146807,19406,1997
IL,streets and highways,11259,32270444,10577,2370,31161102,1109342,128781,1997
IL,air transportation,2313,7645180,2277,112,7602549,42631,6449,1997
IL,water transport and terminals,45,125347,38,9,117487,7860,1129,1997
IL,public welfare,6334,12202541,5610,1423,11121775,1080766,123130,1997
IL,health,7124,17873967,6512,1496,16660910,1213057,105225,1997
IL,hospitals,14984,46046455,13970,1789,44045276,2001179,177681,1997
IL,solid waste management,4768,18319379,4694,182,18206947,112432,13157,1997
IL,sewerage,6191,22720504,6049,596,22460825,259679,28239,1997
IL,parks and recreation,14942,33769871,9526,16301,25417230,8352641,942951,1997
IL,housing and community development,6402,18158854,6248,381,17886788,272066,26474,1997
IL,natural resources,922,2199612,798,982,1984573,215039,22573,1997
IL,water transport and terminals,5928,19430416,5691,1434,18969716,460700,49098,1997
IL,electric power,1140,4085229,1132,15,4077454,7775,1061,1997
IL,gas supply,91,228837,91,1,228748,89,9,1997
IL,transit,16627,54194503,15580,1613,51899708,2294795,184882,1997
IL,education - elementary and secondary instructional,171839,537881287,163046,23917,520798235,17083052,1482928,1997
IL,education - elementary and secondary other,59207,128702290,49364,27678,112976640,15725650,1668979,1997
IL,education - higher education instructional,8714,31525211,4680,11077,21452629,10072582,707781,1997
IL,education - higher education other,11920,28742300,7865,10950,21885159,6857141,712065,1997
IL,libraries,8047,15922022,5367,6566,12092202,3829820,459163,1997
IL,other and unallocable,7827,19353506,6672,6151,17407924,1945582,209331,1997
IN,total,220747,525512965,194835,61256,482979729,42533236,4400950,1997
IN,financial administration,4987,8867022,4658,1463,8223956,643066,67816,1997
IN,other government administration,5122,9275835,4635,4354,7993765,1282070,96813,1997
IN,judicial and legal,4711,9398792,4382,771,8773362,625430,56458,1997
IN,police protection - officers,9435,27018358,9292,496,26788312,230046,26960,1997
IN,police protection - other,3085,5340671,2733,1114,4819439,521232,61069,1997
IN,fire protection - firefighters,5922,17752847,5726,1976,17503826,249021,35792,1997
IN,fire protection - other,394,832768,361,91,788943,43825,6283,1997
IN,corrections,3976,7452674,3677,638,6963604,489070,49568,1997
IN,streets and highways,6265,12730281,6135,270,12543161,187120,23983,1997
IN,air transportation,132,314740,123,27,303784,10956,1559,1997
IN,water transport and terminals,0,0,0,0,0,0,0,1997
IN,public welfare,1531,2404590,1385,326,2208918,195672,23894,1997
IN,health,2877,5681395,2614,797,5286073,395322,43684,1997
IN,hospitals,22815,52034993,18175,7273,42144896,9890097,772318,1997
IN,solid waste management,1659,3277561,1548,244,3132534,145027,18797,1997
IN,sewerage,2810,6693730,2731,295,6554654,139076,15106,1997
IN,parks and recreation,3072,5723249,2358,1785,4819886,903363,125082,1997
IN,housing and community development,1703,3719322,1545,341,3504033,215289,27603,1997
IN,natural resources,665,1060886,609,171,983956,76930,9551,1997
IN,water transport and terminals,2088,4769714,2042,194,4685469,84245,10012,1997
IN,electric power,909,2499602,902,14,2493453,6149,881,1997
IN,gas supply,1028,3148440,998,45,3080988,67452,5431,1997
IN,transit,1259,2684756,1200,110,2582084,102672,10155,1997
IN,education - elementary and secondary instructional,84823,246526111,78307,14488,236652417,9873694,1092838,1997
IN,education - elementary and secondary other,41603,71940508,32631,18980,58197422,13743086,1502081,1997
IN,education - higher education instructional,0,0,0,0,0,0,0,1997
IN,education - higher education other,0,0,0,0,0,0,0,1997
IN,libraries,4183,7291759,2763,3246,5507202,1784557,243635,1997
IN,other and unallocable,3693,7072361,3305,1747,6443592,628769,73581,1997
IA,total,112667,260487093,95224,49725,233111418,27375675,3089971,1997
IA,financial administration,2448,5489699,2319,401,5282643,207056,25026,1997
IA,other government administration,1978,4820128,1712,3747,4167125,653003,60302,1997
IA,judicial and legal,733,2116032,665,154,1929188,186844,11681,1997
IA,police protection - officers,4232,12332902,4153,379,12193172,139730,16579,1997
IA,police protection - other,1325,2652036,1141,496,2387278,264758,32363,1997
IA,fire protection - firefighters,1660,5006990,1562,1794,4857168,149822,19343,1997
IA,fire protection - other,62,144907,49,85,126856,18051,2085,1997
IA,corrections,881,1913196,758,272,1745692,167504,21215,1997
IA,streets and highways,5304,12423635,5211,340,12252800,170835,19646,1997
IA,air transportation,171,452884,158,25,434010,18874,2151,1997
IA,water transport and terminals,0,0,0,0,0,0,0,1997
IA,public welfare,1371,2509658,1117,569,2107239,402419,44346,1997
IA,health,2055,4088972,1577,992,3311037,777935,84263,1997
IA,hospitals,8304,18342960,6465,3565,14639887,3703073,322155,1997
IA,solid waste management,871,1956060,764,277,1801259,154801,20667,1997
IA,sewerage,1240,3221771,1207,223,3141714,80057,9207,1997
IA,parks and recreation,1630,3518416,1196,1675,2979388,539028,76373,1997
IA,housing and community development,536,1370606,480,88,1293868,76738,9352,1997
IA,natural resources,248,549342,218,89,500582,48760,5318,1997
IA,water transport and terminals,1321,3446431,1271,294,3328439,117992,13411,1997
IA,electric power,775,2421859,754,42,2399406,22453,3576,1997
IA,gas supply,60,163699,58,3,161988,1711,239,1997
IA,transit,755,1587145,494,394,1200672,386473,45965,1997
IA,education - elementary and secondary instructional,46507,116290291,42151,11489,109594199,6696092,760027,1997
IA,education - elementary and secondary other,18934,32067805,13088,13337,23810185,8257620,1021469,1997
IA,education - higher education instructional,2276,7209521,1615,2763,5567510,1642011,115120,1997
IA,education - higher education other,3440,7393379,2568,2620,6340402,1052977,152982,1997
IA,libraries,1365,2476330,737,1612,1659876,816454,112511,1997
IA,other and unallocable,2185,4520439,1736,2000,3897835,622604,82599,1997
KS,total,118302,265699420,104883,45827,244528865,21170555,2390732,1997
KS,financial administration,2941,6173825,2826,1228,5933592,240233,26337,1997
KS,other government administration,2499,5926760,2313,4040,5306631,620129,46034,1997
KS,judicial and legal,1303,3340043,1165,687,2967168,372875,28562,1997
KS,police protection - officers,5037,14313050,4936,344,14166175,146875,19117,1997
KS,police protection - other,1877,3861904,1743,516,3661296,200608,24352,1997
KS,fire protection - firefighters,2416,7330791,2271,2293,7122836,207955,28432,1997
KS,fire protection - other,108,257898,102,41,251611,6287,1066,1997
KS,corrections,1842,4274130,1753,210,4152418,121712,16056,1997
KS,streets and highways,5111,10310901,4951,619,10022299,288602,36044,1997
KS,air transportation,211,508471,206,12,503574,4897,689,1997
KS,water transport and terminals,10,28377,10,0,28377,0,0,1997
KS,public welfare,755,1399135,626,243,1179975,219160,23306,1997
KS,health,3106,6876308,2620,1492,6169073,707235,85063,1997
KS,hospitals,6153,13077214,5196,1823,11452485,1624729,168618,1997
KS,solid waste management,913,1740633,867,133,1669282,71351,9122,1997
KS,sewerage,1114,2720537,1090,130,2671751,48786,5707,1997
KS,parks and recreation,1887,3752664,1477,1511,3254647,498017,72127,1997
KS,housing and community development,677,1350053,583,334,1192741,157312,18456,1997
KS,natural resources,362,639577,320,189,572079,67498,8367,1997
KS,water transport and terminals,1897,4841804,1752,556,4564048,277756,28741,1997
KS,electric power,1273,3314220,1269,14,3306970,7250,987,1997
KS,gas supply,47,114726,47,0,114726,0,0,1997
KS,transit,215,426992,207,21,416142,10850,1519,1997
KS,education - elementary and secondary instructional,47234,116430276,43375,10433,110404911,6025365,662441,1997
KS,education - elementary and secondary other,19862,31823424,16048,9593,26518496,5304928,660917,1997
KS,education - higher education instructional,2301,7001116,1549,3229,5045419,1955697,131498,1997
KS,education - higher education other,3637,7025425,2714,3004,5965023,1060402,162665,1997
KS,libraries,796,1472167,568,507,1168749,303418,41572,1997
KS,other and unallocable,2718,5366999,2299,2625,4746371,620628,82937,1997
KY,total,134740,285460723,125577,22597,273288840,12171883,1534527,1997
KY,financial administration,1677,3612195,1611,242,3499491,112704,11893,1997
KY,other government administration,2362,4782587,2261,1405,4385877,396710,21890,1997
KY,judicial and legal,1118,2701109,1058,178,2610097,91012,10751,1997
KY,police protection - officers,5074,12582019,4907,300,12350450,231569,28866,1997
KY,police protection - other,1381,2428588,1196,457,2203328,225260,32879,1997
KY,fire protection - firefighters,2855,6249537,2732,680,6084772,164765,22502,1997
KY,fire protection - other,162,340695,149,41,322516,18179,2441,1997
KY,corrections,2083,3782326,1985,206,3661383,120943,17595,1997
KY,streets and highways,2889,5331259,2838,100,5265498,65761,9281,1997
KY,air transportation,328,754602,311,22,733578,21024,2960,1997
KY,water transport and terminals,35,77543,34,2,76671,872,168,1997
KY,public welfare,682,1378468,610,205,1280285,98183,12577,1997
KY,health,3931,7998885,3617,707,7521507,477378,54741,1997
KY,hospitals,4419,9156423,3848,1101,7972929,1183494,100769,1997
KY,solid waste management,1489,2312595,1441,112,2257380,55215,8272,1997
KY,sewerage,1539,4516978,1521,26,4492265,24713,2705,1997
KY,parks and recreation,1189,1798742,1071,268,1650879,147863,20333,1997
KY,housing and community development,876,1961467,843,67,1919176,42291,5743,1997
KY,natural resources,172,239095,123,293,175887,63208,8397,1997
KY,water transport and terminals,2586,5937996,2489,295,5783548,154448,17598,1997
KY,electric power,604,1835431,596,26,1824503,10928,1528,1997
KY,gas supply,133,234477,131,5,231785,2692,405,1997
KY,transit,869,2325849,821,84,2247321,78528,8469,1997
KY,education - elementary and secondary instructional,63381,157197217,61118,5335,153953192,3244025,371668,1997
KY,education - elementary and secondary other,29035,39260942,24856,8777,34656976,4603966,679331,1997
KY,education - higher education instructional,0,0,0,0,0,0,0,1997
KY,education - higher education other,0,0,0,0,0,0,0,1997
KY,libraries,1175,1832684,873,696,1510326,322358,52160,1997
KY,other and unallocable,2696,4831014,2537,967,4617220,213794,28605,1997
LA,total,169976,335045290,160624,23876,321629898,13415392,1590717,1997
LA,financial administration,3017,6186570,2926,209,6061912,124658,16617,1997
LA,other government administration,3134,6463420,3019,1015,6075095,388325,23369,1997
LA,judicial and legal,3966,7529548,3745,678,7100445,429103,39014,1997
LA,police protection - officers,8999,21837008,8845,567,21632808,204200,28856,1997
LA,police protection - other,2792,5151450,2469,942,4776926,374524,54582,1997
LA,fire protection - firefighters,4091,10055425,4069,217,10024748,30677,4516,1997
LA,fire protection - other,189,406402,179,16,396528,9874,1592,1997
LA,corrections,4284,9831986,4091,261,9559868,272118,31857,1997
LA,streets and highways,4834,8281426,4695,213,8127145,154281,23751,1997
LA,air transportation,452,896695,426,40,868713,27982,4274,1997
LA,water transport and terminals,264,600117,263,7,596079,4038,355,1997
LA,public welfare,469,674938,428,78,635850,39088,6502,1997
LA,health,1118,2153609,1001,130,2019415,134194,19356,1997
LA,hospitals,12557,30794245,10585,3376,26339440,4454805,344263,1997
LA,solid waste management,1474,2061501,1419,114,1995102,66399,9518,1997
LA,sewerage,2101,4327312,2070,58,4286389,40923,5631,1997
LA,parks and recreation,3224,4791109,2436,1837,3844227,946882,135133,1997
LA,housing and community development,1352,2480917,1328,53,2451179,29738,4244,1997
LA,natural resources,734,1393922,700,71,1365648,28274,5643,1997
LA,water transport and terminals,2825,5395764,2803,81,5361005,34759,4778,1997
LA,electric power,607,1423410,591,24,1404260,19150,3032,1997
LA,gas supply,274,518716,269,6,513972,4744,723,1997
LA,transit,341,863054,321,28,827761,35293,3556,1997
LA,education - elementary and secondary instructional,69162,150115970,67236,7075,147700130,2415840,322691,1997
LA,education - elementary and secondary other,31543,41245305,29206,5272,38834729,2410576,382590,1997
LA,education - higher education instructional,182,359451,179,10,353191,6260,500,1997
LA,education - higher education other,163,152864,64,150,76095,76769,15350,1997
LA,libraries,1771,2702236,1466,660,2348455,353781,52653,1997
LA,other and unallocable,4057,6350920,3795,688,6052783,298137,45771,1997
ME,total,46260,105902809,40304,18510,96385775,9517034,1027754,1997
ME,financial administration,1111,2247144,937,734,1963275,283869,31017,1997
ME,other government administration,972,2269731,831,1057,1988209,281522,27894,1997
ME,judicial and legal,220,417430,195,65,378861,38569,4113,1997
ME,police protection - officers,1900,5106161,1777,372,4947487,158674,21917,1997
ME,police protection - other,507,976570,416,336,855892,120678,16377,1997
ME,fire protection - firefighters,1282,3429084,1075,2102,3150773,278311,38076,1997
ME,fire protection - other,78,164129,63,99,145537,18592,2633,1997
ME,corrections,607,1122304,515,187,1000679,121625,15861,1997
ME,streets and highways,1706,3990037,1519,491,3703804,286233,32822,1997
ME,air transportation,292,613109,208,88,483975,129134,14997,1997
ME,water transport and terminals,121,225337,82,75,173795,51542,6809,1997
ME,public welfare,491,981777,345,218,707332,274445,26173,1997
ME,health,230,458404,136,364,316721,141683,16944,1997
ME,hospitals,691,1772674,540,328,1429178,343496,26060,1997
ME,solid waste management,491,998801,379,311,856600,142201,21060,1997
ME,sewerage,636,1559319,604,81,1506168,53151,5741,1997
ME,parks and recreation,597,1080868,316,754,699519,381349,49717,1997
ME,housing and community development,420,965293,386,60,921829,43464,5764,1997
ME,natural resources,31,58246,30,6,55032,3214,393,1997
ME,water transport and terminals,694,1748720,664,119,1701085,47635,4976,1997
ME,electric power,19,53511,19,3,52931,580,78,1997
ME,gas supply,0,0,0,0,0,0,0,1997
ME,transit,101,299346,72,30,226285,73061,3646,1997
ME,education - elementary and secondary instructional,23610,58573050,21637,5612,55130828,3442222,330750,1997
ME,education - elementary and secondary other,8339,14680982,6779,3420,12359566,2321416,263153,1997
ME,education - higher education instructional,0,0,0,0,0,0,0,1997
ME,education - higher education other,0,0,0,0,0,0,0,1997
ME,libraries,327,621812,202,349,439090,182722,23072,1997
ME,other and unallocable,787,1488970,577,1249,1191324,297646,37711,1997
MD,total,171635,523085607,151308,43081,482556330,40529277,3522038,1997
MD,financial administration,2222,6999546,2161,136,6860575,138971,10829,1997
MD,other government administration,3002,8893903,2515,1069,7563039,1330864,87502,1997
MD,judicial and legal,2641,8408826,2517,257,8119347,289479,21357,1997
MD,police protection - officers,11370,39158503,11265,243,38911368,247135,18280,1997
MD,police protection - other,2621,6628442,2201,1156,5953380,675062,71774,1997
MD,fire protection - firefighters,5554,21475594,5487,146,21380834,94760,10790,1997
MD,fire protection - other,343,1008382,317,215,946848,61534,4585,1997
MD,corrections,2454,6960834,2418,53,6892219,68615,6328,1997
MD,streets and highways,4944,12684465,4893,135,12587195,97270,9210,1997
MD,air transportation,20,43700,15,11,35695,8005,884,1997
MD,water transport and terminals,5,14118,5,1,13910,208,31,1997
MD,public welfare,2365,4761125,1867,828,3799202,961923,87017,1997
MD,health,3577,9989609,2744,1180,7878211,2111398,145932,1997
MD,hospitals,0,0,0,0,0,0,0,1997
MD,solid waste management,2182,4631649,2122,111,4546266,85383,10674,1997
MD,sewerage,3986,11741211,3965,44,11683803,57408,4021,1997
MD,parks and recreation,6092,12219213,5071,3023,10924239,1294974,177850,1997
MD,housing and community development,2825,6984778,2691,180,6671983,312795,23297,1997
MD,natural resources,358,1150112,336,44,1092852,57260,4080,1997
MD,water transport and terminals,2102,6071304,2091,22,6048367,22937,1963,1997
MD,electric power,79,234391,78,1,233727,664,133,1997
MD,gas supply,11,26702,11,0,26702,0,0,1997
MD,transit,785,2290941,657,167,2020523,270418,22246,1997
MD,education - elementary and secondary instructional,67181,243015614,60698,13870,227731910,15283704,1128038,1997
MD,education - elementary and secondary other,28861,65038597,23091,9443,55544372,9494225,998547,1997
MD,education - higher education instructional,3253,11230980,1949,4587,7707722,3523258,219282,1997
MD,education - higher education other,5261,12578644,3778,3748,10627799,1950845,250518,1997
MD,libraries,2733,6277877,2025,1542,5063746,1214131,124997,1997
MD,other and unallocable,4808,12566547,4340,869,11690496,876051,81873,1997
MA,total,213917,640275116,194820,48725,606624477,33650639,3193755,1997
MA,financial administration,4573,12404151,4162,1142,11539682,864469,69367,1997
MA,other government administration,3889,11010602,3391,1623,9784346,1226256,86344,1997
MA,judicial and legal,303,1014650,287,54,956836,57814,3073,1997
MA,police protection - officers,13842,53558197,13459,1399,52689304,868893,64632,1997
MA,police protection - other,2972,6281087,2313,1923,5172883,1108204,110062,1997
MA,fire protection - firefighters,11843,41290991,11397,3090,40640229,650762,77703,1997
MA,fire protection - other,520,1409886,458,214,1278721,131165,11229,1997
MA,corrections,5287,15838778,5057,469,15320225,518553,40364,1997
MA,streets and highways,6074,17854349,5964,305,17630867,223482,19925,1997
MA,air transportation,125,360030,118,18,344493,15537,1313,1997
MA,water transport and terminals,50,115334,40,24,98224,17110,1692,1997
MA,public welfare,2048,4254056,1615,915,3538924,715132,73802,1997
MA,health,2539,7715285,2260,954,7127588,587697,47398,1997
MA,hospitals,5549,16054333,4869,1050,13844136,2210197,115199,1997
MA,solid waste management,1306,3018649,1185,301,2820767,197882,21892,1997
MA,sewerage,2012,5942871,1934,208,5778579,164292,13330,1997
MA,parks and recreation,1980,4785349,1506,1573,4012284,773065,80794,1997
MA,housing and community development,4206,11655074,3948,610,11178385,476689,44696,1997
MA,natural resources,343,892035,304,110,819000,73035,7058,1997
MA,water transport and terminals,3094,8900495,3000,365,8727855,172640,15805,1997
MA,electric power,1274,5026154,1256,52,4982125,44029,3206,1997
MA,gas supply,172,693993,171,1,692465,1528,102,1997
MA,transit,6003,22429850,5616,641,21260772,1169078,68235,1997
MA,education - elementary and secondary instructional,95782,307663891,89760,13089,296855647,10808244,982946,1997
MA,education - elementary and secondary other,29802,60173851,24097,13818,52458848,7715003,946341,1997
MA,education - higher education instructional,107,337098,97,45,312379,24719,1634,1997
MA,education - higher education other,54,151465,49,11,143598,7867,788,1997
MA,libraries,3461,7869034,2442,2657,6182372,1686662,174656,1997
MA,other and unallocable,4707,11573578,4065,2064,10432943,1140635,110169,1997
MI,total,332671,1023945646,281926,142283,932418272,91527374,8661105,1997
MI,financial administration,6627,18578000,5958,2599,17008736,1569264,134094,1997
MI,other government administration,7640,20471281,6357,10085,17342998,3128283,237812,1997
MI,judicial and legal,9097,27490153,8687,904,26566184,923969,72601,1997
MI,police protection - officers,17345,61304479,17006,1106,60745412,559067,59677,1997
MI,police protection - other,3898,8907715,3182,2206,7897806,1009909,128799,1997
MI,fire protection - firefighters,7098,23893153,5776,9169,21707505,2185648,233006,1997
MI,fire protection - other,776,2024189,682,446,1904921,119268,15614,1997
MI,corrections,4940,14052599,4512,836,13202989,849610,74027,1997
MI,streets and highways,8950,27126201,8780,443,26862325,263876,30922,1997
MI,air transportation,887,2844926,845,132,2774891,70035,7683,1997
MI,water transport and terminals,40,128558,39,1,127208,1350,140,1997
MI,public welfare,2176,4414894,1493,1331,3487774,927120,117152,1997
MI,health,9249,25647805,8034,2832,23126566,2521239,212231,1997
MI,hospitals,7676,20884142,6018,3166,16398853,4485289,286528,1997
MI,solid waste management,2323,6436893,2198,338,6212646,224247,22956,1997
MI,sewerage,4358,13496875,4279,242,13355339,141536,14568,1997
MI,parks and recreation,5139,11707963,3162,5453,9008113,2699850,346018,1997
MI,housing and community development,1672,5040524,1384,560,4028267,1012257,50230,1997
MI,natural resources,648,1516397,568,162,1390878,125519,13345,1997
MI,water transport and terminals,4463,13341485,4375,234,13190508,150977,15350,1997
MI,electric power,1565,6424374,1562,9,6419125,5249,506,1997
MI,gas supply,0,0,0,0,0,0,0,1997
MI,transit,4668,11248483,4321,587,10683966,564517,60710,1997
MI,education - elementary and secondary instructional,127051,471167160,114857,29310,447055917,24111243,2030637,1997
MI,education - elementary and secondary other,69130,157226732,50062,39797,127022619,30204113,3181311,1997
MI,education - higher education instructional,4913,20190338,3185,6513,14807892,5382446,303037,1997
MI,education - higher education other,7415,17730857,4851,6191,14396902,3333955,449751,1997
MI,libraries,3884,8119709,2282,3994,5905112,2214597,278585,1997
MI,other and unallocable,9043,22529761,7471,13637,19786820,2742941,283815,1997
MN,total,188845,530141581,156080,92203,466996989,63144592,5790265,1997
MN,financial administration,4613,13751065,4335,1890,13049561,701504,57192,1997
MN,other government administration,4074,11907890,3563,9055,10248732,1659158,113690,1997
MN,judicial and legal,3459,11467857,3125,717,10475263,992594,59517,1997
MN,police protection - officers,7163,26969505,7001,546,26655744,313761,30609,1997
MN,police protection - other,2217,5469181,1888,711,4881262,587919,58780,1997
MN,fire protection - firefighters,2082,7698025,1698,4509,7155532,542493,71783,1997
MN,fire protection - other,130,421994,107,113,371898,50096,4106,1997
MN,corrections,3870,11809700,3497,868,11006720,802980,65805,1997
MN,streets and highways,6889,21114084,6570,997,20460485,653599,62557,1997
MN,air transportation,519,1950547,496,37,1911531,39016,4004,1997
MN,water transport and terminals,49,188307,49,1,187942,365,24,1997
MN,public welfare,10481,27889338,9366,2075,25605299,2284039,196421,1997
MN,health,3602,9364685,2283,2550,6557984,2806701,231723,1997
MN,hospitals,10495,28240007,6507,6982,17699159,10540848,702935,1997
MN,solid waste management,991,2669828,915,200,2534922,134906,13783,1997
MN,sewerage,2144,7234791,2044,430,7027269,207522,19657,1997
MN,parks and recreation,4120,10369225,2789,5594,8378466,1990759,235482,1997
MN,housing and community development,2083,6155301,1823,575,5636380,518921,44516,1997
MN,natural resources,716,1573766,621,466,1414203,159563,16999,1997
MN,water transport and terminals,1531,4782179,1464,227,4608347,173832,14752,1997
MN,electric power,836,2864408,806,75,2808207,56201,5439,1997
MN,gas supply,145,474000,144,1,472979,1021,144,1997
MN,transit,2384,7668485,2168,465,7216991,451494,37866,1997
MN,education - elementary and secondary instructional,76803,228357566,65924,22952,207919827,20437739,1893994,1997
MN,education - elementary and secondary other,29733,60627815,21201,20416,46922195,13705620,1482715,1997
MN,education - higher education instructional,0,0,0,0,0,0,0,1997
MN,education - higher education other,0,0,0,0,0,0,0,1997
MN,libraries,2250,5299029,1445,2063,3822511,1476518,140663,1997
MN,other and unallocable,5466,13823003,4251,7688,11967580,1855423,225109,1997
MS,total,122256,222189611,113814,24700,209190617,12998994,1489236,1997
MS,financial administration,2636,4507677,2567,231,4376484,131193,13373,1997
MS,other government administration,1981,4131319,1872,1106,3778096,353223,21537,1997
MS,judicial and legal,2438,4475861,2278,642,4098092,377769,30153,1997
MS,police protection - officers,5234,10647825,5030,592,10394761,253064,37100,1997
MS,police protection - other,1860,2801034,1655,663,2532680,268354,38126,1997
MS,fire protection - firefighters,3068,6607949,2987,496,6505566,102383,14914,1997
MS,fire protection - other,96,180861,87,57,169852,11009,1730,1997
MS,corrections,1338,2048332,1248,166,1932953,115379,15714,1997
MS,streets and highways,5643,8210093,5470,380,7992727,217366,31211,1997
MS,air transportation,144,250566,126,39,233519,17047,2865,1997
MS,water transport and terminals,79,124657,76,14,122219,2438,354,1997
MS,public welfare,548,638588,510,99,590068,48520,7225,1997
MS,health,192,299908,124,181,190880,109028,12157,1997
MS,hospitals,17693,36021011,15720,3782,31928292,4092719,348935,1997
MS,solid waste management,1073,1494152,1029,124,1442788,51364,8081,1997
MS,sewerage,712,1224793,676,60,1181261,43532,6717,1997
MS,parks and recreation,926,1311947,722,724,1108333,203614,35896,1997
MS,housing and community development,889,1695014,837,115,1625617,69397,9505,1997
MS,natural resources,579,826484,477,253,702140,124344,17914,1997
MS,water transport and terminals,1288,2248970,1229,128,2176134,72836,10575,1997
MS,electric power,531,1143169,519,24,1127729,15440,2092,1997
MS,gas supply,256,489635,251,9,481429,8206,1016,1997
MS,transit,127,187856,123,14,183529,4327,648,1997
MS,education - elementary and secondary instructional,45435,87764730,44604,3149,86607723,1157007,143819,1997
MS,education - elementary and secondary other,17333,20445060,14812,6800,17653114,2791946,439546,1997
MS,education - higher education instructional,3307,10005191,2757,2064,8653751,1351440,93195,1997
MS,education - higher education other,3261,6907442,2878,1189,6432319,475123,65453,1997
MS,libraries,862,1240777,651,618,1015695,225082,38089,1997
MS,other and unallocable,2727,4258710,2499,981,3952866,305844,41296,1997
MO,total,201609,461500061,184250,51296,433293014,28207047,3025559,1997
MO,financial administration,3744,8049970,3606,660,7771722,278248,27512,1997
MO,other government administration,3419,7467999,3223,2746,6907181,560818,41831,1997
MO,judicial and legal,3347,7692131,3117,785,7268766,423365,42960,1997
MO,police protection - officers,10598,29455650,10448,545,29234669,220981,28380,1997
MO,police protection - other,3782,7633816,3588,647,7372611,261205,35236,1997
MO,fire protection - firefighters,5370,16860776,5133,2205,16516355,344421,43929,1997
MO,fire protection - other,322,933519,293,193,884450,49069,5721,1997
MO,corrections,2480,5044567,2359,317,4899080,145487,20344,1997
MO,streets and highways,7008,14864194,6736,847,14401354,462840,54871,1997
MO,air transportation,1191,3000963,1163,51,2958781,42182,5086,1997
MO,water transport and terminals,2,6434,2,0,6434,0,0,1997
MO,public welfare,2533,3431585,2128,806,2904196,527389,70389,1997
MO,health,4057,8623410,3431,1416,7676329,947081,110340,1997
MO,hospitals,8110,17118969,6917,2040,14725376,2393593,209061,1997
MO,solid waste management,892,1764802,781,170,1589348,175454,20119,1997
MO,sewerage,2617,6764959,2534,221,6617866,147093,16619,1997
MO,parks and recreation,3511,6732236,2561,2454,5528817,1203419,168357,1997
MO,housing and community development,1719,3582442,1624,232,3446219,136223,16637,1997
MO,natural resources,195,357534,151,136,223918,133616,8231,1997
MO,water transport and terminals,3124,6988158,2982,540,6760153,228005,28408,1997
MO,electric power,1260,3731311,1248,27,3709880,21431,2018,1997
MO,gas supply,138,394697,137,1,394023,674,104,1997
MO,transit,2780,7105736,2584,311,6741799,363937,34687,1997
MO,education - elementary and secondary instructional,82258,209461284,78128,12212,202507647,6953637,696037,1997
MO,education - elementary and secondary other,34832,57089709,29676,12070,49775655,7314054,880728,1997
MO,education - higher education instructional,2185,5898150,1298,3099,4123716,1774434,153764,1997
MO,education - higher education other,2845,7250402,2263,2637,5887840,1362562,99000,1997
MO,libraries,2728,4680376,1949,2207,3570825,1109551,138189,1997
MO,other and unallocable,4562,9514282,4190,1721,8888004,626278,67001,1997
MT,total,32676,70561991,27164,15615,62295155,8266836,964799,1997
MT,financial administration,724,1350930,690,89,1291193,59737,6721,1997
MT,other government administration,758,1548430,703,513,1403497,144933,11487,1997
MT,judicial and legal,722,1568901,593,373,1262464,306437,23107,1997
MT,police protection - officers,1298,3432418,1277,103,3399735,32683,4182,1997
MT,police protection - other,473,799696,424,156,724505,75191,8928,1997
MT,fire protection - firefighters,510,1534929,498,439,1516340,18589,2717,1997
MT,fire protection - other,85,168874,79,36,162434,6440,1046,1997
MT,corrections,453,880095,400,111,802960,77135,9297,1997
MT,streets and highways,1309,2828110,1276,75,2778001,50109,6094,1997
MT,air transportation,104,272309,100,27,263435,8874,1110,1997
MT,water transport and terminals,0,0,0,0,0,0,0,1997
MT,public welfare,512,720611,343,309,498007,222604,30230,1997
MT,health,664,1279195,475,465,945143,334052,33581,1997
MT,hospitals,778,1436288,589,335,1150626,285662,33196,1997
MT,solid waste management,542,1145932,504,155,1090395,55537,7512,1997
MT,sewerage,313,716518,293,82,683858,32660,4237,1997
MT,parks and recreation,356,710630,266,450,581023,129607,16106,1997
MT,housing and community development,227,466559,197,45,419707,46852,5045,1997
MT,natural resources,274,477288,219,176,388480,88808,10043,1997
MT,water transport and terminals,407,916445,386,148,866658,49787,5286,1997
MT,electric power,0,0,0,0,0,0,0,1997
MT,gas supply,0,0,0,0,0,0,0,1997
MT,transit,147,279961,137,22,267284,12677,1941,1997
MT,education - elementary and secondary instructional,15361,36546157,13173,5710,33173860,3372297,373608,1997
MT,education - elementary and secondary other,5338,9043100,3606,4651,6745720,2297380,300318,1997
MT,education - higher education instructional,56,156065,49,21,141913,14152,1206,1997
MT,education - higher education other,92,172641,67,69,150228,22413,4394,1997
MT,libraries,283,464362,160,290,291789,172573,21417,1997
MT,other and unallocable,890,1645547,660,765,1295900,349647,41990,1997
NE,total,75377,178587058,66360,25196,164593164,13993894,1624103,1997
NE,financial administration,1482,2793859,1390,374,2629773,164086,18394,1997
NE,other government administration,1649,3502772,1489,2048,3073251,429521,34393,1997
NE,judicial and legal,974,2279653,903,194,2136459,143194,13239,1997
NE,police protection - officers,2633,8038334,2600,150,7976585,61749,7484,1997
NE,police protection - other,879,1738583,792,180,1627907,110676,15041,1997
NE,fire protection - firefighters,1146,4292259,1127,220,4269272,22987,3709,1997
NE,fire protection - other,54,136758,52,72,129457,7301,905,1997
NE,corrections,1003,2006144,953,124,1938294,67850,9076,1997
NE,streets and highways,2901,5906280,2797,354,5703996,202284,22168,1997
NE,air transportation,220,588913,197,71,544599,44314,4255,1997
NE,water transport and terminals,0,0,0,0,0,0,0,1997
NE,public welfare,797,1230624,650,312,1034321,196303,26866,1997
NE,health,423,1058143,351,235,931877,126266,13012,1997
NE,hospitals,4154,8380537,3372,1272,7029626,1350911,134900,1997
NE,solid waste management,254,542496,231,110,498101,44395,5821,1997
NE,sewerage,647,1675277,625,129,1614548,60729,6456,1997
NE,parks and recreation,1287,2178308,753,983,1631519,546789,94745,1997
NE,housing and community development,706,1437600,585,306,1294792,142808,19488,1997
NE,natural resources,754,1340500,678,306,1230878,109622,14467,1997
NE,water transport and terminals,867,2314187,828,206,2232805,81382,9991,1997
NE,electric power,6602,23612223,6427,323,23297869,314354,31352,1997
NE,gas supply,525,1718964,525,0,1718964,0,0,1997
NE,transit,389,986916,377,32,968067,18849,2119,1997
NE,education - elementary and secondary instructional,29624,72534920,27111,6619,68672427,3862493,443034,1997
NE,education - elementary and secondary other,10077,16553434,7714,6087,13365406,3188028,426102,1997
NE,education - higher education instructional,1137,3420990,778,1011,2482675,938315,63890,1997
NE,education - higher education other,1540,3358437,1009,1246,2398411,960026,94009,1997
NE,libraries,654,1168315,368,691,820361,347954,50464,1997
NE,other and unallocable,1999,3791632,1678,1541,3340924,450708,58723,1997
NV,total,56607,174186308,49826,15746,160092227,14094081,1161651,1997
NV,financial administration,1131,3823286,1100,51,3753215,70071,5607,1997
NV,other government administration,1607,5230008,1552,187,5117807,112201,9509,1997
NV,judicial and legal,2525,8878560,2384,320,8614372,264188,25343,1997
NV,police protection - officers,3143,13307830,3104,89,13244787,63043,7073,1997
NV,police protection - other,1406,4313697,1271,381,4110211,203486,23206,1997
NV,fire protection - firefighters,1761,8138839,1729,751,8078612,60227,5929,1997
NV,fire protection - other,159,583751,143,44,554568,29183,2980,1997
NV,corrections,1381,5090151,1357,52,5026246,63905,4347,1997
NV,streets and highways,1393,4815637,1368,43,4759735,55902,4449,1997
NV,air transportation,946,2805173,931,22,2777810,27363,2544,1997
NV,water transport and terminals,0,0,0,0,0,0,0,1997
NV,public welfare,379,1055425,339,81,982055,73370,7330,1997
NV,health,385,1210468,345,124,1103633,106835,7176,1997
NV,hospitals,4355,14224531,3681,1115,11971057,2253474,119072,1997
NV,solid waste management,52,132330,52,1,132022,308,28,1997
NV,sewerage,795,2721647,784,22,2700941,20706,1777,1997
NV,parks and recreation,2174,5572679,1429,2344,4447938,1124741,130120,1997
NV,housing and community development,518,1514585,509,23,1499873,14712,1542,1997
NV,natural resources,117,313012,104,48,283244,29768,2216,1997
NV,water transport and terminals,1280,4607419,1259,42,4565052,42367,3594,1997
NV,electric power,67,255118,66,4,251297,3821,283,1997
NV,gas supply,0,0,0,0,0,0,0,1997
NV,transit,123,409758,119,11,403163,6595,802,1997
NV,education - elementary and secondary instructional,20568,60386650,18073,5866,54887004,5499646,421205,1997
NV,education - elementary and secondary other,7880,17819803,6125,3324,14637546,3182257,294345,1997
NV,education - higher education instructional,0,0,0,0,0,0,0,1997
NV,education - higher education other,0,0,0,0,0,0,0,1997
NV,libraries,736,1653913,520,406,1239896,414017,38103,1997
NV,other and unallocable,1726,5322038,1482,395,4950143,371895,43071,1997
NH,total,38830,99691118,33387,14881,90676098,9015020,927404,1997
NH,financial administration,842,2035603,710,430,1792732,242871,23918,1997
NH,other government administration,696,1800993,548,666,1523964,277029,25723,1997
NH,judicial and legal,209,569318,178,59,514753,54565,5169,1997
NH,police protection - officers,2172,7092386,1993,534,6799879,292507,32116,1997
NH,police protection - other,616,1317024,495,338,1134340,182684,20962,1997
NH,fire protection - firefighters,1374,4298353,1240,1526,4081980,216373,24743,1997
NH,fire protection - other,71,165867,57,61,145819,20048,2111,1997
NH,corrections,506,1211346,490,26,1184107,27239,2659,1997
NH,streets and highways,1506,4255773,1404,246,4093523,162250,18039,1997
NH,air transportation,58,168231,54,8,156756,11475,676,1997
NH,water transport and terminals,0,0,0,0,0,0,0,1997
NH,public welfare,2093,4089580,1531,866,3100180,989400,97570,1997
NH,health,169,420020,131,114,346343,73677,6920,1997
NH,hospitals,281,523189,191,143,366717,156472,15971,1997
NH,solid waste management,618,1389379,502,353,1209302,180077,21585,1997
NH,sewerage,363,1016313,349,60,989715,26598,2429,1997
NH,parks and recreation,313,661014,197,347,503986,157028,20378,1997
NH,housing and community development,377,878292,337,89,816924,61368,6237,1997
NH,natural resources,35,69224,33,6,65801,3423,325,1997
NH,water transport and terminals,344,924315,309,151,852337,71978,6449,1997
NH,electric power,10,25753,9,3,24240,1513,141,1997
NH,gas supply,0,0,0,0,0,0,0,1997
NH,transit,100,197634,51,85,121600,76034,8643,1997
NH,education - elementary and secondary instructional,19323,53730372,17463,4200,50329894,3400478,308072,1997
NH,education - elementary and secondary other,5410,10091302,4244,2664,8428210,1663092,192689,1997
NH,education - higher education instructional,3,5938,1,14,1758,4180,343,1997
NH,education - higher education other,1,1683,0,2,0,1683,166,1997
NH,libraries,587,1141478,345,618,788312,353166,43929,1997
NH,other and unallocable,753,1610738,525,1272,1302926,307812,39441,1997
NJ,total,298363,1067474463,271178,74534,1015743234,51731229,4533739,1997
NJ,financial administration,5181,15625646,4777,1052,14564749,1060897,68865,1997
NJ,other government administration,6378,18826927,5570,3238,16761585,2065342,139096,1997
NJ,judicial and legal,7333,24783986,6700,1600,23133078,1650908,108558,1997
NJ,police protection - officers,21480,102609491,20964,1273,101718526,890965,88387,1997
NJ,police protection - other,6280,12823837,3870,5886,9095380,3728457,419786,1997
NJ,fire protection - firefighters,6259,29107736,6062,726,28756415,351321,34186,1997
NJ,fire protection - other,574,1450375,432,547,1174214,276161,25460,1997
NJ,corrections,6194,22496091,6102,162,22295049,201042,15329,1997
NJ,streets and highways,10272,31815048,9989,578,31375038,440010,48173,1997
NJ,air transportation,48,164914,48,1,164387,527,64,1997
NJ,water transport and terminals,2,4839,0,5,0,4839,320,1997
NJ,public welfare,11086,33136595,10453,1406,31742684,1393911,112687,1997
NJ,health,3673,11004109,3310,901,10217965,786144,62931,1997
NJ,hospitals,5213,15879743,4533,789,13506824,2372919,118131,1997
NJ,solid waste management,4815,13571707,4543,573,13117222,454485,48008,1997
NJ,sewerage,4457,15249443,4381,327,15040554,208889,13401,1997
NJ,parks and recreation,4966,12490970,3674,3409,10663850,1827120,222063,1997
NJ,housing and community development,3509,9922106,3333,346,9641696,280410,30946,1997
NJ,natural resources,428,1241660,410,52,1195094,46566,3349,1997
NJ,water transport and terminals,2593,8157392,2489,211,7986247,171145,18137,1997
NJ,electric power,287,1182406,285,2,1179445,2961,313,1997
NJ,gas supply,0,0,0,0,0,0,0,1997
NJ,transit,419,1308096,408,22,1284970,23126,2001,1997
NJ,education - elementary and secondary instructional,116658,508625528,110072,18197,494344273,14281255,1072475,1997
NJ,education - elementary and secondary other,45429,111543139,39446,16815,102164424,9378715,968888,1997
NJ,education - higher education instructional,4637,15347313,2761,5188,11397439,3949874,301466,1997
NJ,education - higher education other,6533,14535601,5254,4328,12664476,1871125,208692,1997
NJ,libraries,4656,10389101,3445,3929,8632804,1756297,208867,1997
NJ,other and unallocable,9003,24180664,7867,2971,21924846,2255818,193160,1997
NM,total,69941,148459197,65792,12794,141912332,6546865,721379,1997
NM,financial administration,1716,3888715,1664,111,3809862,78853,9552,1997
NM,other government administration,2234,5326303,2120,676,4992373,333930,20602,1997
NM,judicial and legal,378,954008,326,144,863028,90980,10157,1997
NM,police protection - officers,3373,9372823,3327,84,9307107,65716,8113,1997
NM,police protection - other,1244,2357773,1113,336,2178172,179601,23121,1997
NM,fire protection - firefighters,1592,4703280,1578,170,4685723,17557,2504,1997
NM,fire protection - other,138,369716,133,13,363914,5802,658,1997
NM,corrections,1431,2891402,1393,73,2835922,55480,6510,1997
NM,streets and highways,1700,3653784,1688,25,3637077,16707,2234,1997
NM,air transportation,292,608421,285,14,600076,8345,1194,1997
NM,water transport and terminals,0,0,0,0,0,0,0,1997
NM,public welfare,413,757296,311,162,640306,116990,17690,1997
NM,health,346,798299,336,38,778834,19465,1648,1997
NM,hospitals,2916,7204523,2070,1180,5722322,1482201,149832,1997
NM,solid waste management,1167,2463543,1144,67,2432453,31090,4325,1997
NM,sewerage,695,1670672,686,31,1656830,13842,1401,1997
NM,parks and recreation,1603,3197127,1339,1845,2707813,489314,46660,1997
NM,housing and community development,353,700844,342,25,682447,18397,2042,1997
NM,natural resources,570,962290,512,200,888980,73310,10481,1997
NM,water transport and terminals,779,1702640,768,35,1688512,14128,1969,1997
NM,electric power,216,669542,215,2,667483,2059,162,1997
NM,gas supply,127,290390,123,8,285495,4895,768,1997
NM,transit,566,1234245,491,87,1113744,120501,13209,1997
NM,education - elementary and secondary instructional,30529,65444991,29820,2624,64490814,954177,117270,1997
NM,education - elementary and secondary other,10863,17240772,10211,2031,16465611,775161,110342,1997
NM,education - higher education instructional,913,2819689,646,1136,2050218,769471,47269,1997
NM,education - higher education other,1703,3154842,1274,1148,2616825,538017,75937,1997
NM,libraries,522,940524,426,186,820642,119882,16578,1997
NM,other and unallocable,1562,3080743,1451,343,2929749,150994,19151,1997
NY,total,860168,2878401804,775762,196608,2728949605,149452199,13299304,1997
NY,financial administration,12494,35999098,11265,3365,33485145,2513953,214056,1997
NY,other government administration,16312,44435035,13851,11401,39541927,4893108,425858,1997
NY,judicial and legal,11529,38067860,10383,4004,34896297,3171563,205810,1997
NY,police protection - officers,65562,262171449,64502,3914,259797900,2373549,179334,1997
NY,police protection - other,9150,29421514,7735,4150,27139215,2282299,248269,1997
NY,fire protection - firefighters,21446,86642372,21155,1309,86102146,540226,53096,1997
NY,fire protection - other,2242,8163432,2068,839,7823048,340384,34405,1997
NY,corrections,25931,98475348,25431,985,97535794,939554,81466,1997
NY,streets and highways,26713,81644346,25944,2136,80373885,1270461,132040,1997
NY,air transportation,1508,6565510,1496,28,6544432,21078,2163,1997
NY,water transport and terminals,519,1907763,513,27,1899606,8157,1039,1997
NY,public welfare,51862,128488963,48616,6177,122197510,6291453,523891,1997
NY,health,17179,50199159,15099,4131,44985037,5214122,335785,1997
NY,hospitals,51957,169568998,50325,2595,165257604,4311394,264548,1997
NY,solid waste management,14811,53389096,14489,842,52839420,549676,57357,1997
NY,sewerage,6629,20723064,6501,447,20424069,298995,22226,1997
NY,parks and recreation,10190,26079320,7758,6248,21888172,4191148,406048,1997
NY,housing and community development,21649,51801479,21364,1383,51133574,667905,47318,1997
NY,natural resources,343,1045151,329,51,1021123,24028,2665,1997
NY,water transport and terminals,6391,20126990,6198,1561,19698424,428566,37090,1997
NY,electric power,434,1515886,428,23,1502592,13294,1309,1997
NY,gas supply,11,26796,10,1,25446,1350,92,1997
NY,transit,37703,145762054,37567,244,145556294,205760,23710,1997
NY,education - elementary and secondary instructional,277147,1081168152,260912,41284,1050869508,30298644,2537824,1997
NY,education - elementary and secondary other,113152,257627120,77669,62701,205013129,52613991,5295298,1997
NY,education - higher education instructional,11341,44251778,7089,10753,33600213,10651565,691258,1997
NY,education - higher education other,11187,30584986,8221,7984,25322843,5262143,496616,1997
NY,libraries,10041,23956909,7376,6985,20020551,3936358,430071,1997
NY,other and unallocable,24735,78592176,21468,11040,72454701,6137475,548662,1997
NC,total,293505,688389146,268586,75273,641289790,47099356,4404693,1997
NC,financial administration,5409,13165790,5251,320,12913214,252576,27469,1997
NC,other government administration,4279,10912370,3888,1904,10116727,795643,70541,1997
NC,judicial and legal,706,1955128,652,123,1859641,95487,9546,1997
NC,police protection - officers,14376,36235145,14170,652,35928043,307102,37233,1997
NC,police protection - other,3021,6158802,2720,864,5713061,445741,52418,1997
NC,fire protection - firefighters,5457,14306777,5390,567,14206249,100528,12395,1997
NC,fire protection - other,368,945321,355,33,927887,17434,2059,1997
NC,corrections,4070,8641167,3955,240,8471292,169875,20476,1997
NC,streets and highways,3455,7275841,3373,169,7158366,117475,13823,1997
NC,air transportation,666,1567074,621,111,1508775,58299,7885,1997
NC,water transport and terminals,0,0,0,0,0,0,0,1997
NC,public welfare,13218,27351970,12425,1526,26363121,988849,139129,1997
NC,health,14782,34206849,13799,2247,32354946,1851903,173483,1997
NC,hospitals,17723,42365663,16403,2227,39884644,2481019,233422,1997
NC,solid waste management,4611,8621777,4161,794,8066679,555098,79067,1997
NC,sewerage,3361,7735707,3327,89,7676603,59104,6143,1997
NC,parks and recreation,3974,7601729,2926,3284,6413022,1188707,183509,1997
NC,housing and community development,2846,6420866,2683,263,6201807,219059,27434,1997
NC,natural resources,1162,2021199,1043,271,1835415,185784,20378,1997
NC,water transport and terminals,3527,7719654,3464,170,7620648,99006,11909,1997
NC,electric power,1202,3323252,1196,11,3313753,9499,1104,1997
NC,gas supply,162,385595,161,1,384477,1118,177,1997
NC,transit,528,952172,429,179,829566,122606,16996,1997
NC,education - elementary and secondary instructional,118288,309154830,112457,21070,293364325,15790505,1032115,1997
NC,education - elementary and secondary other,40708,67244563,32685,19219,55104731,12139832,1425268,1997
NC,education - higher education instructional,6674,20533112,4506,11318,14824710,5708402,381839,1997
NC,education - higher education other,6970,16158999,5791,4351,14434828,1724171,206271,1997
NC,libraries,2375,4626620,1914,1178,4040069,586551,81053,1997
NC,other and unallocable,9587,20801174,8841,2092,19773191,1027983,131551,1997
ND,total,21221,50741189,17414,17585,44824204,5916985,703657,1997
ND,financial administration,670,1464722,599,1457,1279816,184906,19202,1997
ND,other government administration,377,776049,251,5710,430523,345526,31708,1997
ND,judicial and legal,309,711253,281,159,632609,78644,6220,1997
ND,police protection - officers,964,2345416,946,63,2313225,32191,3848,1997
ND,police protection - other,201,359686,187,44,340617,19069,2517,1997
ND,fire protection - firefighters,323,912821,318,541,899946,12875,1780,1997
ND,fire protection - other,7,15462,5,77,10670,4792,638,1997
ND,corrections,184,350977,156,53,317843,33134,4707,1997
ND,streets and highways,951,2020511,872,332,1899286,121225,15710,1997
ND,air transportation,74,188185,65,46,170722,17463,2059,1997
ND,water transport and terminals,0,0,0,0,0,0,0,1997
ND,public welfare,825,1556293,713,299,1389676,166617,19652,1997
ND,health,323,677997,190,354,404805,273192,23410,1997
ND,hospitals,0,0,0,0,0,0,0,1997
ND,solid waste management,356,769328,321,70,710257,59071,6517,1997
ND,sewerage,136,319136,127,70,302294,16842,2439,1997
ND,parks and recreation,748,1148278,383,1459,771374,376904,65318,1997
ND,housing and community development,265,505544,201,111,401551,103993,11285,1997
ND,natural resources,203,348206,159,196,285098,63108,8014,1997
ND,water transport and terminals,338,763684,310,117,717558,46126,6524,1997
ND,electric power,8,18996,8,0,18996,0,0,1997
ND,gas supply,0,0,0,0,0,0,0,1997
ND,transit,44,97162,24,29,58417,38745,3512,1997
ND,education - elementary and secondary instructional,9868,28348810,8639,2076,26447047,1901763,217712,1997
ND,education - elementary and secondary other,3421,5870774,2257,2611,4178638,1692136,206208,1997
ND,education - higher education instructional,0,0,0,0,0,0,0,1997
ND,education - higher education other,0,0,0,0,0,0,0,1997
ND,libraries,122,223117,76,164,158558,64559,9151,1997
ND,other and unallocable,504,948782,326,1547,684678,264104,35526,1997
OH,total,421092,1128512234,376360,119028,1052167813,76344421,7702787,1997
OH,financial administration,7522,18571317,7126,1267,17625074,946243,77220,1997
OH,other government administration,8658,21465421,7388,9567,17740848,3724573,241360,1997
OH,judicial and legal,15176,35848552,14542,1740,34119787,1728765,114597,1997
OH,police protection - officers,21150,69063399,20447,2281,67929972,1133427,127395,1997
OH,police protection - other,6233,13856328,5288,2729,12390117,1466211,166792,1997
OH,fire protection - firefighters,13612,42667009,11366,10597,39524099,3142910,397360,1997
OH,fire protection - other,548,1228334,423,533,1068311,160023,22035,1997
OH,corrections,7709,17054650,7495,521,16694828,359822,37431,1997
OH,streets and highways,12909,32471778,12290,1616,31529287,942491,114853,1997
OH,air transportation,1164,3215159,1123,100,3133489,81670,7412,1997
OH,water transport and terminals,46,118219,42,11,114956,3263,410,1997
OH,public welfare,24508,58564281,23650,1771,57130557,1433724,149465,1997
OH,health,16376,38657677,14608,3851,35377791,3279886,307685,1997
OH,hospitals,12683,32963228,10385,2603,29068660,3894568,403200,1997
OH,solid waste management,3307,8266318,3072,443,7658160,608158,43150,1997
OH,sewerage,6362,17602843,6269,202,17448780,154063,15777,1997
OH,parks and recreation,7560,16626383,5289,5501,13542790,3083593,401174,1997
OH,housing and community development,4861,11980453,4689,367,11695449,285004,29180,1997
OH,natural resources,880,1879230,828,110,1800109,79121,8740,1997
OH,water transport and terminals,7177,19059250,7016,448,18782449,276801,29292,1997
OH,electric power,1450,4855214,1428,43,4791202,64012,4140,1997
OH,gas supply,67,206043,64,3,199226,6817,469,1997
OH,transit,6106,18607457,5811,570,18120399,487058,52567,1997
OH,education - elementary and secondary instructional,143694,460921064,135212,20948,444564475,16356589,1420385,1997
OH,education - elementary and secondary other,66374,124209357,52220,34345,102427969,21781388,2381699,1997
OH,education - higher education instructional,2457,8140928,1082,2559,4895702,3245226,231141,1997
OH,education - higher education other,2875,6577922,1522,2593,4888294,1689628,229548,1997
OH,libraries,7366,15096835,4937,5329,11706395,3390440,414724,1997
OH,other and unallocable,12262,28737585,10748,6380,26198638,2538947,273586,1997
OK,total,129462,264258979,119729,28021,250394283,13864696,1705276,1997
OK,financial administration,2681,5070623,2612,395,4897325,173298,15658,1997
OK,other government administration,2042,4506914,1946,1164,4254005,252909,19761,1997
OK,judicial and legal,1311,2640045,1209,363,2463709,176336,21707,1997
OK,police protection - officers,6286,15850261,6167,310,15679112,171149,21689,1997
OK,police protection - other,1923,3378063,1779,513,3146745,231318,26203,1997
OK,fire protection - firefighters,3789,11971531,3703,1403,11835038,136493,17834,1997
OK,fire protection - other,165,382827,152,45,370305,12522,2331,1997
OK,corrections,950,1357881,863,182,1237183,120698,15398,1997
OK,streets and highways,5199,8917010,5042,280,8706653,210357,28005,1997
OK,air transportation,258,651856,248,17,640490,11366,1716,1997
OK,water transport and terminals,18,58268,17,10,55749,2519,260,1997
OK,public welfare,376,568922,344,83,534870,34052,5748,1997
OK,health,1112,2275549,1012,335,2146420,129129,18143,1997
OK,hospitals,9334,19203546,8441,1907,17069024,2134522,158368,1997
OK,solid waste management,1163,2009450,1121,75,1960372,49078,7625,1997
OK,sewerage,1175,2314984,1160,65,2284445,30539,3688,1997
OK,parks and recreation,2079,3814919,1570,1030,3265599,549320,89916,1997
OK,housing and community development,970,1767290,909,188,1680465,86825,11712,1997
OK,natural resources,346,572367,311,98,523545,48822,6427,1997
OK,water transport and terminals,2678,5235482,2549,408,5036511,198971,23882,1997
OK,electric power,372,847979,366,9,841682,6297,1177,1997
OK,gas supply,29,54891,27,2,51921,2970,223,1997
OK,transit,215,545612,203,21,526367,19245,2105,1997
OK,education - elementary and secondary instructional,55995,127080826,53174,8712,123356958,3723868,478985,1997
OK,education - elementary and secondary other,24892,35655145,21125,9065,30895135,4760010,649480,1997
OK,education - higher education instructional,0,0,0,0,0,0,0,1997
OK,education - higher education other,0,0,0,0,0,0,0,1997
OK,libraries,788,1325780,621,475,1114677,211103,30166,1997
OK,other and unallocable,3316,6200958,3058,866,5819978,380980,47069,1997
OR,total,117999,331502353,99096,51138,294557391,36944962,3332319,1997
OR,financial administration,2455,6906477,2343,321,6663842,242635,20132,1997
OR,other government administration,2423,7438426,2237,498,6957898,480528,33965,1997
OR,judicial and legal,1451,4237792,1343,285,3940487,297305,19707,1997
OR,police protection - officers,4468,16784815,4426,148,16706282,78533,7715,1997
OR,police protection - other,1787,5361877,1699,205,5186570,175307,15579,1997
OR,fire protection - firefighters,3198,12838868,3099,1184,12688323,150545,18730,1997
OR,fire protection - other,549,1666624,503,153,1594575,72049,8608,1997
OR,corrections,2951,8146870,2703,556,7693548,453322,43400,1997
OR,streets and highways,4327,12342020,4146,286,11951487,390533,31710,1997
OR,air transportation,291,1048318,252,63,972962,75356,6784,1997
OR,water transport and terminals,205,695511,198,19,686390,9121,1215,1997
OR,public welfare,810,1851287,707,187,1671139,180148,17873,1997
OR,health,3692,9098735,2888,1608,7477772,1620963,140857,1997
OR,hospitals,2706,7302453,2056,1184,5737888,1564565,108594,1997
OR,solid waste management,463,1361181,413,150,1246760,114421,9108,1997
OR,sewerage,1547,4843285,1471,174,4709701,133584,13730,1997
OR,parks and recreation,2385,5571133,1530,3033,4140108,1431025,150321,1997
OR,housing and community development,868,2188601,822,120,2095552,93049,8129,1997
OR,natural resources,562,1182086,496,194,1083305,98781,11653,1997
OR,water transport and terminals,2181,6951101,2113,276,6811217,139884,12885,1997
OR,electric power,1302,5042658,1274,54,4977954,64704,4974,1997
OR,gas supply,0,0,0,0,0,0,0,1997
OR,transit,2603,7941320,2359,435,7394553,546767,43200,1997
OR,education - elementary and secondary instructional,42699,125877686,36038,16948,112151581,13726105,1174650,1997
OR,education - elementary and secondary other,18150,38244414,14010,9188,31724896,6519518,731470,1997
OR,education - higher education instructional,3558,11676903,2081,5463,7451103,4225800,260812,1997
OR,education - higher education other,4919,10504237,3547,5582,8402524,2101713,240268,1997
OR,libraries,1502,3243024,894,1411,2191348,1051676,107671,1997
OR,other and unallocable,3947,11154651,3448,1413,10247626,907025,88579,1997
PA,total,365556,1057356770,332239,93896,1004306296,53050474,5712363,1997
PA,financial administration,7755,17919449,7012,5211,15980105,1939344,150676,1997
PA,other government administration,8762,21608054,7906,8278,19378221,2229833,170130,1997
PA,judicial and legal,13672,31591204,13089,2176,30539259,1051945,102184,1997
PA,police protection - officers,19488,66756298,18107,3554,64726523,2029775,240984,1997
PA,police protection - other,5029,10229181,3311,4689,7428901,2800280,299119,1997
PA,fire protection - firefighters,5521,19282387,5360,541,19067383,215004,28279,1997
PA,fire protection - other,473,1154178,400,210,1035495,118683,12081,1997
PA,corrections,11257,28276213,10880,700,27676844,599369,63586,1997
PA,streets and highways,10465,24504239,9670,2299,23318058,1186181,144487,1997
PA,air transportation,1294,3688129,1214,158,3560022,128107,13874,1997
PA,water transport and terminals,893,1900119,781,142,1757311,142808,19687,1997
PA,public welfare,20051,41964674,18731,3787,39824215,2140459,227720,1997
PA,health,5143,13244302,4951,516,12931597,312705,33565,1997
PA,hospitals,0,0,0,0,0,0,0,1997
PA,solid waste management,3332,8174763,3224,263,8006657,168106,20312,1997
PA,sewerage,5459,14716545,5198,948,14271780,444765,48136,1997
PA,parks and recreation,3789,8481403,2978,2343,7381763,1099640,140823,1997
PA,housing and community development,6398,16085244,6036,659,15405226,680018,59738,1997
PA,natural resources,313,637083,298,110,609658,27425,3166,1997
PA,water transport and terminals,5298,14384032,5100,748,14057065,326967,37558,1997
PA,electric power,148,464603,138,26,444135,20468,1872,1997
PA,gas supply,7,20747,7,0,20747,0,0,1997
PA,transit,13336,46479226,13148,301,46210739,268487,32706,1997
PA,education - elementary and secondary instructional,141593,501658562,133532,21269,488675946,12982616,1344419,1997
PA,education - elementary and secondary other,59554,125543887,48668,23993,109884802,15659085,1829567,1997
PA,education - higher education instructional,3086,9568123,1551,4221,6566399,3001724,256037,1997
PA,education - higher education other,3994,8089637,2733,2837,6447444,1642193,213504,1997
PA,libraries,1455,3552924,1191,618,3188331,364593,45529,1997
PA,other and unallocable,7991,17381564,7025,3299,15911670,1469894,172624,1997
RI,total,29102,90536622,26917,5521,86938781,3597841,348039,1997
RI,financial administration,589,1491692,561,69,1443164,48528,4648,1997
RI,other government administration,692,1555035,652,273,1438720,116315,7164,1997
RI,judicial and legal,94,204145,68,44,159801,44344,4621,1997
RI,police protection - officers,2040,7183821,2034,15,7174175,9646,1011,1997
RI,police protection - other,523,1088120,426,240,936909,151211,16440,1997
RI,fire protection - firefighters,2118,7105078,2079,220,7055371,49707,6505,1997
RI,fire protection - other,158,343041,153,28,335433,7608,796,1997
RI,corrections,0,0,0,0,0,0,0,1997
RI,streets and highways,918,2279868,905,35,2262967,16901,1993,1997
RI,air transportation,0,0,0,0,0,0,0,1997
RI,water transport and terminals,0,0,0,0,0,0,0,1997
RI,public welfare,95,187802,62,63,146601,41201,5141,1997
RI,health,72,220122,67,14,211021,9101,795,1997
RI,hospitals,0,0,0,0,0,0,0,1997
RI,solid waste management,149,339163,147,8,333967,5196,600,1997
RI,sewerage,379,999728,374,9,989774,9954,702,1997
RI,parks and recreation,332,702395,266,202,613397,88998,11184,1997
RI,housing and community development,535,1303189,469,116,1207310,95879,11351,1997
RI,natural resources,3,3679,0,15,0,3679,371,1997
RI,water transport and terminals,500,1279836,494,12,1271561,8275,912,1997
RI,electric power,12,43807,11,1,42753,1054,115,1997
RI,gas supply,0,0,0,0,0,0,0,1997
RI,transit,0,0,0,0,0,0,0,1997
RI,education - elementary and secondary instructional,15379,53538646,14602,1801,52132587,1406059,122852,1997
RI,education - elementary and secondary other,3768,9054327,2969,1941,7789332,1264995,122591,1997
RI,libraries,393,771568,273,289,624151,147417,20264,1997
RI,other and unallocable,353,841560,305,126,769787,71773,7983,1997
SC,total,143952,328035043,135445,22599,314685764,13349279,1459860,1997
SC,financial administration,2610,5562076,2522,197,5429200,132876,15060,1997
SC,other government administration,2149,5009106,2014,960,4670148,338958,24547,1997
SC,judicial and legal,2682,5578093,2492,431,5197375,380718,33201,1997
SC,police protection - officers,6850,16417792,6820,118,16367607,50185,5572,1997
SC,police protection - other,1809,3024499,1617,510,2799697,224802,33217,1997
SC,fire protection - firefighters,3069,6957772,2974,701,6840245,117527,16887,1997
SC,fire protection - other,165,334072,159,13,325901,8171,1041,1997
SC,corrections,2099,3901156,2081,28,3882450,18706,2666,1997
SC,streets and highways,2389,4447504,2368,39,4418476,29028,3399,1997
SC,air transportation,357,682844,347,23,666315,16529,1731,1997
SC,water transport and terminals,0,0,0,0,0,0,0,1997
SC,public welfare,301,463569,275,53,432323,31246,4405,1997
SC,health,1929,4263101,1784,344,4050931,212170,24751,1997
SC,hospitals,19911,52248789,17823,4393,47570987,4677802,368527,1997
SC,solid waste management,2667,4161636,2321,653,3772834,388802,59853,1997
SC,sewerage,1659,3588201,1637,42,3556826,31375,3904,1997
SC,parks and recreation,2117,3713806,1643,1267,3179144,534662,82200,1997
SC,housing and community development,1013,2168928,976,87,2122554,46374,6086,1997
SC,natural resources,95,162773,70,42,135471,27302,3490,1997
SC,water transport and terminals,2320,5362490,2290,106,5309242,53248,5806,1997
SC,electric power,292,717902,292,2,716701,1201,103,1997
SC,gas supply,309,758896,302,18,748481,10415,1329,1997
SC,transit,432,649607,385,80,598123,51484,7958,1997
SC,education - elementary and secondary instructional,60133,153362916,58671,5211,151156684,2206232,246556,1997
SC,education - elementary and secondary other,22506,36850014,19885,6167,33624157,3225857,439236,1997
SC,education - higher education instructional,0,0,0,0,0,0,0,1997
SC,education - higher education other,0,0,0,0,0,0,0,1997
SC,libraries,952,1696186,767,539,1454561,241625,32175,1997
SC,other and unallocable,3137,5951315,2930,575,5659331,291984,36160,1997
SD,total,26567,55347245,23218,15147,49920466,5426779,611410,1997
SD,financial administration,962,1803968,879,840,1628578,175390,19318,1997
SD,other government administration,500,1153623,407,3775,760177,393446,24895,1997
SD,judicial and legal,212,556422,191,77,486633,69789,4284,1997
SD,police protection - officers,1055,2610588,1033,95,2573805,36783,5072,1997
SD,police protection - other,335,571341,296,132,520861,50480,7302,1997
SD,fire protection - firefighters,361,1018682,360,214,1014027,4655,562,1997
SD,fire protection - other,22,53779,21,21,50481,3298,474,1997
SD,corrections,387,786080,358,87,691908,94172,4938,1997
SD,streets and highways,1525,3160542,1441,274,3022084,138458,17315,1997
SD,air transportation,52,115241,44,13,104654,10587,1212,1997
SD,water transport and terminals,0,0,0,0,0,0,0,1997
SD,public welfare,309,432291,158,259,225766,206525,26825,1997
SD,health,220,414340,147,285,302204,112136,13082,1997
SD,hospitals,510,1078122,334,304,760630,317492,31064,1997
SD,solid waste management,232,456794,210,80,426311,30483,4595,1997
SD,sewerage,259,620098,243,116,584388,35710,3843,1997
SD,parks and recreation,400,774608,269,464,619235,155373,23079,1997
SD,housing and community development,132,249208,103,89,208361,40847,4899,1997
SD,natural resources,280,437535,218,235,352169,85366,10990,1997
SD,water transport and terminals,358,800156,334,86,760398,39758,5355,1997
SD,electric power,134,370974,128,24,358182,12792,1028,1997
SD,gas supply,12,44581,12,0,44581,0,0,1997
SD,transit,0,0,0,0,0,0,0,1997
SD,education - elementary and secondary instructional,12484,28099764,11660,2464,26734280,1365484,142977,1997
SD,education - elementary and secondary other,4558,7154473,3419,3694,5539423,1615050,199985,1997
SD,education - higher education instructional,140,437010,137,4,431208,5802,483,1997
SD,education - higher education other,84,181194,56,108,123211,57983,4714,1997
SD,libraries,268,476705,181,279,368954,107751,16134,1997
SD,other and unallocable,776,1489126,579,1128,1227957,261169,36985,1997
TN,total,194274,424204373,182268,33753,406117491,18086882,2063284,1997
TN,financial administration,3535,8161795,3388,334,7945471,216324,25765,1997
TN,other government administration,3211,7209774,3061,1329,6770375,439399,28341,1997
TN,judicial and legal,3375,8065877,3220,446,7706761,359116,28276,1997
TN,police protection - officers,10760,27779727,10659,303,27636265,143462,18231,1997
TN,police protection - other,2774,5692386,2509,689,5342160,350226,47764,1997
TN,fire protection - firefighters,5687,16269512,5605,1065,16158775,110737,15447,1997
TN,fire protection - other,321,898653,316,42,894574,4079,693,1997
TN,corrections,4610,9360260,4537,160,9271540,88720,12455,1997
TN,streets and highways,6815,11742506,6703,204,11606837,135669,19537,1997
TN,air transportation,721,2076729,676,77,2015326,61403,7765,1997
TN,water transport and terminals,11,28958,11,2,27429,1529,131,1997
TN,public welfare,3543,6066186,3292,500,5752297,313889,43706,1997
TN,health,3301,6990785,3183,249,6835852,154933,20882,1997
TN,hospitals,13198,28339163,11330,3006,24287237,4051926,325643,1997
TN,solid waste management,4221,7458802,3991,475,7212549,246253,40020,1997
TN,sewerage,1759,3528349,1747,43,3503297,25052,2539,1997
TN,parks and recreation,3918,5826574,3466,1194,5261055,565519,79257,1997
TN,housing and community development,2691,5825782,2576,188,5675962,149820,19236,1997
TN,natural resources,190,307468,157,113,265370,42098,6129,1997
TN,water transport and terminals,4060,9602699,3954,305,9441545,161154,18864,1997
TN,electric power,4816,15445446,4759,108,15365179,80267,9662,1997
TN,gas supply,1947,5459859,1929,39,5424924,34935,3441,1997
TN,transit,313,671813,244,119,547057,124756,12166,1997
TN,education - elementary and secondary instructional,73799,181824813,70855,9984,177579448,4245365,496512,1997
TN,education - elementary and secondary other,28505,36976692,24387,11590,31696168,5280524,696538,1997
TN,libraries,1335,2335753,1142,437,2081784,253969,34530,1997
TN,other and unallocable,4858,10258012,4571,752,9812254,445758,49754,1997
TX,total,850380,1936972352,790520,156712,1841701706,95270646,10432150,1997
TX,financial administration,11962,27419886,11664,659,26942004,477882,53861,1997
TX,other government administration,10409,25068725,9825,2220,24042990,1025735,110550,1997
TX,judicial and legal,15992,39121761,15208,1783,37600300,1521461,140549,1997
TX,police protection - officers,39954,117797106,39774,532,117503800,293306,31857,1997
TX,police protection - other,12764,24590084,11815,2828,23386818,1203266,166744,1997
TX,fire protection - firefighters,17228,56528427,17064,1095,56312081,216346,28964,1997
TX,fire protection - other,1452,3646709,1392,151,3528263,118446,11927,1997
TX,corrections,20563,44725450,20009,1070,43926368,799082,98148,1997
TX,streets and highways,17931,35481558,17290,1013,34565043,916515,113239,1997
TX,air transportation,4255,9834165,4153,153,9727623,106542,18628,1997
TX,water transport and terminals,863,2701629,843,54,2668756,32873,3253,1997
TX,public welfare,3609,6714295,3299,665,6318091,396204,55288,1997
TX,health,18094,37612742,16760,2472,35364114,2248628,236237,1997
TX,hospitals,44066,102523032,40538,6331,95281467,7241565,623508,1997
TX,solid waste management,6182,11803177,6026,291,11601140,202037,27345,1997
TX,sewerage,10306,22936680,10204,253,22789358,147322,18769,1997
TX,parks and recreation,13087,23686490,10928,4758,21050357,2636133,382070,1997
TX,housing and community development,6015,11561163,5538,1047,10797466,763697,84175,1997
TX,natural resources,3960,8462951,3761,594,8196378,266573,36361,1997
TX,water transport and terminals,13167,28976075,12912,689,28579752,396323,45901,1997
TX,electric power,7568,24665118,7521,97,24574580,90538,8566,1997
TX,gas supply,1332,3719033,1331,2,3717705,1328,146,1997
TX,transit,10006,31635448,9535,790,30777911,857537,83301,1997
TX,education - elementary and secondary instructional,361184,894311160,347638,42066,868968332,25342828,2325924,1997
TX,education - elementary and secondary other,147863,222893339,125850,50639,194479357,28413982,3805738,1997
TX,education - higher education instructional,13243,42399064,8326,16295,30366701,12032363,862562,1997
TX,education - higher education other,17240,34448836,13018,14058,29213562,5235274,741203,1997
TX,libraries,5264,9757522,4386,1864,8667214,1090308,154124,1997
TX,other and unallocable,14821,31950727,13912,2243,30754175,1196552,163212,1997
UT,total,63884,152745924,52864,32917,136472862,16273062,1906672,1997
UT,financial administration,1339,3438700,1232,275,3248145,190555,19241,1997
UT,other government administration,1687,4470489,1549,961,4137559,332930,26220,1997
UT,judicial and legal,794,2456040,701,288,2212973,243067,17810,1997
UT,police protection - officers,2836,8602780,2788,168,8522709,80071,8778,1997
UT,police protection - other,1259,2607520,920,915,2200619,406901,60418,1997
UT,fire protection - firefighters,1352,4062162,1100,1216,3702481,359681,45494,1997
UT,fire protection - other,167,392017,152,75,372432,19585,2585,1997
UT,corrections,750,1913408,736,41,1892387,21021,2469,1997
UT,streets and highways,1549,3896313,1473,190,3776969,119344,14209,1997
UT,air transportation,473,1089319,456,32,1064587,24732,2698,1997
UT,water transport and terminals,0,0,0,0,0,0,0,1997
UT,public welfare,388,780847,264,289,597914,182933,22133,1997
UT,health,1177,3078409,950,618,2636279,442130,40588,1997
UT,hospitals,775,1528398,593,415,1240607,287791,32337,1997
UT,solid waste management,409,963053,379,80,914288,48765,5757,1997
UT,sewerage,747,1978189,701,129,1893021,85168,8414,1997
UT,parks and recreation,1793,3326313,892,2873,2262653,1063660,159327,1997
UT,housing and community development,526,1351394,487,75,1300108,51286,6643,1997
UT,natural resources,386,1161393,364,112,1124082,37311,3852,1997
UT,water transport and terminals,1133,2955825,1093,192,2875479,80346,8291,1997
UT,electric power,495,1585619,476,39,1558306,27313,3035,1997
UT,gas supply,4,8250,3,4,6750,1500,230,1997
UT,transit,1226,3101486,1181,94,3022243,79243,7937,1997
UT,education - elementary and secondary instructional,29186,73250490,24994,11382,67101418,6149072,705712,1997
UT,education - elementary and secondary other,11034,19496702,7600,10568,14456922,5039780,591835,1997
UT,education - higher education instructional,0,0,0,0,0,0,0,1997
UT,education - higher education other,0,0,0,0,0,0,0,1997
UT,libraries,643,1292509,371,667,889399,403110,48303,1997
UT,other and unallocable,1756,3958299,1409,1219,3462532,495767,62356,1997
VT,total,17841,40975423,14944,8407,36274996,4700427,503849,1997
VT,financial administration,412,906339,302,511,695940,210399,21405,1997
VT,other government administration,420,981327,328,518,789798,191529,17612,1997
VT,judicial and legal,47,100104,38,20,81827,18277,1683,1997
VT,police protection - officers,581,1657464,520,150,1568914,88550,10523,1997
VT,police protection - other,183,381639,152,93,335663,45976,5677,1997
VT,fire protection - firefighters,281,774888,226,469,707387,67501,10430,1997
VT,fire protection - other,12,27377,7,29,18801,8576,1171,1997
VT,corrections,0,0,0,0,0,0,0,1997
VT,streets and highways,897,2295254,862,103,2230698,64556,6988,1997
VT,air transportation,20,62356,19,5,61209,1147,199,1997
VT,water transport and terminals,0,0,0,0,0,0,0,1997
VT,public welfare,0,0,0,0,0,0,0,1997
VT,health,23,47459,19,24,40016,7443,800,1997
VT,hospitals,0,0,0,0,0,0,0,1997
VT,solid waste management,127,280143,94,130,226476,53667,6791,1997
VT,sewerage,160,413829,148,30,392525,21304,2239,1997
VT,parks and recreation,184,355529,107,256,263832,91697,13649,1997
VT,housing and community development,94,208389,84,20,192004,16385,1669,1997
VT,natural resources,8,14540,2,15,3729,10811,1131,1997
VT,water transport and terminals,180,460155,168,81,436365,23790,2465,1997
VT,electric power,218,684928,213,9,679148,5780,670,1997
VT,gas supply,0,0,0,0,0,0,0,1997
VT,transit,117,234462,109,15,224187,10275,1242,1997
VT,education - elementary and secondary instructional,10706,25622537,9212,3690,23116199,2506338,250903,1997
VT,education - elementary and secondary other,2876,4892090,2138,1869,3788188,1103902,127973,1997
VT,education - higher education instructional,0,0,0,0,0,0,0,1997
VT,education - higher education other,0,0,0,0,0,0,0,1997
VT,libraries,111,199706,48,151,105973,93733,11457,1997
VT,other and unallocable,184,374908,148,219,316117,58791,7172,1997
VA,total,253219,630349211,224048,65267,587352604,42996607,4896239,1997
VA,financial administration,6029,16100956,5691,642,15456401,644555,59247,1997
VA,other government administration,4841,14578308,4557,1430,13787534,790774,51559,1997
VA,judicial and legal,3385,10321889,3210,338,9987121,334768,31225,1997
VA,police protection - officers,11757,36772857,11647,253,36620633,152224,18771,1997
VA,police protection - other,3212,6772749,2830,748,6238000,534749,66617,1997
VA,fire protection - firefighters,6508,20621152,6485,152,20575779,45373,4075,1997
VA,fire protection - other,587,1723550,538,85,1649670,73880,8727,1997
VA,corrections,6541,15823988,6176,610,15220234,603754,62557,1997
VA,streets and highways,4069,9354555,3928,206,9158827,195728,24675,1997
VA,air transportation,1463,5139699,1388,165,5002988,136711,13367,1997
VA,water transport and terminals,3,7487,3,3,6649,838,120,1997
VA,public welfare,7020,17043928,6623,685,16367749,676179,68485,1997
VA,health,5287,14314149,4284,1683,12367931,1946218,175307,1997
VA,hospitals,2760,6964192,2261,979,5790407,1173785,86703,1997
VA,solid waste management,3846,8265558,3540,510,7898650,366908,53476,1997
VA,sewerage,4012,10330468,3872,230,10052235,278233,24321,1997
VA,parks and recreation,6142,12455212,4350,5216,9949053,2506159,310943,1997
VA,housing and community development,1967,5118300,1902,114,5023385,94915,10595,1997
VA,natural resources,373,767206,279,181,624671,142535,16869,1997
VA,water transport and terminals,3747,9353748,3667,182,9226853,126895,13906,1997
VA,electric power,287,797236,284,5,791590,5646,495,1997
VA,gas supply,340,675463,336,5,667414,8049,701,1997
VA,transit,1362,2121960,908,759,1517186,604774,80077,1997
VA,education - elementary and secondary instructional,109486,298291467,103137,17940,287589969,10701498,1047721,1997
VA,education - elementary and secondary other,44592,74615971,30717,27533,56820207,17795764,2287466,1997
VA,education - higher education instructional,677,2900196,660,35,2853840,46356,3033,1997
VA,education - higher education other,666,859757,651,33,843995,15762,2640,1997
VA,libraries,3425,6982689,2100,2670,5182134,1800555,229969,1997
VA,other and unallocable,8835,21274521,8024,1875,20081499,1193022,142592,1997
WA,total,185152,589156797,149491,71012,510014073,79142724,6277055,1997
WA,financial administration,4906,14669880,4735,383,14255354,414526,29997,1997
WA,other government administration,4459,14910742,4137,1592,13965077,945665,57898,1997
WA,judicial and legal,5222,17204076,4939,744,16380493,823583,49215,1997
WA,police protection - officers,7785,32635487,7731,177,32522774,112713,9782,1997
WA,police protection - other,2870,8309166,2739,318,8022770,286396,23498,1997
WA,fire protection - firefighters,6104,24801229,5653,4203,24132490,668739,83059,1997
WA,fire protection - other,561,1848291,519,256,1754514,93777,8504,1997
WA,corrections,3789,12216889,3666,357,11913491,303398,21290,1997
WA,streets and highways,6710,21706298,6530,335,21186664,519634,30934,1997
WA,air transportation,1147,4350335,1084,94,4234475,115860,11007,1997
WA,water transport and terminals,1278,4257677,1224,148,4135015,122662,9815,1997
WA,public welfare,961,3063655,848,191,2801889,261766,19623,1997
WA,health,3868,11022237,3022,1396,8473144,2549093,135427,1997
WA,hospitals,9984,29715305,6626,5759,19678967,10036338,591091,1997
WA,solid waste management,1584,4841300,1423,279,4402909,438391,27544,1997
WA,sewerage,2700,8952583,2611,215,8721911,230672,15750,1997
WA,parks and recreation,4184,11014068,3029,3486,9081002,1933066,205070,1997
WA,housing and community development,1988,5637690,1800,424,5293106,344584,33029,1997
WA,natural resources,964,2968727,894,268,2788008,180719,12292,1997
WA,water transport and terminals,2995,10077882,2870,413,9780608,297274,24242,1997
WA,electric power,7257,31445927,7023,360,30874090,571837,41261,1997
WA,gas supply,35,112688,35,0,112688,0,0,1997
WA,transit,6346,20239387,5279,1961,17010479,3228908,172639,1997
WA,education - elementary and secondary instructional,57634,203582621,54225,5799,192996973,10585648,604155,1997
WA,education - elementary and secondary other,30747,64518879,9707,37107,24390439,40128440,3723968,1997
WA,libraries,3090,7658567,1790,2659,5325519,2333048,227577,1997
WA,other and unallocable,5984,17395211,5352,2088,15779224,1615987,108388,1997
WV,total,59926,133161565,55671,10425,126355380,6806185,751980,1997
WV,financial administration,1498,2574024,1443,169,2482219,91805,10576,1997
WV,other government administration,1042,1941920,969,914,1750124,191796,15887,1997
WV,judicial and legal,733,1512575,703,162,1431968,80607,6870,1997
WV,police protection - officers,2161,4709834,2132,82,4669447,40387,5232,1997
WV,police protection - other,404,538726,334,188,466395,72331,12620,1997
WV,fire protection - firefighters,853,2002216,841,87,1989573,12643,2336,1997
WV,fire protection - other,36,67283,34,6,64793,2490,231,1997
WV,corrections,438,701253,422,63,678487,22766,3086,1997
WV,streets and highways,925,1611367,876,99,1540474,70893,9119,1997
WV,air transportation,161,253138,150,23,240970,12168,2011,1997
WV,water transport and terminals,0,0,0,0,0,0,0,1997
WV,public welfare,0,0,0,0,0,0,0,1997
WV,health,1350,2766912,1226,371,2526416,240496,21111,1997
WV,hospitals,3470,7558085,2741,847,6131067,1427018,127449,1997
WV,solid waste management,670,1006788,611,129,930737,76051,11519,1997
WV,sewerage,900,1695567,859,156,1629144,66423,8143,1997
WV,parks and recreation,809,1114233,489,849,807483,306750,56357,1997
WV,housing and community development,575,1144933,515,130,1050726,94207,10402,1997
WV,natural resources,96,161446,88,18,152627,8819,1362,1997
WV,water transport and terminals,1222,2235914,1129,367,2099900,136014,17686,1997
WV,electric power,10,23338,10,0,23338,0,0,1997
WV,gas supply,0,0,0,0,0,0,0,1997
WV,transit,406,868564,389,58,844601,23963,2984,1997
WV,education - elementary and secondary instructional,27806,73776789,26485,2536,71513169,2263620,228175,1997
WV,education - elementary and secondary other,12852,22624889,11900,2631,21274812,1350077,166404,1997
WV,education - higher education instructional,0,0,0,0,0,0,0,1997
WV,education - higher education other,0,0,0,0,0,0,0,1997
WV,libraries,313,478255,251,145,411341,66914,10517,1997
WV,other and unallocable,1196,1793516,1074,395,1645569,147947,21903,1997
WI,total,201633,569193019,171903,82251,514039999,55153020,5282298,1997
WI,financial administration,2830,8116523,2533,1898,7232699,883824,75140,1997
WI,other government administration,4791,12305548,3601,8866,9572048,2733500,226039,1997
WI,judicial and legal,3301,8642078,3005,976,7948464,693614,53473,1997
WI,police protection - officers,10587,36622954,10272,1066,36083611,539343,57641,1997
WI,police protection - other,2996,6659140,2477,1802,5786100,873040,94804,1997
WI,fire protection - firefighters,4016,14589207,3612,4203,14036255,552952,72688,1997
WI,fire protection - other,311,915308,282,197,873305,42003,5718,1997
WI,corrections,2805,7683629,2639,316,7336846,346783,29545,1997
WI,streets and highways,9027,25318918,8690,1260,24761852,557066,68363,1997
WI,air transportation,355,1017521,338,45,984433,33088,3304,1997
WI,water transport and terminals,31,106956,31,4,106495,461,53,1997
WI,public welfare,12819,29458082,10516,3955,25413529,4044553,405451,1997
WI,health,5840,14549358,4560,2416,11707085,2842273,224632,1997
WI,hospitals,2988,6883794,2683,466,6316294,567500,53937,1997
WI,solid waste management,1716,4610109,1471,971,4250599,359510,52543,1997
WI,sewerage,2312,7259638,2215,719,7038860,220778,21949,1997
WI,parks and recreation,2760,6871826,1985,2585,5762417,1109409,137019,1997
WI,housing and community development,1147,2969536,1021,378,2760538,208998,21867,1997
WI,natural resources,978,2289218,869,287,2136314,152904,19296,1997
WI,water transport and terminals,1839,5540736,1801,159,5465219,75517,8246,1997
WI,electric power,354,1126693,348,21,1112898,13795,1400,1997
WI,gas supply,0,0,0,0,0,0,0,1997
WI,transit,2211,6973358,2091,209,6678757,294601,21501,1997
WI,education - elementary and secondary instructional,82720,257184107,73114,17701,238691212,18492895,1676356,1997
WI,education - elementary and secondary other,25207,51082513,18397,16660,40287404,10795109,1189630,1997
WI,education - higher education instructional,4433,16834112,3324,3906,13274713,3559399,188584,1997
WI,education - higher education other,4615,13256510,3590,2845,11429047,1827463,174180,1997
WI,libraries,2516,5263383,1547,2308,3889108,1374275,170466,1997
WI,other and unallocable,6128,15062264,4891,6032,13103897,1958367,228473,1997
WY,total,27423,62586264,22936,12538,55199634,7386630,784400,1997
WY,financial administration,603,1183712,583,60,1148877,34835,3967,1997
WY,other government administration,464,983467,431,383,867385,116082,7852,1997
WY,judicial and legal,320,792037,300,108,709108,82929,4367,1997
WY,police protection - officers,975,2572665,966,17,2558820,13845,1359,1997
WY,police protection - other,445,822730,401,120,747989,74741,8401,1997
WY,fire protection - firefighters,323,958754,305,277,929696,29058,3739,1997
WY,fire protection - other,20,32916,14,14,26229,6687,1035,1997
WY,corrections,294,563299,288,13,550861,12438,1090,1997
WY,streets and highways,700,1595793,679,46,1564900,30893,3750,1997
WY,air transportation,112,250090,97,24,230532,19558,2414,1997
WY,water transport and terminals,0,0,0,0,0,0,0,1997
WY,public welfare,40,71058,28,17,58871,12187,2122,1997
WY,health,221,429497,171,180,348032,81465,8757,1997
WY,hospitals,4103,10171502,3438,1437,8726975,1444527,116382,1997
WY,solid waste management,278,562752,262,70,529953,32799,3614,1997
WY,sewerage,159,380468,153,25,366530,13938,1424,1997
WY,parks and recreation,464,881724,316,639,675967,205757,26535,1997
WY,housing and community development,60,102708,44,30,84831,17877,2937,1997
WY,natural resources,224,391700,197,86,351501,40199,5260,1997
WY,water transport and terminals,281,634797,261,76,604147,30650,3548,1997
WY,electric power,41,124388,41,0,124388,0,0,1997
WY,gas supply,0,0,0,0,0,0,0,1997
WY,transit,51,70188,19,43,20366,49822,5517,1997
WY,education - elementary and secondary instructional,10142,25791787,8762,3581,23653491,2138296,236349,1997
WY,education - elementary and secondary other,4544,7727570,3179,3269,5805928,1921642,235322,1997
WY,education - higher education instructional,723,2010482,547,451,1563036,447446,31262,1997
WY,education - higher education other,1021,1966856,791,1139,1654723,312133,40669,1997
WY,libraries,227,375024,151,177,270256,104768,12863,1997
WY,other and unallocable,588,1138300,512,256,1026242,112058,13865,1997
