state,year,government_function,full_time_employees,full_time_pay,part_time_employees,part_time_pay,part_time_hours,full_time_equivalent_employees,total_march_full_time_and_part_time_employees,total_march_pay
US,2012,total,10616251,46673559903,3287363,3736502376,218884365,11891751,13903614,50410062279
US,2012,financial administration,210342,948299327,41060,41362723,2448835,223561,251402,989662050
US,2012,other government administration,188194,843692729,171037,89463091,4786438,214253,359231,933155820
US,2012,judicial and legal,223041,1071016269,32356,47020506,2222786,235471,255397,1118036775
US,2012,police protection total,774983,4276363009,93278,95216015,6368182,811222,868261,4371579024
US,2012,police protection - officers,611274,3599967383,34933,38200098,2428290,624993,646207,3638167481
US,2012,police protection - other,163709,676395626,58345,57015917,3939892,186229,222054,733411543
US,2012,fire protection total,321835,1955268048,106456,52512587,3780559,343017,428291,2007780635
US,2012,fire protection - firefighters,295050,1815417579,94989,43591844,3285389,313522,390039,1859009423
US,2012,fire protection - other,26785,139850469,11467,8920743,495170,29495,38252,148771212
US,2012,corrections,248295,1076540987,14081,18856579,1236495,255393,262376,1095397566
US,2012,highways,266753,1078693749,24812,27330638,1949041,277575,291565,1106024387
US,2012,air transportation,41114,206626551,3902,4775965,338863,43044,45016,211402516
US,2012,water transport and terminals,7815,46842415,998,1237826,77459,8252,8813,48080241
US,2012,public welfare,249872,1008129769,38475,54363008,3526176,270205,288347,1062492777
US,2012,health,219332,949355384,54534,84472657,4334854,244042,273866,1033828041
US,2012,hospitals,490946,2440512845,131434,343858856,13195123,566864,622380,2784371701
US,2012,social insurance administration,462,2519625,0,0,0,462,462,2519625
US,2012,solid waste management,96629,389813731,14565,14310604,1242705,103607,111194,404124335
US,2012,sewerage,119223,547114196,9759,8973252,540105,122077,128982,556087448
US,2012,parks and recreation,148525,584103095,201605,156581577,12979875,222438,350130,740684672
US,2012,housing and community development,101474,450208308,12204,15543695,964065,107013,113678,465752003
US,2012,natural resources,33860,143509104,7881,7093772,459304,36438,41741,150602876
US,2012,water transport and terminals,163044,760403616,15335,14483324,880016,167761,178379,774886940
US,2012,electric power,73298,481295387,2462,5007439,234266,74623,75760,486302826
US,2012,gas supply,11111,49748914,361,570776,26951,11263,11472,50319690
US,2012,transit,182244,976806650,17257,32429507,1959508,193392,199501,1009236157
US,2012,education total,6133248,25072763788,2121737,2456766977,143470318,6981404,8254985,27529530765
US,2012,education - elementary and secondary total,5894884,23834963125,1757182,2038910886,126059940,6642462,7652066,25873874011
US,2012,education - elementary and secondary instructional,4239686,19229873420,968609,1188324754,66539046,4632812,5208295,20418198174
US,2012,education - elementary and secondary other,1655198,4605089705,788573,850586132,59520894,2009650,2443771,5455675837
US,2012,education - higher education total,238364,1237800663,364555,417856091,17410378,338942,602919,1655656754
US,2012,education - higher education instructional,88339,585948270,211325,297142920,8309815,136378,299664,883091190
US,2012,education - higher education other,150025,651852393,153230,120713171,9100563,202564,303255,772565564
US,2012,education - other,0,0,0,0,0,0,0,0
US,2012,libraries,85871,322957904,94193,95554771,7144519,127098,180064,418512675
US,2012,liquor stores,0,0,0,0,0,0,0,0
US,2012,other and unallocable,224740,990974503,77581,68716231,4717922,251276,302321,1059690734
AL,2012,total,179300,601164925,28787,33581843,2297060,192683,208087,634746768
AL,2012,financial administration,3809,13029444,212,204496,16607,3901,4021,13233940
AL,2012,other government administration,2476,8386294,2049,1277116,64778,2836,4525,9663410
AL,2012,judicial and legal,1470,5067935,453,486758,27446,1620,1923,5554693
AL,2012,police protection total,12323,45852974,1211,1135427,98510,12889,13534,46988401
AL,2012,police protection - officers,9980,39349463,507,515205,43546,10236,10487,39864668
AL,2012,police protection - other,2343,6503511,704,620222,54964,2653,3047,7123733
AL,2012,fire protection total,5791,23864548,877,588482,50925,6082,6668,24453030
AL,2012,fire protection - firefighters,5498,22857738,819,564626,49162,5777,6317,23422364
AL,2012,fire protection - other,293,1006810,58,23856,1763,305,351,1030666
AL,2012,corrections,3260,9555246,242,286206,26626,3413,3502,9841452
AL,2012,highways,6111,18096751,290,367214,33859,6302,6401,18463965
AL,2012,air transportation,457,1618792,38,39389,3928,480,495,1658181
AL,2012,water transport and terminals,5,15296,2,2214,281,7,7,17510
AL,2012,public welfare,912,2054858,459,457345,44508,1167,1371,2512203
AL,2012,health,5584,15206835,1300,1321542,102641,6165,6884,16528377
AL,2012,hospitals,20903,81270605,6745,15574430,700349,25088,27648,96845035
AL,2012,social insurance administration,0,0,0,0,0,0,0,0
AL,2012,solid waste management,3276,8702411,162,194674,17970,3381,3438,8897085
AL,2012,sewerage,1405,5357806,53,55750,3945,1428,1458,5413556
AL,2012,parks and recreation,2856,8399192,2146,1567314,169938,3815,5002,9966506
AL,2012,housing and community development,1896,6815468,237,242037,17918,2002,2133,7057505
AL,2012,natural resources,439,1126301,67,80343,5834,475,506,1206644
AL,2012,water transport and terminals,3764,14497499,265,262871,18573,3868,4029,14760370
AL,2012,electric power,1102,5410530,29,62043,3273,1121,1131,5472573
AL,2012,gas supply,862,3481495,33,25952,2639,877,895,3507447
AL,2012,transit,504,1455635,129,154372,14456,587,633,1610007
AL,2012,education total,94610,303507834,10315,7627176,707313,98756,104925,311135010
AL,2012,education - elementary and secondary total,94610,303507834,10315,7627176,707313,98756,104925,311135010
AL,2012,education - elementary and secondary instructional,64050,244371346,6802,5293872,464637,66746,70852,249665218
AL,2012,education - elementary and secondary other,30560,59136488,3513,2333304,242676,32010,34073,61469792
AL,2012,education - higher education total,0,0,0,0,0,0,0,0
AL,2012,education - higher education instructional,0,0,0,0,0,0,0,0
AL,2012,education - higher education other,0,0,0,0,0,0,0,0
AL,2012,education - other,0,0,0,0,0,0,0,0
AL,2012,libraries,913,2758103,668,730389,67618,1301,1581,3488492
AL,2012,liquor stores,0,0,0,0,0,0,0,0
AL,2012,other and unallocable,4572,15633073,805,838303,97125,5122,5377,16471376
AK,2012,total,25262,128386213,8407,9120998,480987,28028,33669,137507211
AK,2012,financial administration,919,5056753,87,128659,6713,958,1006,5185412
AK,2012,other government administration,898,4833963,823,608666,25415,1043,1721,5442629
AK,2012,judicial and legal,105,674297,3,5989,291,107,108,680286
AK,2012,police protection total,1267,8159696,85,77083,4876,1295,1352,8236779
AK,2012,police protection - officers,891,6415482,50,46418,3128,909,941,6461900
AK,2012,police protection - other,376,1744214,35,30665,1748,386,411,1774879
AK,2012,fire protection total,753,5708140,548,192350,14067,833,1301,5900490
AK,2012,fire protection - firefighters,649,5054123,534,178891,13226,724,1183,5233014
AK,2012,fire protection - other,104,654017,14,13459,841,109,118,667476
AK,2012,corrections,78,361955,0,0,0,78,78,361955
AK,2012,highways,683,4077634,123,113178,6246,719,806,4190812
AK,2012,air transportation,70,381210,9,15832,808,74,79,397042
AK,2012,water transport and terminals,153,735137,16,23898,1419,161,169,759035
AK,2012,public welfare,125,637928,29,62276,2987,143,154,700204
AK,2012,health,229,1179052,249,204378,11661,295,478,1383430
AK,2012,hospitals,617,3593030,290,838841,27201,774,907,4431871
AK,2012,social insurance administration,0,0,0,0,0,0,0,0
AK,2012,solid waste management,298,1453877,72,84786,4876,322,370,1538663
AK,2012,sewerage,294,1690410,55,49206,3409,314,349,1739616
AK,2012,parks and recreation,379,1616193,559,529431,35582,585,938,2145624
AK,2012,housing and community development,642,3245947,183,377183,16898,742,825,3623130
AK,2012,natural resources,28,180136,3,6703,228,29,31,186839
AK,2012,water transport and terminals,293,1644920,73,85004,4745,323,366,1729924
AK,2012,electric power,460,3397942,64,73668,3280,479,524,3471610
AK,2012,gas supply,6,30119,1,994,64,6,7,31113
AK,2012,transit,217,1157329,57,176722,6813,255,274,1334051
AK,2012,education total,15875,74203943,4485,4755515,263487,17386,20360,78959458
AK,2012,education - elementary and secondary total,15784,73751327,4446,4711466,261706,17284,20230,78462793
AK,2012,education - elementary and secondary instructional,10112,55852420,2423,3242826,165763,11063,12535,59095246
AK,2012,education - elementary and secondary other,5672,17898907,2023,1468640,95943,6221,7695,19367547
AK,2012,education - higher education total,91,452616,39,44049,1781,102,130,496665
AK,2012,education - higher education instructional,11,64872,10,15480,266,13,21,80352
AK,2012,education - higher education other,80,387744,29,28569,1515,89,109,416313
AK,2012,education - other,0,0,0,0,0,0,0,0
AK,2012,libraries,192,829719,207,254244,14556,274,399,1083963
AK,2012,liquor stores,0,0,0,0,0,0,0,0
AK,2012,other and unallocable,681,3536883,386,456392,25365,833,1067,3993275
AZ,2012,total,186621,770989089,57612,63954523,4009715,209533,244233,834943612
AZ,2012,financial administration,4722,22715991,170,298384,16299,4814,4892,23014375
AZ,2012,other government administration,3731,18455203,357,424032,22605,3859,4088,18879235
AZ,2012,judicial and legal,8107,35915639,481,963675,37740,8320,8588,36879314
AZ,2012,police protection total,17577,92766206,272,431770,23493,17709,17849,93197976
AZ,2012,police protection - officers,12900,72779917,51,93892,4110,12922,12951,72873809
AZ,2012,police protection - other,4677,19986289,221,337878,19383,4787,4898,20324167
AZ,2012,fire protection total,8213,47722470,1419,1133437,84281,8692,9632,48855907
AZ,2012,fire protection - firefighters,7105,42314810,1191,908551,70266,7503,8296,43223361
AZ,2012,fire protection - other,1108,5407660,228,224886,14015,1189,1336,5632546
AZ,2012,corrections,5277,19375826,192,286007,16128,5370,5469,19661833
AZ,2012,highways,4055,17148982,92,165841,9493,4109,4147,17314823
AZ,2012,air transportation,1150,5366014,43,37062,2878,1168,1193,5403076
AZ,2012,water transport and terminals,0,0,0,0,0,0,0,0
AZ,2012,public welfare,1043,3938444,300,386064,24685,1184,1343,4324508
AZ,2012,health,3615,13824415,485,802090,51265,3904,4100,14626505
AZ,2012,hospitals,2395,14312366,370,855948,37841,2609,2765,15168314
AZ,2012,social insurance administration,0,0,0,0,0,0,0,0
AZ,2012,solid waste management,2213,8597479,69,90571,8285,2260,2282,8688050
AZ,2012,sewerage,1574,6657900,72,106393,5733,1606,1646,6764293
AZ,2012,parks and recreation,3024,11489619,3400,2857075,231160,4330,6424,14346694
AZ,2012,housing and community development,1419,6386330,228,189517,16041,1509,1647,6575847
AZ,2012,natural resources,655,2632747,49,59520,3053,669,704,2692267
AZ,2012,water transport and terminals,3449,17702599,87,102714,5605,3482,3536,17805313
AZ,2012,electric power,4912,38051956,187,599931,27314,5066,5099,38651887
AZ,2012,gas supply,114,599663,0,0,0,114,114,599663
AZ,2012,transit,689,3125153,95,151396,10718,751,784,3276549
AZ,2012,education total,104065,365057478,47689,52251075,3258481,122731,151754,417308553
AZ,2012,education - elementary and secondary total,95472,318149074,35221,40325230,2603132,110415,130693,358474304
AZ,2012,education - elementary and secondary instructional,63518,234674153,19148,24759021,1333401,71195,82666,259433174
AZ,2012,education - elementary and secondary other,31954,83474921,16073,15566209,1269731,39220,48027,99041130
AZ,2012,education - higher education total,8593,46908404,12468,11925845,655349,12316,21061,58834249
AZ,2012,education - higher education instructional,2059,16095573,5527,6641041,258108,3532,7586,22736614
AZ,2012,education - higher education other,6534,30812831,6941,5284804,397241,8784,13475,36097635
AZ,2012,education - other,0,0,0,0,0,0,0,0
AZ,2012,libraries,1312,4996319,1153,1295166,88442,1808,2465,6291485
AZ,2012,liquor stores,0,0,0,0,0,0,0,0
AZ,2012,other and unallocable,3310,14150290,402,466855,28175,3469,3712,14617145
AR,2012,total,100966,315257954,21643,13755420,1192251,107801,122609,329013374
AR,2012,financial administration,2219,6444882,423,299209,25221,2352,2642,6744091
AR,2012,other government administration,1812,5043040,2715,1026822,68757,2187,4527,6069862
AR,2012,judicial and legal,1508,4140627,467,363619,25614,1648,1975,4504246
AR,2012,police protection total,6930,23013433,689,464033,44891,7172,7619,23477466
AR,2012,police protection - officers,5619,19601e3,452,285917,26996,5764,6071,19886917
AR,2012,police protection - other,1311,3412433,237,178116,17895,1408,1548,3590549
AR,2012,fire protection total,2654,10749521,1579,369049,39508,2872,4233,11118570
AR,2012,fire protection - firefighters,2579,10498601,1509,363138,38920,2793,4088,10861739
AR,2012,fire protection - other,75,250920,70,5911,588,79,145,256831
AR,2012,corrections,2364,5761780,223,153266,15718,2454,2587,5915046
AR,2012,highways,3469,9142953,229,257692,24548,3601,3698,9400645
AR,2012,air transportation,299,1018455,43,37090,3508,321,342,1055545
AR,2012,water transport and terminals,10,67925,1,426,28,10,11,68351
AR,2012,public welfare,67,160546,50,32513,3651,86,117,193059
AR,2012,health,589,1992154,135,165885,10701,646,724,2158039
AR,2012,hospitals,1282,4156285,267,359541,20040,1396,1549,4515826
AR,2012,social insurance administration,0,0,0,0,0,0,0,0
AR,2012,solid waste management,1463,3507591,137,94188,10175,1520,1600,3601779
AR,2012,sewerage,1245,4049262,83,65930,6227,1274,1328,4115192
AR,2012,parks and recreation,988,2790355,695,486439,54871,1293,1683,3276794
AR,2012,housing and community development,995,2973809,212,198530,18581,1098,1207,3172339
AR,2012,natural resources,157,370088,102,78662,5727,186,259,448750
AR,2012,water transport and terminals,2328,7724759,223,239337,17393,2423,2551,7964096
AR,2012,electric power,433,1948412,7,10856,777,438,440,1959268
AR,2012,gas supply,7,20606,0,0,0,7,7,20606
AR,2012,transit,306,991807,40,43055,4432,332,346,1034862
AR,2012,education total,67799,213411094,12240,8190288,691805,71880,80039,221601382
AR,2012,education - elementary and secondary total,67496,212262857,11974,7789555,676355,71489,79470,220052412
AR,2012,education - elementary and secondary instructional,44979,167269514,6701,3821949,324719,46895,51680,171091463
AR,2012,education - elementary and secondary other,22517,44993343,5273,3967606,351636,24594,27790,48960949
AR,2012,education - higher education total,303,1148237,266,400733,15450,391,569,1548970
AR,2012,education - higher education instructional,108,548406,145,244464,7352,150,253,792870
AR,2012,education - higher education other,195,599831,121,156269,8098,241,316,756100
AR,2012,education - other,0,0,0,0,0,0,0,0
AR,2012,libraries,673,1818177,594,452749,44628,928,1267,2270926
AR,2012,liquor stores,0,0,0,0,0,0,0,0
AR,2012,other and unallocable,1369,3960393,489,366241,55450,1677,1858,4326634
CA,2012,total,1136820,6801273334,492785,739573694,33341807,1335573,1629605,7540847028
CA,2012,financial administration,25184,152439417,1387,3110177,126720,25906,26571,155549594
CA,2012,other government administration,23830,150070417,4258,7577466,297452,25539,28088,157647883
CA,2012,judicial and legal,35317,263047272,1762,6212340,166425,36262,37079,269259612
CA,2012,police protection total,85546,654958580,6060,10008732,487576,88316,91606,664967312
CA,2012,police protection - officers,61989,519853716,1416,2880946,101447,62559,63405,522734662
CA,2012,police protection - other,23557,135104864,4644,7127786,386129,25757,28201,142232650
CA,2012,fire protection total,31962,313570235,3839,3802741,210167,33129,35801,317372976
CA,2012,fire protection - firefighters,28127,291783857,2927,2710001,162368,29036,31054,294493858
CA,2012,fire protection - other,3835,21786378,912,1092740,47799,4093,4747,22879118
CA,2012,corrections,28984,172044914,1215,2561277,104927,29581,30199,174606191
CA,2012,highways,20933,127614915,2016,3859370,188007,22008,22949,131474285
CA,2012,air transportation,6835,43424726,452,842341,44151,7087,7287,44267067
CA,2012,water transport and terminals,2214,15980310,195,322421,16470,2307,2409,16302731
CA,2012,public welfare,66085,308348494,3058,5275911,279134,67676,69143,313624405
CA,2012,health,40970,241451315,4589,13203852,405110,43266,45559,254655167
CA,2012,hospitals,56957,361330022,16424,72683075,1758867,67051,73381,434013097
CA,2012,social insurance administration,0,0,0,0,0,0,0,0
CA,2012,solid waste management,8447,46549643,686,1348859,79074,8895,9133,47898502
CA,2012,sewerage,11600,76054166,572,970785,37842,11808,12172,77024951
CA,2012,parks and recreation,17646,91002292,30349,30806616,2156695,29911,47995,121808908
CA,2012,housing and community development,11670,70385076,1047,1855991,92206,12193,12717,72241067
CA,2012,natural resources,7699,40933750,1009,1354434,70131,8086,8708,42288184
CA,2012,water transport and terminals,23664,170194804,1477,2409829,101818,24241,25141,172604633
CA,2012,electric power,11828,105336704,352,1039789,41391,12062,12180,106376493
CA,2012,gas supply,230,1387035,7,13148,813,235,237,1400183
CA,2012,transit,30990,170573978,2599,6109668,325133,32824,33589,176683646
CA,2012,education total,549911,3006628040,394274,543877300,25194314,702300,944185,3550505340
CA,2012,education - elementary and secondary total,502463,2695282688,311873,432827608,21848241,635820,814336,3128110296
CA,2012,education - elementary and secondary instructional,345068,2121859059,156160,246766300,10366722,407142,501228,2368625359
CA,2012,education - elementary and secondary other,157395,573423629,155713,186061308,11481519,228678,313108,759484937
CA,2012,education - higher education total,47448,311345352,82401,111049692,3346073,66480,129849,422395044
CA,2012,education - higher education instructional,19601,168871040,45482,84762266,1506110,28165,65083,253633306
CA,2012,education - higher education other,27847,142474312,36919,26287426,1839963,38315,64766,168761738
CA,2012,education - other,0,0,0,0,0,0,0,0
CA,2012,libraries,7413,37562491,8598,11078504,669111,11215,16011,48640995
CA,2012,liquor stores,0,0,0,0,0,0,0,0
CA,2012,other and unallocable,30905,180384738,6560,9249068,488273,33675,37465,189633806
CO,2012,total,173314,738253882,62207,77615176,4414948,198533,235521,815869058
CO,2012,financial administration,4331,21616994,310,563796,27695,4489,4641,22180790
CO,2012,other government administration,4060,18972884,1413,1173010,60282,4394,5473,20145894
CO,2012,judicial and legal,2395,13188133,344,617532,22261,2512,2739,13805665
CO,2012,police protection total,13353,74954032,646,883397,47357,13615,13999,75837429
CO,2012,police protection - officers,9669,58979281,132,182651,8785,9714,9801,59161932
CO,2012,police protection - other,3684,15974751,514,700746,38572,3901,4198,16675497
CO,2012,fire protection total,6193,38697108,1265,857908,60397,6529,7458,39555016
CO,2012,fire protection - firefighters,5566,35237394,1020,630812,46859,5828,6586,35868206
CO,2012,fire protection - other,627,3459714,245,227096,13538,701,872,3686810
CO,2012,corrections,3591,16759592,143,210343,12154,3660,3734,16969935
CO,2012,highways,4888,20328043,194,349757,20500,5001,5082,20677800
CO,2012,air transportation,1363,6605178,97,129521,8306,1409,1460,6734699
CO,2012,water transport and terminals,0,0,0,0,0,0,0,0
CO,2012,public welfare,6076,22767579,664,1124410,65443,6448,6740,23891989
CO,2012,health,3594,16519316,1638,4216691,153863,4471,5232,20736007
CO,2012,hospitals,8007,39447156,2944,9712123,307413,9757,10951,49159279
CO,2012,social insurance administration,0,0,0,0,0,0,0,0
CO,2012,solid waste management,608,2306182,103,144327,9543,663,711,2450509
CO,2012,sewerage,2339,11392353,316,250872,12193,2393,2655,11643225
CO,2012,parks and recreation,4495,18534831,8705,6124152,511233,7390,13200,24658983
CO,2012,housing and community development,1994,9169319,355,558961,29712,2161,2349,9728280
CO,2012,natural resources,658,3027339,294,309562,19466,766,952,3336901
CO,2012,water transport and terminals,4298,22322312,567,538485,25080,4431,4865,22860797
CO,2012,electric power,1486,10884061,42,127532,5752,1519,1528,11011593
CO,2012,gas supply,269,1627759,0,0,0,269,269,1627759
CO,2012,transit,3070,15303084,546,992642,60691,3412,3616,16295726
CO,2012,education total,89627,327766912,38220,44944634,2702412,105195,127847,372711546
CO,2012,education - elementary and secondary total,88933,325032029,36891,43703242,2641334,104156,125824,368735271
CO,2012,education - elementary and secondary instructional,62352,249700074,21102,28281451,1592599,71530,83454,277981525
CO,2012,education - elementary and secondary other,26581,75331955,15789,15421791,1048735,32626,42370,90753746
CO,2012,education - higher education total,694,2734883,1329,1241392,61078,1039,2023,3976275
CO,2012,education - higher education instructional,205,987765,972,966829,40965,437,1177,1954594
CO,2012,education - higher education other,489,1747118,357,274563,20113,602,846,2021681
CO,2012,education - other,0,0,0,0,0,0,0,0
CO,2012,libraries,1794,6651860,2232,2607396,181484,2829,4026,9259256
CO,2012,liquor stores,0,0,0,0,0,0,0,0
CO,2012,other and unallocable,4825,19411855,1169,1178125,71711,5220,5994,20589980
CT,2012,total,108929,584159791,37873,47375345,2548669,124161,146802,631535136
CT,2012,financial administration,2025,10326629,523,745058,32355,2224,2548,11071687
CT,2012,other government administration,1760,8863109,858,938298,44255,2031,2618,9801407
CT,2012,judicial and legal,154,1032579,27,62166,2031,167,181,1094745
CT,2012,police protection total,7607,51349600,1214,1069670,67448,7998,8821,52419270
CT,2012,police protection - officers,6463,46239249,253,229805,12110,6532,6716,46469054
CT,2012,police protection - other,1144,5110351,961,839865,55338,1466,2105,5950216
CT,2012,fire protection total,4340,27259293,987,664968,35596,4540,5327,27924261
CT,2012,fire protection - firefighters,4048,25851427,780,459314,25165,4193,4828,26310741
CT,2012,fire protection - other,292,1407866,207,205654,10431,347,499,1613520
CT,2012,corrections,0,0,0,0,0,0,0,0
CT,2012,highways,3160,15114129,307,320577,19446,3276,3467,15434706
CT,2012,air transportation,19,81872,0,0,0,19,19,81872
CT,2012,water transport and terminals,3,14546,2,5007,205,5,5,19553
CT,2012,public welfare,1049,4624617,1189,1491069,89224,1584,2238,6115686
CT,2012,health,1100,5482082,513,803498,35922,1303,1613,6285580
CT,2012,hospitals,0,0,0,0,0,0,0,0
CT,2012,social insurance administration,0,0,0,0,0,0,0,0
CT,2012,solid waste management,1053,5502169,186,203044,14905,1142,1239,5705213
CT,2012,sewerage,993,5790092,40,73482,3642,1015,1033,5863574
CT,2012,parks and recreation,1266,5879935,2725,1718943,122080,1990,3991,7598878
CT,2012,housing and community development,1368,6509158,426,517090,30463,1546,1794,7026248
CT,2012,natural resources,45,265556,13,12456,680,49,58,278012
CT,2012,water transport and terminals,906,5092659,23,38013,1579,916,929,5130672
CT,2012,electric power,321,2191523,5,13141,685,325,326,2204664
CT,2012,gas supply,37,248507,0,0,0,37,37,248507
CT,2012,transit,584,2607625,195,269831,17020,681,779,2877456
CT,2012,education total,78510,413282218,25891,35782007,1868793,89720,104401,449064225
CT,2012,education - elementary and secondary total,78447,413064449,25858,35762561,1867280,89649,104305,448827010
CT,2012,education - elementary and secondary instructional,60791,348587798,14483,22135653,1045531,67082,75274,370723451
CT,2012,education - elementary and secondary other,17656,64476651,11375,13626908,821749,22567,29031,78103559
CT,2012,education - higher education total,63,217769,33,19446,1513,71,96,237215
CT,2012,education - higher education instructional,29,108740,6,6219,207,30,35,114959
CT,2012,education - higher education other,34,109029,27,13227,1306,41,61,122256
CT,2012,education - other,0,0,0,0,0,0,0,0
CT,2012,libraries,1093,4898972,1593,1452103,97722,1678,2686,6351075
CT,2012,liquor stores,0,0,0,0,0,0,0,0
CT,2012,other and unallocable,1536,7742921,1156,1194924,64618,1915,2692,8937845
DE,2012,total,20014,93233307,5052,6117708,445520,22675,25066,99351015
DE,2012,financial administration,460,2056475,22,14231,853,464,482,2070706
DE,2012,other government administration,597,2824955,152,74307,3934,618,749,2899262
DE,2012,judicial and legal,104,512539,17,31475,1361,112,121,544014
DE,2012,police protection total,1349,7558053,177,232882,19033,1457,1526,7790935
DE,2012,police protection - officers,1132,6821814,15,16419,1180,1139,1147,6838233
DE,2012,police protection - other,217,736239,162,216463,17853,318,379,952702
DE,2012,fire protection total,186,895770,1,817,66,186,187,896587
DE,2012,fire protection - firefighters,175,846484,0,0,0,175,175,846484
DE,2012,fire protection - other,11,49286,1,817,66,11,12,50103
DE,2012,corrections,0,0,0,0,0,0,0,0
DE,2012,highways,446,1624120,71,51760,4716,472,517,1675880
DE,2012,air transportation,33,114978,8,8395,701,37,41,123373
DE,2012,water transport and terminals,136,529252,135,74420,7135,176,271,603672
DE,2012,public welfare,1,3713,3,3007,279,3,4,6720
DE,2012,health,279,1571184,1,928,111,280,280,1572112
DE,2012,hospitals,0,0,0,0,0,0,0,0
DE,2012,social insurance administration,0,0,0,0,0,0,0,0
DE,2012,solid waste management,102,422974,5,8739,731,106,107,431713
DE,2012,sewerage,435,1912019,3,5266,408,438,438,1917285
DE,2012,parks and recreation,188,736837,138,110098,8693,239,326,846935
DE,2012,housing and community development,240,1023125,9,18317,891,244,249,1041442
DE,2012,natural resources,1,5992,0,0,0,1,1,5992
DE,2012,water transport and terminals,170,616105,4,2555,231,172,174,618660
DE,2012,electric power,128,699007,0,0,0,128,128,699007
DE,2012,gas supply,0,0,0,0,0,0,0,0
DE,2012,transit,0,0,0,0,0,0,0,0
DE,2012,education total,14521,67770722,3914,5147268,365737,16726,18435,72917990
DE,2012,education - elementary and secondary total,14521,67770722,3914,5147268,365737,16726,18435,72917990
DE,2012,education - elementary and secondary instructional,11076,53246825,1334,1911150,106029,11717,12410,55157975
DE,2012,education - elementary and secondary other,3445,14523897,2580,3236118,259708,5009,6025,17760015
DE,2012,education - higher education total,0,0,0,0,0,0,0,0
DE,2012,education - higher education instructional,0,0,0,0,0,0,0,0
DE,2012,education - higher education other,0,0,0,0,0,0,0,0
DE,2012,education - other,0,0,0,0,0,0,0,0
DE,2012,libraries,163,609119,325,246137,23737,302,488,855256
DE,2012,liquor stores,0,0,0,0,0,0,0,0
DE,2012,other and unallocable,475,1746368,67,87106,6903,514,542,1833474
DC,2012,total,41843,264677663,3363,7977009,448546,44377,45206,272654672
DC,2012,financial administration,1785,12755143,0,0,0,1785,1785,12755143
DC,2012,other government administration,1220,7405225,29,61347,2965,1237,1249,7466572
DC,2012,judicial and legal,2108,17675527,31,139099,3417,2127,2139,17814626
DC,2012,police protection total,4386,30650796,0,0,0,4386,4386,30650796
DC,2012,police protection - officers,3797,27256112,0,0,0,3797,3797,27256112
DC,2012,police protection - other,589,3394684,0,0,0,589,589,3394684
DC,2012,fire protection total,1853,11326304,0,0,0,1853,1853,11326304
DC,2012,fire protection - firefighters,1759,10674990,0,0,0,1759,1759,10674990
DC,2012,fire protection - other,94,651314,0,0,0,94,94,651314
DC,2012,corrections,1269,6922083,2,8616,332,1271,1271,6930699
DC,2012,highways,718,4087421,175,229584,17482,817,893,4317005
DC,2012,air transportation,0,0,0,0,0,0,0,0
DC,2012,water transport and terminals,0,0,0,0,0,0,0,0
DC,2012,public welfare,1965,11637637,11,23841,1256,1972,1976,11661478
DC,2012,health,711,4331174,10,28378,1116,717,721,4359552
DC,2012,hospitals,1391,8564153,22,117297,2617,1406,1413,8681450
DC,2012,social insurance administration,462,2519625,0,0,0,462,462,2519625
DC,2012,solid waste management,1276,5764926,0,0,0,1276,1276,5764926
DC,2012,sewerage,679,4334387,0,0,0,679,679,4334387
DC,2012,parks and recreation,599,2781661,106,169415,11273,663,705,2951076
DC,2012,housing and community development,941,5485029,6,14805,806,946,947,5499834
DC,2012,natural resources,43,272977,0,0,0,43,43,272977
DC,2012,water transport and terminals,398,2536803,0,0,0,398,398,2536803
DC,2012,electric power,0,0,0,0,0,0,0,0
DC,2012,gas supply,0,0,0,0,0,0,0,0
DC,2012,transit,10355,68590788,138,368723,11747,10421,10493,68959511
DC,2012,education total,7585,45321518,1453,2738813,157612,8475,9038,48060331
DC,2012,education - elementary and secondary total,6855,41127106,1048,2399617,141300,7653,7903,43526723
DC,2012,education - elementary and secondary instructional,5873,36813175,916,2184415,130957,6613,6789,38997590
DC,2012,education - elementary and secondary other,982,4313931,132,215202,10343,1040,1114,4529133
DC,2012,education - higher education total,730,4194412,405,339196,16312,822,1135,4533608
DC,2012,education - higher education instructional,252,1645482,357,201682,10162,309,609,1847164
DC,2012,education - higher education other,478,2548930,48,137514,6150,513,526,2686444
DC,2012,education - other,0,0,0,0,0,0,0,0
DC,2012,libraries,382,1921872,28,71165,3401,401,410,1993037
DC,2012,liquor stores,0,0,0,0,0,0,0,0
DC,2012,other and unallocable,1717,9792614,1352,4005926,234522,3042,3069,13798540
FL,2012,total,639572,2533654307,131503,142776415,9846741,695604,771075,2676430722
FL,2012,financial administration,16401,75217727,594,875289,56115,16723,16995,76093016
FL,2012,other government administration,10609,49183544,1401,1511215,80628,11073,12010,50694759
FL,2012,judicial and legal,11718,47993603,577,1051785,65122,12086,12295,49045388
FL,2012,police protection total,56369,290387070,5495,5118860,393932,58596,61864,295505930
FL,2012,police protection - officers,38117,219034143,543,729323,48967,38389,38660,219763466
FL,2012,police protection - other,18252,71352927,4952,4389537,344965,20207,23204,75742464
FL,2012,fire protection total,28094,165384025,1187,1187345,77821,28535,29281,166571370
FL,2012,fire protection - firefighters,25411,151805633,863,705834,50143,25693,26274,152511467
FL,2012,fire protection - other,2683,13578392,324,481511,27678,2842,3007,14059903
FL,2012,corrections,16060,73436724,133,176014,11234,16125,16193,73612738
FL,2012,highways,12842,47822547,272,381960,28607,13008,13114,48204507
FL,2012,air transportation,4230,20370411,215,341258,25811,4382,4445,20711669
FL,2012,water transport and terminals,1223,6209053,204,310228,23047,1352,1427,6519281
FL,2012,public welfare,4368,16428407,840,781510,75773,4795,5208,17209917
FL,2012,health,5339,21959351,527,619656,48556,5613,5866,22579007
FL,2012,hospitals,43379,228399327,9578,30510248,1177015,50239,52957,258909575
FL,2012,social insurance administration,0,0,0,0,0,0,0,0
FL,2012,solid waste management,7092,26289720,208,227036,20432,7208,7300,26516756
FL,2012,sewerage,9150,39497648,221,300511,21701,9271,9371,39798159
FL,2012,parks and recreation,12504,43292885,9444,9347137,794344,17008,21948,52640022
FL,2012,housing and community development,4865,19633887,427,524161,38967,5087,5292,20158048
FL,2012,natural resources,5178,25030510,182,242961,13941,5257,5360,25273471
FL,2012,water transport and terminals,12158,52693932,218,310054,20041,12272,12376,53003986
FL,2012,electric power,4934,28832388,139,304654,16842,5028,5073,29137042
FL,2012,gas supply,557,2132457,7,11344,684,560,564,2143801
FL,2012,transit,7661,33154455,544,996278,66797,8039,8205,34150733
FL,2012,education total,343292,1133071119,94662,83361896,6455413,379911,437954,1216433015
FL,2012,education - elementary and secondary total,323977,1046698097,66615,51488068,4890263,351607,390592,1098186165
FL,2012,education - elementary and secondary instructional,231167,830447208,45306,40457501,3650317,251790,276473,870904709
FL,2012,education - elementary and secondary other,92810,216250889,21309,11030567,1239946,99817,114119,227281456
FL,2012,education - higher education total,19315,86373022,28047,31873828,1565150,28304,47362,118246850
FL,2012,education - higher education instructional,6073,34765008,14410,20643216,638658,9742,20483,55408224
FL,2012,education - higher education other,13242,51608014,13637,11230612,926492,18562,26879,62838626
FL,2012,education - other,0,0,0,0,0,0,0,0
FL,2012,libraries,4923,16710937,1890,2019146,169636,5885,6813,18730083
FL,2012,liquor stores,0,0,0,0,0,0,0,0
FL,2012,other and unallocable,16626,70522580,2538,2265869,164282,17551,19164,72788449
GA,2012,total,366635,1271537479,62866,59974252,4169269,390392,429501,1331511731
GA,2012,financial administration,7555,27482474,716,641907,42287,7796,8271,28124381
GA,2012,other government administration,4681,18029020,2969,1772870,100218,5236,7650,19801890
GA,2012,judicial and legal,9384,36571745,2174,2327651,132704,10125,11558,38899396
GA,2012,police protection total,24675,90350334,1556,1579758,120385,25350,26231,91930092
GA,2012,police protection - officers,20230,76939556,801,842923,58732,20557,21031,77782479
GA,2012,police protection - other,4445,13410778,755,736835,61653,4793,5200,14147613
GA,2012,fire protection total,11953,46062788,1798,1294445,106364,12557,13751,47357233
GA,2012,fire protection - firefighters,11333,43660930,1679,1218767,101564,11910,13012,44879697
GA,2012,fire protection - other,620,2401858,119,75678,4800,647,739,2477536
GA,2012,corrections,10063,32010336,406,528905,39905,10289,10469,32539241
GA,2012,highways,7539,21903335,355,455689,33400,7732,7894,22359024
GA,2012,air transportation,923,3914721,96,107604,8687,973,1019,4022325
GA,2012,water transport and terminals,0,0,0,0,0,0,0,0
GA,2012,public welfare,1093,2909754,828,1266406,104373,1683,1921,4176160
GA,2012,health,7679,22130116,2242,2835108,203622,8830,9921,24965224
GA,2012,hospitals,16705,66633388,3923,6827431,336425,18655,20628,73460819
GA,2012,social insurance administration,0,0,0,0,0,0,0,0
GA,2012,solid waste management,3921,10754905,701,559089,67387,4304,4622,11313994
GA,2012,sewerage,4169,14908726,51,55049,4284,4192,4220,14963775
GA,2012,parks and recreation,3913,11972724,3754,2954499,292692,5567,7667,14927223
GA,2012,housing and community development,2688,9634002,225,248318,19341,2800,2913,9882320
GA,2012,natural resources,196,461698,204,168881,14977,281,400,630579
GA,2012,water transport and terminals,6355,22195395,261,283260,19689,6463,6616,22478655
GA,2012,electric power,993,3949753,16,22444,1151,998,1009,3972197
GA,2012,gas supply,567,1823334,5,5511,421,569,572,1828845
GA,2012,transit,4876,19641055,417,490556,42891,5119,5293,20131611
GA,2012,education total,228587,781868772,36232,32637194,2223003,241300,264819,814505966
GA,2012,education - elementary and secondary total,228587,781868772,36232,32637194,2223003,241300,264819,814505966
GA,2012,education - elementary and secondary instructional,155379,626182176,22798,19537453,1167721,162027,178177,645719629
GA,2012,education - elementary and secondary other,73208,155686596,13434,13099741,1055282,79273,86642,168786337
GA,2012,education - higher education total,0,0,0,0,0,0,0,0
GA,2012,education - higher education instructional,0,0,0,0,0,0,0,0
GA,2012,education - higher education other,0,0,0,0,0,0,0,0
GA,2012,education - other,0,0,0,0,0,0,0,0
GA,2012,libraries,1924,6131917,1163,937284,95223,2466,3087,7069201
GA,2012,liquor stores,0,0,0,0,0,0,0,0
GA,2012,other and unallocable,6196,20197187,2774,1974393,159840,7107,8970,22171580
HI,2012,total,14914,75960246,1320,1014656,70757,15329,16234,76974902
HI,2012,financial administration,971,3966538,7,15906,578,974,978,3982444
HI,2012,other government administration,1097,4968500,56,72002,3214,1116,1153,5040502
HI,2012,judicial and legal,560,2844498,7,6618,456,562,567,2851116
HI,2012,police protection total,3711,23812140,148,64710,5014,3740,3859,23876850
HI,2012,police protection - officers,2898,20755150,0,0,0,2898,2898,20755150
HI,2012,police protection - other,813,3056990,148,64710,5014,842,961,3121700
HI,2012,fire protection total,1910,12063014,17,41668,1912,1921,1927,12104682
HI,2012,fire protection - firefighters,1777,11570204,0,0,0,1777,1777,11570204
HI,2012,fire protection - other,133,492810,17,41668,1912,144,150,534478
HI,2012,corrections,0,0,0,0,0,0,0,0
HI,2012,highways,944,3597732,12,16786,820,949,956,3614518
HI,2012,air transportation,0,0,0,0,0,0,0,0
HI,2012,water transport and terminals,0,0,0,0,0,0,0,0
HI,2012,public welfare,141,608800,99,70906,5916,174,240,679706
HI,2012,health,266,1592668,34,48682,2254,279,300,1641350
HI,2012,hospitals,0,0,0,0,0,0,0,0
HI,2012,social insurance administration,0,0,0,0,0,0,0,0
HI,2012,solid waste management,614,2887586,0,0,0,614,614,2887586
HI,2012,sewerage,714,3257120,1,638,84,715,715,3257758
HI,2012,parks and recreation,1658,5598010,790,448204,35254,1868,2448,6046214
HI,2012,housing and community development,270,1062088,9,10002,780,275,279,1072090
HI,2012,natural resources,169,648685,80,135290,8071,217,249,783975
HI,2012,water transport and terminals,949,4873825,2,7634,266,951,951,4881459
HI,2012,electric power,0,0,0,0,0,0,0,0
HI,2012,gas supply,0,0,0,0,0,0,0,0
HI,2012,transit,71,275366,26,40376,3654,92,97,315742
HI,2012,education total,0,0,0,0,0,0,0,0
HI,2012,education - elementary and secondary total,0,0,0,0,0,0,0,0
HI,2012,education - elementary and secondary instructional,0,0,0,0,0,0,0,0
HI,2012,education - elementary and secondary other,0,0,0,0,0,0,0,0
HI,2012,education - higher education total,0,0,0,0,0,0,0,0
HI,2012,education - higher education instructional,0,0,0,0,0,0,0,0
HI,2012,education - higher education other,0,0,0,0,0,0,0,0
HI,2012,education - other,0,0,0,0,0,0,0,0
HI,2012,libraries,2,6102,1,1322,64,2,3,7424
HI,2012,liquor stores,0,0,0,0,0,0,0,0
HI,2012,other and unallocable,867,3897574,31,33912,2420,880,898,3931486
ID,2012,total,49664,166142467,21209,16103491,1145187,56232,70873,182245958
ID,2012,financial administration,1371,4765492,159,162124,12934,1439,1530,4927616
ID,2012,other government administration,950,3496668,1017,543897,29810,1111,1967,4040565
ID,2012,judicial and legal,1450,5357329,132,163838,10489,1506,1582,5521167
ID,2012,police protection total,3490,14821847,226,210223,14438,3565,3716,15032070
ID,2012,police protection - officers,2515,11724162,89,90717,5303,2543,2604,11814879
ID,2012,police protection - other,975,3097685,137,119506,9135,1022,1112,3217191
ID,2012,fire protection total,1244,6714580,1321,420060,27673,1396,2565,7134640
ID,2012,fire protection - firefighters,1161,6278189,1118,358598,23042,1291,2279,6636787
ID,2012,fire protection - other,83,436391,203,61462,4631,105,286,497853
ID,2012,corrections,1571,5403799,217,199505,16343,1665,1788,5603304
ID,2012,highways,1715,6188015,238,163286,10665,1772,1953,6351301
ID,2012,air transportation,136,450328,20,16328,1429,144,156,466656
ID,2012,water transport and terminals,6,27814,1,1610,31,6,7,29424
ID,2012,public welfare,113,306031,42,33842,2858,128,155,339873
ID,2012,health,784,2809748,375,435625,23730,916,1159,3245373
ID,2012,hospitals,2932,12921978,1174,3150101,137072,3710,4106,16072079
ID,2012,social insurance administration,0,0,0,0,0,0,0,0
ID,2012,solid waste management,451,1337800,69,56921,4728,478,520,1394721
ID,2012,sewerage,658,2491738,193,127035,7590,697,851,2618773
ID,2012,parks and recreation,559,1977263,829,455713,44170,811,1388,2432976
ID,2012,housing and community development,205,730502,34,48445,2691,221,239,778947
ID,2012,natural resources,374,1136551,216,131796,9316,431,590,1268347
ID,2012,water transport and terminals,496,1831004,167,78424,5223,519,663,1909428
ID,2012,electric power,98,577647,1,849,25,98,99,578496
ID,2012,gas supply,0,0,0,0,0,0,0,0
ID,2012,transit,79,221502,46,50417,4106,102,125,271919
ID,2012,education total,29712,88562880,13502,8739741,701350,33813,43214,97302621
ID,2012,education - elementary and secondary total,28217,83279457,11723,7211161,623271,31865,39940,90490618
ID,2012,education - elementary and secondary instructional,20487,68857306,6879,4301913,344376,22505,27366,73159219
ID,2012,education - elementary and secondary other,7730,14422151,4844,2909248,278895,9360,12574,17331399
ID,2012,education - higher education total,1495,5283423,1779,1528580,78079,1948,3274,6812003
ID,2012,education - higher education instructional,476,2074574,914,1120215,33451,670,1390,3194789
ID,2012,education - higher education other,1019,3208849,865,408365,44628,1278,1884,3617214
ID,2012,education - other,0,0,0,0,0,0,0,0
ID,2012,libraries,400,1226377,763,629451,55573,715,1163,1855828
ID,2012,liquor stores,0,0,0,0,0,0,0,0
ID,2012,other and unallocable,870,2785574,467,284260,22943,989,1337,3069834
IL,2012,total,448836,2152660754,179997,171517282,10476195,510196,628833,2324178036
IL,2012,financial administration,6807,32055061,2659,2356144,142319,7549,9466,34411205
IL,2012,other government administration,7172,32658621,18413,6567634,338592,8944,25585,39226255
IL,2012,judicial and legal,12631,58235015,762,857868,51333,12926,13393,59092883
IL,2012,police protection total,35838,223125059,7069,6866087,446550,38359,42907,229991146
IL,2012,police protection - officers,30126,198429866,2826,2507011,177358,31119,32952,200936877
IL,2012,police protection - other,5712,24695193,4243,4359076,269192,7240,9955,29054269
IL,2012,fire protection total,15142,104674280,12339,6401878,439844,17611,27481,111076158
IL,2012,fire protection - firefighters,12906,88210761,11213,5907288,411237,15225,24119,94118049
IL,2012,fire protection - other,2236,16463519,1126,494590,28607,2386,3362,16958109
IL,2012,corrections,10119,48718059,274,302800,23353,10252,10393,49020859
IL,2012,highways,9511,45368356,2950,2678820,205372,10653,12461,48047176
IL,2012,air transportation,1815,10105821,202,177824,13242,1886,2017,10283645
IL,2012,water transport and terminals,57,273530,17,16129,1303,64,74,289659
IL,2012,public welfare,4979,15993331,1517,1836379,121303,5684,6496,17829710
IL,2012,health,5623,23496660,1565,1692394,92180,6167,7188,25189054
IL,2012,hospitals,10279,59407626,1604,3147934,161392,11224,11883,62555560
IL,2012,social insurance administration,0,0,0,0,0,0,0,0
IL,2012,solid waste management,2958,16687755,107,111452,9691,3010,3065,16799207
IL,2012,sewerage,4959,29403230,477,391154,26749,5101,5436,29794384
IL,2012,parks and recreation,9217,41000903,24087,18398807,1468967,17584,33304,59399710
IL,2012,housing and community development,3275,15181525,380,497675,33527,3474,3655,15679200
IL,2012,natural resources,1432,6818502,479,383958,26975,1584,1911,7202460
IL,2012,water transport and terminals,5325,30206092,1039,813357,56486,5618,6364,31019449
IL,2012,electric power,1137,7710788,37,51847,2410,1151,1174,7762635
IL,2012,gas supply,122,447769,21,19654,1606,131,143,467423
IL,2012,transit,13901,75370577,1373,3848633,183403,14941,15274,79219210
IL,2012,education total,273191,1214595604,91622,103215639,5821146,308271,364813,1317811243
IL,2012,education - elementary and secondary total,257828,1132986170,63017,68750753,4174446,283380,320845,1201736923
IL,2012,education - elementary and secondary instructional,188919,921072348,32817,38791847,2097739,201839,221736,959864195
IL,2012,education - elementary and secondary other,68909,211913822,30200,29958906,2076707,81541,99109,241872728
IL,2012,education - higher education total,15363,81609434,28605,34464886,1646700,24891,43968,116074320
IL,2012,education - higher education instructional,5458,37762586,16754,22607827,788168,10013,22212,60370413
IL,2012,education - higher education other,9905,43846848,11851,11857059,858532,14878,21756,55703907
IL,2012,education - other,0,0,0,0,0,0,0,0
IL,2012,libraries,5481,21864427,8567,8906542,672302,9402,14048,30770969
IL,2012,liquor stores,0,0,0,0,0,0,0,0
IL,2012,other and unallocable,7865,39262163,2437,1976673,136150,8610,10302,41238836
IN,2012,total,205436,741958567,73131,80912242,5351400,236837,278567,822870809
IN,2012,financial administration,3603,10615336,1802,1355326,109109,4207,5405,11970662
IN,2012,other government administration,4736,12653730,6411,2589566,166791,5610,11147,15243296
IN,2012,judicial and legal,5567,17928423,996,1188526,78075,6014,6563,19116949
IN,2012,police protection total,13132,52664276,1912,1399073,105655,13736,15044,54063349
IN,2012,police protection - officers,10271,44106206,570,445031,31387,10449,10841,44551237
IN,2012,police protection - other,2861,8558070,1342,954042,74268,3287,4203,9512112
IN,2012,fire protection total,7317,32727085,2379,945331,77533,7757,9696,33672416
IN,2012,fire protection - firefighters,7063,31866378,2270,877848,72273,7474,9333,32744226
IN,2012,fire protection - other,254,860707,109,67483,5260,283,363,928190
IN,2012,corrections,5825,17329163,794,768853,62977,6202,6619,18098016
IN,2012,highways,5350,17098205,370,370861,28819,5512,5720,17469066
IN,2012,air transportation,256,1110582,74,70537,5468,289,330,1181119
IN,2012,water transport and terminals,7,28799,0,0,0,7,7,28799
IN,2012,public welfare,877,2008200,257,250191,20156,994,1134,2258391
IN,2012,health,2754,8974063,884,905587,60150,3115,3638,9879650
IN,2012,hospitals,18419,81085882,7496,19022501,804741,23047,25915,100108383
IN,2012,social insurance administration,0,0,0,0,0,0,0,0
IN,2012,solid waste management,1168,3590529,349,336618,29451,1335,1517,3927147
IN,2012,sewerage,2826,10415757,373,275463,18554,2922,3199,10691220
IN,2012,parks and recreation,2165,7246856,2998,2537748,222675,3429,5163,9784604
IN,2012,housing and community development,1316,4337149,212,219250,15026,1402,1528,4556399
IN,2012,natural resources,423,1244990,253,109731,9319,476,676,1354721
IN,2012,water transport and terminals,1951,6924889,259,217936,16374,2037,2210,7142825
IN,2012,electric power,873,4027177,59,54379,3683,895,932,4081556
IN,2012,gas supply,1134,6023436,85,288310,6208,1169,1219,6311746
IN,2012,transit,1335,5373293,175,267521,19169,1446,1510,5640814
IN,2012,education total,118487,420783569,39956,43619794,3116110,137130,158443,464403363
IN,2012,education - elementary and secondary total,118487,420783569,39956,43619794,3116110,137130,158443,464403363
IN,2012,education - elementary and secondary instructional,80638,330717765,18857,20379236,1395688,88999,99495,351097001
IN,2012,education - elementary and secondary other,37849,90065804,21099,23240558,1720422,48131,58948,113306362
IN,2012,education - higher education total,0,0,0,0,0,0,0,0
IN,2012,education - higher education instructional,0,0,0,0,0,0,0,0
IN,2012,education - higher education other,0,0,0,0,0,0,0,0
IN,2012,education - other,0,0,0,0,0,0,0,0
IN,2012,libraries,3076,9219858,3691,3109850,283548,4740,6767,12329708
IN,2012,liquor stores,0,0,0,0,0,0,0,0
IN,2012,other and unallocable,2839,8547320,1346,1009290,91809,3366,4185,9556610
IA,2012,total,108279,427535675,58821,55526284,3731255,129586,167100,483061959
IA,2012,financial administration,2646,10493038,674,439439,30077,2795,3320,10932477
IA,2012,other government administration,1961,7737504,4829,1475251,89045,2424,6790,9212755
IA,2012,judicial and legal,806,4110938,119,203874,9482,861,925,4314812
IA,2012,police protection total,5849,27021575,947,814431,51473,6124,6796,27836006
IA,2012,police protection - officers,4586,22534600,369,268332,18039,4671,4955,22802932
IA,2012,police protection - other,1263,4486975,578,546099,33434,1453,1841,5033074
IA,2012,fire protection total,1794,9532049,1966,475032,37121,1994,3760,10007081
IA,2012,fire protection - firefighters,1718,9151802,1876,432404,34468,1904,3594,9584206
IA,2012,fire protection - other,76,380247,90,42628,2653,90,166,422875
IA,2012,corrections,1444,5489069,302,393566,26472,1596,1746,5882635
IA,2012,highways,5357,21274849,363,282487,20941,5465,5720,21557336
IA,2012,air transportation,129,605014,44,38917,3217,147,173,643931
IA,2012,water transport and terminals,0,0,0,0,0,0,0,0
IA,2012,public welfare,851,2892846,538,524356,39567,1081,1389,3417202
IA,2012,health,1666,6058632,942,936304,62858,2024,2608,6994936
IA,2012,hospitals,9279,38360006,3260,6395877,307050,11038,12539,44755883
IA,2012,social insurance administration,0,0,0,0,0,0,0,0
IA,2012,solid waste management,815,3246429,269,222242,18552,918,1084,3468671
IA,2012,sewerage,1162,4828728,302,164525,11702,1209,1464,4993253
IA,2012,parks and recreation,1317,5262259,2349,1254293,117140,1966,3666,6516552
IA,2012,housing and community development,409,1843821,83,105109,7186,449,492,1948930
IA,2012,natural resources,195,742663,131,103821,7211,237,326,846484
IA,2012,water transport and terminals,1494,6404085,400,260083,19133,1581,1894,6664168
IA,2012,electric power,797,4051679,23,26636,1588,804,820,4078315
IA,2012,gas supply,80,387202,2,1365,120,80,82,388567
IA,2012,transit,493,1947006,546,837143,59670,831,1039,2784149
IA,2012,education total,67247,255427210,37556,38173397,2609636,82351,104803,293600607
IA,2012,education - elementary and secondary total,61976,231642422,30145,30858951,2270183,75160,92121,262501373
IA,2012,education - elementary and secondary instructional,47299,191803524,16366,16814251,1169445,54091,63665,208617775
IA,2012,education - elementary and secondary other,14677,39838898,13779,14044700,1100738,21069,28456,53883598
IA,2012,education - higher education total,5271,23784788,7411,7314446,339453,7191,12682,31099234
IA,2012,education - higher education instructional,1952,10673614,4221,4978850,151930,2811,6173,15652464
IA,2012,education - higher education other,3319,13111174,3190,2335596,187523,4380,6509,15446770
IA,2012,education - other,0,0,0,0,0,0,0,0
IA,2012,libraries,865,3377959,2061,1680667,143729,1676,2926,5058626
IA,2012,liquor stores,0,0,0,0,0,0,0,0
IA,2012,other and unallocable,1623,6441114,1115,717469,58285,1935,2738,7158583
KS,2012,total,127336,445263032,51393,41320851,2918071,143915,178729,486583883
KS,2012,financial administration,2818,10463235,1084,337853,25089,2918,3902,10801088
KS,2012,other government administration,2284,8766563,3993,954410,63219,2557,6277,9720973
KS,2012,judicial and legal,1469,5971268,495,480883,23633,1583,1964,6452151
KS,2012,police protection total,7698,31439044,788,660504,49134,7965,8486,32099548
KS,2012,police protection - officers,5837,25435352,430,301907,22810,5955,6267,25737259
KS,2012,police protection - other,1861,6003692,358,358597,26324,2010,2219,6362289
KS,2012,fire protection total,3064,15039830,2321,476301,35469,3253,5385,15516131
KS,2012,fire protection - firefighters,2903,14350947,2094,427341,31217,3068,4997,14778288
KS,2012,fire protection - other,161,688883,227,48960,4252,185,388,737843
KS,2012,corrections,2762,9810549,235,195187,13294,2840,2997,10005736
KS,2012,highways,4692,15001034,652,583072,49011,4929,5344,15584106
KS,2012,air transportation,210,837554,14,11918,1111,216,224,849472
KS,2012,water transport and terminals,0,0,0,0,0,0,0,0
KS,2012,public welfare,495,1596479,181,150936,12614,568,676,1747415
KS,2012,health,2747,10175595,1308,951736,66180,3121,4055,11127331
KS,2012,hospitals,7258,29336059,2187,3394080,189342,8335,9445,32730139
KS,2012,social insurance administration,0,0,0,0,0,0,0,0
KS,2012,solid waste management,993,2942100,136,106204,9796,1046,1129,3048304
KS,2012,sewerage,1160,4285161,115,67010,5451,1187,1275,4352171
KS,2012,parks and recreation,1550,5594128,2092,1235590,109708,2165,3642,6829718
KS,2012,housing and community development,891,3040020,296,269967,20038,1001,1187,3309987
KS,2012,natural resources,369,1174266,155,93974,7337,410,524,1268240
KS,2012,water transport and terminals,2035,7768170,604,476872,30941,2191,2639,8245042
KS,2012,electric power,1082,5733435,30,26962,2217,1094,1112,5760397
KS,2012,gas supply,57,210217,0,0,0,57,57,210217
KS,2012,transit,283,989913,78,58768,5354,314,361,1048681
KS,2012,education total,80274,264370815,33028,29728249,2109364,92541,113302,294099064
KS,2012,education - elementary and secondary total,74293,239365747,24800,22768755,1715207,84305,99093,262134502
KS,2012,education - elementary and secondary instructional,54168,193367527,14026,12650105,860346,59196,68194,206017632
KS,2012,education - elementary and secondary other,20125,45998220,10774,10118650,854861,25109,30899,56116870
KS,2012,education - higher education total,5981,25005068,8228,6959494,394157,8236,14209,31964562
KS,2012,education - higher education instructional,2144,11186882,4330,4121698,148717,2998,6474,15308580
KS,2012,education - higher education other,3837,13818186,3898,2837796,245440,5238,7735,16655982
KS,2012,education - other,0,0,0,0,0,0,0,0
KS,2012,libraries,827,2835082,689,587073,50008,1105,1516,3422155
KS,2012,liquor stores,0,0,0,0,0,0,0,0
KS,2012,other and unallocable,2318,7882515,912,473302,39761,2519,3230,8355817
KY,2012,total,150297,488037490,30793,26847881,2020239,162289,181090,514885371
KY,2012,financial administration,1755,6129509,281,252863,18861,1853,2036,6382372
KY,2012,other government administration,2448,8136591,1965,879004,48938,2706,4413,9015595
KY,2012,judicial and legal,1005,3052666,629,640974,51201,1294,1634,3693640
KY,2012,police protection total,7297,29632997,819,778488,64373,7659,8116,30411485
KY,2012,police protection - officers,6376,26969367,360,420561,32580,6557,6736,27389928
KY,2012,police protection - other,921,2663630,459,357927,31793,1102,1380,3021557
KY,2012,fire protection total,3930,16933877,1479,677456,56435,4244,5409,17611333
KY,2012,fire protection - firefighters,3772,16368148,1329,643290,53383,4069,5101,17011438
KY,2012,fire protection - other,158,565729,150,34166,3052,175,308,599895
KY,2012,corrections,3523,10270965,586,568743,55983,3839,4109,10839708
KY,2012,highways,3079,9089870,108,108802,9920,3137,3187,9198672
KY,2012,air transportation,637,2966583,117,127711,10590,700,754,3094294
KY,2012,water transport and terminals,71,272665,3,5239,341,73,74,277904
KY,2012,public welfare,322,994431,131,80074,10041,377,453,1074505
KY,2012,health,5328,17407516,1304,1399477,103890,5915,6632,18806993
KY,2012,hospitals,4274,16664972,1324,2810280,122700,4975,5598,19475252
KY,2012,social insurance administration,0,0,0,0,0,0,0,0
KY,2012,solid waste management,1351,3837381,144,131560,12355,1421,1495,3968941
KY,2012,sewerage,1866,7489892,79,85116,6014,1900,1945,7575008
KY,2012,parks and recreation,1409,3748760,1043,797182,85502,1894,2452,4545942
KY,2012,housing and community development,938,3254330,92,97293,7767,981,1030,3351623
KY,2012,natural resources,198,549316,277,135596,10553,259,475,684912
KY,2012,water transport and terminals,2812,10066812,334,290234,18897,2911,3146,10357046
KY,2012,electric power,624,3330021,19,21936,1310,631,643,3351957
KY,2012,gas supply,142,445683,1,1470,125,143,143,447153
KY,2012,transit,923,3623651,150,193080,15518,1014,1073,3816731
KY,2012,education total,102513,317893401,17927,15178972,1153068,109608,120440,333072373
KY,2012,education - elementary and secondary total,102510,317884766,17924,15176288,1152865,109604,120434,333061054
KY,2012,education - elementary and secondary instructional,62713,241537116,10001,8928038,579371,66336,72714,250465154
KY,2012,education - elementary and secondary other,39797,76347650,7923,6248250,573494,43268,47720,82595900
KY,2012,education - higher education total,3,8635,3,2684,203,4,6,11319
KY,2012,education - higher education instructional,0,0,0,0,0,0,0,0
KY,2012,education - higher education other,3,8635,3,2684,203,4,6,11319
KY,2012,education - other,0,0,0,0,0,0,0,0
KY,2012,libraries,1425,4034780,1196,988805,100514,2015,2621,5023585
KY,2012,liquor stores,0,0,0,0,0,0,0,0
KY,2012,other and unallocable,2427,8210821,785,597526,55343,2740,3212,8808347
LA,2012,total,172974,586420124,33668,29746112,2301830,186361,206642,616166236
LA,2012,financial administration,3516,13082745,308,369050,26884,3664,3824,13451795
LA,2012,other government administration,2640,9473051,1623,1090980,76106,3059,4263,10564031
LA,2012,judicial and legal,5452,18200508,993,1094041,83697,5920,6445,19294549
LA,2012,police protection total,14775,54025331,1956,1842287,171843,15746,16731,55867618
LA,2012,police protection - officers,11575,43504380,812,710038,60566,11916,12387,44214418
LA,2012,police protection - other,3200,10520951,1144,1132249,111277,3830,4344,11653200
LA,2012,fire protection total,4897,20498852,368,191132,19605,5004,5265,20689984
LA,2012,fire protection - firefighters,4602,19537085,322,161520,16733,4694,4924,19698605
LA,2012,fire protection - other,295,961767,46,29612,2872,310,341,991379
LA,2012,corrections,6493,20459494,609,782634,76430,6925,7102,21242128
LA,2012,highways,5114,14983296,342,372626,35488,5313,5456,15355922
LA,2012,air transportation,425,1575654,33,37249,2890,441,458,1612903
LA,2012,water transport and terminals,314,1384896,23,24051,1920,326,337,1408947
LA,2012,public welfare,737,2075899,107,134010,11962,804,844,2209909
LA,2012,health,1540,5600679,402,471578,35666,1740,1942,6072257
LA,2012,hospitals,16373,72891114,4111,7509655,362053,18419,20484,80400769
LA,2012,social insurance administration,0,0,0,0,0,0,0,0
LA,2012,solid waste management,1031,2748968,194,163336,16770,1125,1225,2912304
LA,2012,sewerage,1846,6292214,105,105074,8936,1896,1951,6397288
LA,2012,parks and recreation,2871,8616340,2437,1993237,204431,4027,5308,10609577
LA,2012,housing and community development,1119,3828828,147,137371,12489,1188,1266,3966199
LA,2012,natural resources,923,3057347,134,59806,5930,956,1057,3117153
LA,2012,water transport and terminals,3030,11201247,276,200279,18446,3133,3306,11401526
LA,2012,electric power,595,2460549,27,34182,2963,612,622,2494731
LA,2012,gas supply,287,828695,46,36572,3601,307,333,865267
LA,2012,transit,349,1157645,50,78050,5943,383,399,1235695
LA,2012,education total,93336,295883351,17620,11096194,953958,99142,110956,306979545
LA,2012,education - elementary and secondary total,93336,295883351,17620,11096194,953958,99142,110956,306979545
LA,2012,education - elementary and secondary instructional,64193,235338444,10096,6705120,554770,67602,74289,242043564
LA,2012,education - elementary and secondary other,29143,60544907,7524,4391074,399188,31540,36667,64935981
LA,2012,education - higher education total,0,0,0,0,0,0,0,0
LA,2012,education - higher education instructional,0,0,0,0,0,0,0,0
LA,2012,education - higher education other,0,0,0,0,0,0,0,0
LA,2012,education - other,0,0,0,0,0,0,0,0
LA,2012,libraries,2183,6368481,1195,1392825,111752,2812,3378,7761306
LA,2012,liquor stores,0,0,0,0,0,0,0,0
LA,2012,other and unallocable,3128,9724940,562,529893,52067,3419,3690,10254833
ME,2012,total,43970,158074835,20701,17960278,1164864,50781,64671,176035113
ME,2012,financial administration,989,3547052,712,541582,35583,1190,1701,4088634
ME,2012,other government administration,922,3640998,1700,765780,48191,1189,2622,4406778
ME,2012,judicial and legal,174,624016,71,65361,3975,198,245,689377
ME,2012,police protection total,2250,10004450,586,457127,35049,2445,2836,10461577
ME,2012,police protection - officers,1860,8585649,358,296726,21690,1980,2218,8882375
ME,2012,police protection - other,390,1418801,228,160401,13359,465,618,1579202
ME,2012,fire protection total,1227,5426025,3282,920697,72872,1645,4509,6346722
ME,2012,fire protection - firefighters,1156,5135922,3138,803324,65877,1532,4294,5939246
ME,2012,fire protection - other,71,290103,144,117373,6995,113,215,407476
ME,2012,corrections,726,2647339,111,145680,11034,790,837,2793019
ME,2012,highways,1589,5642885,377,310250,21466,1703,1966,5953135
ME,2012,air transportation,154,664564,59,67092,4612,181,213,731656
ME,2012,water transport and terminals,18,66081,16,15111,810,21,34,81192
ME,2012,public welfare,98,333710,65,78563,5044,128,163,412273
ME,2012,health,170,691534,448,363713,21117,290,618,1055247
ME,2012,hospitals,877,3697215,384,733234,34602,1076,1261,4430449
ME,2012,social insurance administration,0,0,0,0,0,0,0,0
ME,2012,solid waste management,416,1483225,375,282496,27362,570,791,1765721
ME,2012,sewerage,530,2196543,118,92109,5680,564,648,2288652
ME,2012,parks and recreation,381,1368423,916,562603,49378,659,1297,1931026
ME,2012,housing and community development,435,1624252,93,97664,7333,477,528,1721916
ME,2012,natural resources,37,130756,18,22721,1326,45,55,153477
ME,2012,water transport and terminals,613,2610030,207,144851,8749,662,820,2754881
ME,2012,electric power,21,91738,11,12452,574,24,32,104190
ME,2012,gas supply,0,0,0,0,0,0,0,0
ME,2012,transit,83,339883,37,87547,5418,114,120,427430
ME,2012,education total,31404,108311130,9714,11364752,701720,35598,41118,119675882
ME,2012,education - elementary and secondary total,31404,108311130,9714,11364752,701720,35598,41118,119675882
ME,2012,education - elementary and secondary instructional,23773,88385380,6311,7309184,421890,26289,30084,95694564
ME,2012,education - elementary and secondary other,7631,19925750,3403,4055568,279830,9309,11034,23981318
ME,2012,education - higher education total,0,0,0,0,0,0,0,0
ME,2012,education - higher education instructional,0,0,0,0,0,0,0,0
ME,2012,education - higher education other,0,0,0,0,0,0,0,0
ME,2012,education - other,0,0,0,0,0,0,0,0
ME,2012,libraries,206,677848,412,371765,27634,369,618,1049613
ME,2012,liquor stores,0,0,0,0,0,0,0,0
ME,2012,other and unallocable,650,2255138,989,457128,35335,843,1639,2712266
MD,2012,total,187010,957755392,57655,87855866,4409463,212787,244665,1045611258
MD,2012,financial administration,2510,12088357,183,331184,14561,2597,2693,12419541
MD,2012,other government administration,3172,17064872,988,1469560,68424,3563,4160,18534432
MD,2012,judicial and legal,2927,15155945,302,604568,28807,3099,3229,15760513
MD,2012,police protection total,15790,91402858,1440,1788453,119095,16499,17230,93191311
MD,2012,police protection - officers,12055,73657359,302,540999,27796,12217,12357,74198358
MD,2012,police protection - other,3735,17745499,1138,1247454,91299,4282,4873,18992953
MD,2012,fire protection total,6740,39651011,149,254363,12144,6811,6889,39905374
MD,2012,fire protection - firefighters,6163,36412466,41,48642,2905,6181,6204,36461108
MD,2012,fire protection - other,577,3238545,108,205721,9239,630,685,3444266
MD,2012,corrections,3624,17475244,62,130743,7415,3666,3686,17605987
MD,2012,highways,4449,17953426,107,206988,12556,4523,4556,18160414
MD,2012,air transportation,29,121677,18,18097,1525,37,47,139774
MD,2012,water transport and terminals,2,11890,9,3266,343,4,11,15156
MD,2012,public welfare,2317,11257929,1003,1629883,144732,3156,3320,12887812
MD,2012,health,4220,20564978,1286,3178297,151871,5085,5506,23743275
MD,2012,hospitals,0,0,0,0,0,0,0,0
MD,2012,social insurance administration,0,0,0,0,0,0,0,0
MD,2012,solid waste management,1523,5580626,158,188038,16055,1617,1681,5768664
MD,2012,sewerage,3718,16921753,45,119224,4843,3746,3763,17040977
MD,2012,parks and recreation,4630,19664718,5287,4077245,350154,6678,9917,23741963
MD,2012,housing and community development,2404,9836897,205,548777,25377,2549,2609,10385674
MD,2012,natural resources,505,2297447,63,109921,5247,538,568,2407368
MD,2012,water transport and terminals,2131,9611954,23,50883,2496,2145,2154,9662837
MD,2012,electric power,80,399146,0,0,0,80,80,399146
MD,2012,gas supply,0,0,0,0,0,0,0,0
MD,2012,transit,1077,4210218,226,321897,22545,1208,1303,4532115
MD,2012,education total,118223,618566297,43203,69391401,3187099,136899,161426,687957698
MD,2012,education - elementary and secondary total,110207,575585364,29593,53998625,2432138,124481,139800,629583989
MD,2012,education - elementary and secondary instructional,82766,470930124,16999,34292373,1274899,90228,99765,505222497
MD,2012,education - elementary and secondary other,27441,104655240,12594,19706252,1157239,34253,40035,124361492
MD,2012,education - higher education total,8016,42980933,13610,15392776,754961,12418,21626,58373709
MD,2012,education - higher education instructional,2426,16452629,8609,10686155,432668,4930,11035,27138784
MD,2012,education - higher education other,5590,26528304,5001,4706621,322293,7488,10591,31234925
MD,2012,education - other,0,0,0,0,0,0,0,0
MD,2012,libraries,2326,8873132,1900,1766553,129818,3073,4226,10639685
MD,2012,liquor stores,0,0,0,0,0,0,0,0
MD,2012,other and unallocable,4613,19045017,998,1666525,104356,5214,5611,20711542
MA,2012,total,204005,1020137897,61318,71752087,3850794,226983,265323,1091889984
MA,2012,financial administration,3968,19119682,1161,1349950,62497,4327,5129,20469632
MA,2012,other government administration,3392,16404791,1739,1667854,84550,3880,5131,18072645
MA,2012,judicial and legal,243,1419642,64,132498,4289,265,307,1552140
MA,2012,police protection total,16065,105203022,2813,2645221,153894,16949,18878,107848243
MA,2012,police protection - officers,13579,94242881,1292,1140209,67037,13960,14871,95383090
MA,2012,police protection - other,2486,10960141,1521,1505012,86857,2989,4007,12465153
MA,2012,fire protection total,12166,75895279,2456,1306664,79401,12615,14622,77201943
MA,2012,fire protection - firefighters,11547,72772111,2187,1059818,66808,11922,13734,73831929
MA,2012,fire protection - other,619,3123168,269,246846,12593,693,888,3370014
MA,2012,corrections,0,0,0,0,0,0,0,0
MA,2012,highways,5603,25957916,268,339062,19477,5713,5871,26296978
MA,2012,air transportation,154,763198,44,56618,3617,175,198,819816
MA,2012,water transport and terminals,57,257549,49,41394,2897,75,106,298943
MA,2012,public welfare,1667,6525928,1201,1354879,87689,2175,2868,7880807
MA,2012,health,2637,12809047,993,1098407,59039,2975,3630,13907454
MA,2012,hospitals,2116,7468608,1132,2128334,61042,2461,3248,9596942
MA,2012,social insurance administration,0,0,0,0,0,0,0,0
MA,2012,solid waste management,998,3934750,245,203871,15851,1083,1243,4138621
MA,2012,sewerage,1864,9059989,109,129065,5972,1898,1973,9189054
MA,2012,parks and recreation,1612,6735774,2061,1255520,93681,2155,3673,7991294
MA,2012,housing and community development,4193,19424085,647,1130027,54454,4505,4840,20554112
MA,2012,natural resources,265,1098022,73,97959,5869,296,338,1195981
MA,2012,water transport and terminals,2790,13793457,252,199703,11089,2852,3042,13993160
MA,2012,electric power,1206,7964748,53,86610,4136,1229,1259,8051358
MA,2012,gas supply,98,709917,4,5927,326,101,102,715844
MA,2012,transit,196,874401,102,182731,10452,257,298,1057132
MA,2012,education total,135504,654015254,39821,51113230,2692685,151808,175325,705128484
MA,2012,education - elementary and secondary total,135465,653813575,39646,50946768,2687603,151738,175111,704760343
MA,2012,education - elementary and secondary instructional,108295,558530889,24050,34680289,1632406,118211,132345,593211178
MA,2012,education - elementary and secondary other,27170,95282686,15596,16266479,1055197,33527,42766,111549165
MA,2012,education - higher education total,39,201679,175,166462,5082,70,214,368141
MA,2012,education - higher education instructional,35,185574,165,163086,4801,65,200,348660
MA,2012,education - higher education other,4,16105,10,3376,281,5,14,19481
MA,2012,education - other,0,0,0,0,0,0,0,0
MA,2012,libraries,2764,11114908,2913,3035445,192393,3885,5677,14150353
MA,2012,liquor stores,0,0,0,0,0,0,0,0
MA,2012,other and unallocable,4447,19587930,3118,2191118,145494,5304,7565,21779048
MI,2012,total,249406,1132077951,130088,133659709,8521226,299391,379494,1265737660
MI,2012,financial administration,5414,24120688,3579,3594807,227613,6658,8993,27715495
MI,2012,other government administration,5364,22035163,13453,6341646,356644,7380,18817,28376809
MI,2012,judicial and legal,8907,38478682,1000,1614718,86825,9404,9907,40093400
MI,2012,police protection total,17256,94120098,3357,2966497,219613,18511,20613,97086595
MI,2012,police protection - officers,14424,82528438,1262,1182132,80122,14881,15686,83710570
MI,2012,police protection - other,2832,11591660,2095,1784365,139491,3630,4927,13376025
MI,2012,fire protection total,5613,29473317,13080,4206061,293088,7300,18693,33679378
MI,2012,fire protection - firefighters,5143,27646675,12482,4027695,279379,6754,17625,31674370
MI,2012,fire protection - other,470,1826642,598,178366,13709,546,1068,2005008
MI,2012,corrections,5147,23039222,832,1161165,80888,5617,5979,24200387
MI,2012,highways,8054,33556284,654,696723,49610,8342,8708,34253007
MI,2012,air transportation,932,5316913,136,143229,9651,991,1068,5460142
MI,2012,water transport and terminals,8,48078,15,8635,319,10,23,56713
MI,2012,public welfare,2943,9383885,2051,2687898,214652,4181,4994,12071783
MI,2012,health,8752,34803366,3400,5020087,291962,10446,12152,39823453
MI,2012,hospitals,6522,29811055,2556,5910582,286820,8181,9078,35721637
MI,2012,social insurance administration,0,0,0,0,0,0,0,0
MI,2012,solid waste management,946,4152982,291,223206,18208,1037,1237,4376188
MI,2012,sewerage,3320,14540302,320,272082,19102,3424,3640,14812384
MI,2012,parks and recreation,2046,8532351,4723,3160654,287106,3678,6769,11693005
MI,2012,housing and community development,1383,6165334,348,488665,34862,1582,1731,6653999
MI,2012,natural resources,476,1775719,201,220565,14816,562,677,1996284
MI,2012,water transport and terminals,3898,14744054,274,257616,17231,3997,4172,15001670
MI,2012,electric power,978,5340399,24,23096,1402,985,1002,5363495
MI,2012,gas supply,0,0,0,0,0,0,0,0
MI,2012,transit,4213,13606777,1041,1610724,118295,4890,5254,15217501
MI,2012,education total,149460,687606611,67644,85014680,5298472,181082,217104,772621291
MI,2012,education - elementary and secondary total,140872,637914510,49516,64545975,4347988,167065,190388,702460485
MI,2012,education - elementary and secondary instructional,103535,520853308,20256,28857439,1722061,113815,123791,549710747
MI,2012,education - elementary and secondary other,37337,117061202,29260,35688536,2625927,53250,66597,152749738
MI,2012,education - higher education total,8588,49692101,18128,20468705,950484,14017,26716,70160806
MI,2012,education - higher education instructional,3031,23470320,10449,14410355,427853,5476,13480,37880675
MI,2012,education - higher education other,5557,26221781,7679,6058350,522631,8541,13236,32280131
MI,2012,education - other,0,0,0,0,0,0,0,0
MI,2012,libraries,2442,9031499,4633,4647331,362694,4523,7075,13678830
MI,2012,liquor stores,0,0,0,0,0,0,0,0
MI,2012,other and unallocable,5332,22395172,6476,3389042,231353,6610,11808,25784214
MN,2012,total,162708,741091724,97314,106545262,6202345,198158,260022,847636986
MN,2012,financial administration,4809,24095969,2273,1614602,93816,5244,7082,25710571
MN,2012,other government administration,4377,20255172,12102,3607151,195741,5298,16479,23862323
MN,2012,judicial and legal,2200,13403116,406,1023112,38972,2415,2606,14426228
MN,2012,police protection total,10516,59337893,1379,1624248,94869,11051,11895,60962141
MN,2012,police protection - officers,8045,48637370,660,682701,38384,8257,8705,49320071
MN,2012,police protection - other,2471,10700523,719,941547,56485,2794,3190,11642070
MN,2012,fire protection total,1956,11860698,6598,1754880,148783,2791,8554,13615578
MN,2012,fire protection - firefighters,1788,10960490,6405,1611154,140165,2573,8193,12571644
MN,2012,fire protection - other,168,900208,193,143726,8618,218,361,1043934
MN,2012,corrections,4566,22582150,558,1010321,54027,4873,5124,23592471
MN,2012,highways,6545,29973642,989,1023431,64255,6868,7534,30997073
MN,2012,air transportation,651,3974707,62,113115,5212,680,713,4087822
MN,2012,water transport and terminals,33,237232,7,8383,421,35,40,245615
MN,2012,public welfare,9889,46259564,1433,3052421,150890,10747,11322,49311985
MN,2012,health,2589,12788693,1918,3370216,151178,3451,4507,16158909
MN,2012,hospitals,3962,18421423,4334,10695446,464350,6627,8296,29116869
MN,2012,social insurance administration,0,0,0,0,0,0,0,0
MN,2012,solid waste management,887,3750596,218,179664,12709,957,1105,3930260
MN,2012,sewerage,1235,5678333,260,226943,14664,1301,1495,5905276
MN,2012,parks and recreation,3443,14889133,5278,3056788,246930,4839,8721,17945921
MN,2012,housing and community development,1807,8754861,478,442783,26186,1958,2285,9197644
MN,2012,natural resources,816,3358506,315,206905,11746,880,1131,3565411
MN,2012,water transport and terminals,1631,7861916,263,203020,13052,1687,1894,8064936
MN,2012,electric power,936,5286901,101,96735,4748,962,1037,5383636
MN,2012,gas supply,135,623143,7,3890,485,137,142,627033
MN,2012,transit,390,1462283,224,279661,19215,499,614,1741944
MN,2012,education total,94422,404799170,52798,68114367,4029583,117931,147220,472913537
MN,2012,education - elementary and secondary total,94422,404799170,52798,68114367,4029583,117931,147220,472913537
MN,2012,education - elementary and secondary instructional,70794,328205244,28880,41956435,2265604,84011,99674,370161679
MN,2012,education - elementary and secondary other,23628,76593926,23918,26157932,1763979,33920,47546,102751858
MN,2012,education - higher education total,0,0,0,0,0,0,0,0
MN,2012,education - higher education instructional,0,0,0,0,0,0,0,0
MN,2012,education - higher education other,0,0,0,0,0,0,0,0
MN,2012,education - other,0,0,0,0,0,0,0,0
MN,2012,libraries,1451,6158237,1994,2541578,171035,2415,3445,8699815
MN,2012,liquor stores,0,0,0,0,0,0,0,0
MN,2012,other and unallocable,3462,15278386,3319,2295602,189478,4512,6781,17573988
MS,2012,total,127072,382732577,21109,26024511,1496788,135574,148181,408757088
MS,2012,financial administration,2412,7374755,237,233208,20775,2528,2649,7607963
MS,2012,other government administration,2156,6610554,1438,822190,47537,2422,3594,7432744
MS,2012,judicial and legal,1996,5740921,614,656839,28916,2152,2610,6397760
MS,2012,police protection total,8046,24244056,1350,1012756,91380,8562,9396,25256812
MS,2012,police protection - officers,6224,19806736,817,635002,57747,6556,7041,20441738
MS,2012,police protection - other,1822,4437320,533,377754,33633,2006,2355,4815074
MS,2012,fire protection total,3425,11536153,638,273755,23749,3555,4063,11809908
MS,2012,fire protection - firefighters,3270,11014683,562,222141,19917,3380,3832,11236824
MS,2012,fire protection - other,155,521470,76,51614,3832,175,231,573084
MS,2012,corrections,2189,5257928,241,165557,14744,2272,2430,5423485
MS,2012,highways,4382,10706086,286,280816,26823,4539,4668,10986902
MS,2012,air transportation,142,449156,42,32327,2998,159,184,481483
MS,2012,water transport and terminals,109,408348,5,4415,318,111,114,412763
MS,2012,public welfare,456,1011928,210,203457,19242,563,666,1215385
MS,2012,health,224,731007,53,67756,3604,246,277,798763
MS,2012,hospitals,16385,67243058,4009,12515765,450887,18931,20394,79758823
MS,2012,social insurance administration,0,0,0,0,0,0,0,0
MS,2012,solid waste management,1013,2190431,117,95995,10850,1073,1130,2286426
MS,2012,sewerage,652,1894584,49,27767,2186,663,701,1922351
MS,2012,parks and recreation,1020,2464248,546,335738,34057,1217,1566,2799986
MS,2012,housing and community development,869,2706837,93,77701,6386,904,962,2784538
MS,2012,natural resources,210,553109,187,191943,13608,291,397,745052
MS,2012,water transport and terminals,1334,3642462,114,91156,7075,1365,1448,3733618
MS,2012,electric power,427,1611364,8,6604,516,430,435,1617968
MS,2012,gas supply,205,587450,17,20025,1406,213,222,607475
MS,2012,transit,116,299352,41,47250,5082,146,157,346602
MS,2012,education total,77236,220535305,9862,8294848,624742,80829,87098,228830153
MS,2012,education - elementary and secondary total,71184,197218201,6582,4657495,426405,73631,77766,201875696
MS,2012,education - elementary and secondary instructional,49739,160245326,3591,2560966,221690,51011,53330,162806292
MS,2012,education - elementary and secondary other,21445,36972875,2991,2096529,204715,22620,24436,39069404
MS,2012,education - higher education total,6052,23317104,3280,3637353,198337,7198,9332,26954457
MS,2012,education - higher education instructional,2591,11898544,1870,2775795,114155,3245,4461,14674339
MS,2012,education - higher education other,3461,11418560,1410,861558,84182,3953,4871,12280118
MS,2012,education - other,0,0,0,0,0,0,0,0
MS,2012,libraries,720,1645310,468,275743,31737,901,1188,1921053
MS,2012,liquor stores,0,0,0,0,0,0,0,0
MS,2012,other and unallocable,1348,3288175,484,290900,28170,1502,1832,3579075
MO,2012,total,209209,738601971,62553,53809354,3648384,230185,271762,792411325
MO,2012,financial administration,3723,12366819,770,519517,41220,3943,4493,12886336
MO,2012,other government administration,3895,14294187,3669,1213129,80845,4306,7564,15507316
MO,2012,judicial and legal,3984,14500466,887,878191,55939,4291,4871,15378657
MO,2012,police protection total,15454,56534549,1311,1014941,86488,15933,16765,57549490
MO,2012,police protection - officers,12042,46216124,789,576203,47337,12304,12831,46792327
MO,2012,police protection - other,3412,10318425,522,438738,39151,3629,3934,10757163
MO,2012,fire protection total,6988,33857573,2373,741540,58834,7305,9361,34599113
MO,2012,fire protection - firefighters,5898,29530631,2090,571553,46407,6150,7988,30102184
MO,2012,fire protection - other,1090,4326942,283,169987,12427,1155,1373,4496929
MO,2012,corrections,3018,8376561,333,286849,24382,3152,3351,8663410
MO,2012,highways,6369,19905857,741,604616,48074,6610,7110,20510473
MO,2012,air transportation,1182,4571658,75,88267,6886,1221,1257,4659925
MO,2012,water transport and terminals,4,24021,2,760,87,4,6,24781
MO,2012,public welfare,2525,5682071,896,790232,77353,2983,3421,6472303
MO,2012,health,3274,12049529,1503,1497468,110925,3899,4777,13546997
MO,2012,hospitals,10889,45347426,3241,6874549,347386,12891,14130,52221975
MO,2012,social insurance administration,0,0,0,0,0,0,0,0
MO,2012,solid waste management,799,2348766,137,144738,13582,873,936,2493504
MO,2012,sewerage,2588,10456123,223,181682,13148,2654,2811,10637805
MO,2012,parks and recreation,2885,9549899,4594,2353950,231957,4194,7479,11903849
MO,2012,housing and community development,1209,4115065,203,194371,14312,1293,1412,4309436
MO,2012,natural resources,414,1123157,121,87865,5617,446,535,1211022
MO,2012,water transport and terminals,3018,10114136,566,440778,33643,3197,3584,10554914
MO,2012,electric power,1360,7804365,34,46017,2945,1378,1394,7850382
MO,2012,gas supply,162,722302,2,1957,190,163,164,724259
MO,2012,transit,2955,13156251,328,600013,35001,3155,3283,13756264
MO,2012,education total,127081,432671980,36980,32385047,2105874,139430,164061,465057027
MO,2012,education - elementary and secondary total,122250,411988354,29236,24886106,1766022,132659,151486,436874460
MO,2012,education - elementary and secondary instructional,85598,325836065,16598,13724703,899535,90916,102196,339560768
MO,2012,education - elementary and secondary other,36652,86152289,12638,11161403,866487,41743,49290,97313692
MO,2012,education - higher education total,4831,20683626,7744,7498941,339852,6771,12575,28182567
MO,2012,education - higher education instructional,1615,8468268,4670,5516298,186970,2683,6285,13984566
MO,2012,education - higher education other,3216,12215358,3074,1982643,152882,4088,6290,14198001
MO,2012,education - other,0,0,0,0,0,0,0,0
MO,2012,libraries,2025,6222626,2836,2221766,201041,3164,4861,8444392
MO,2012,liquor stores,0,0,0,0,0,0,0,0
MO,2012,other and unallocable,3408,12806584,728,641111,52655,3700,4136,13447695
MT,2012,total,30807,115533625,15137,13451441,930921,36109,45944,128985066
MT,2012,financial administration,722,2489084,81,101436,6674,760,803,2590520
MT,2012,other government administration,734,2948359,747,413397,25249,869,1481,3361756
MT,2012,judicial and legal,777,2975694,272,347290,21320,897,1049,3322984
MT,2012,police protection total,2025,8765526,207,205582,14642,2110,2232,8971108
MT,2012,police protection - officers,1501,7193558,87,71665,4868,1530,1588,7265223
MT,2012,police protection - other,524,1571968,120,133917,9774,580,644,1705885
MT,2012,fire protection total,710,3641731,305,102683,7755,746,1015,3744414
MT,2012,fire protection - firefighters,642,3359419,278,85306,6556,674,920,3444725
MT,2012,fire protection - other,68,282312,27,17377,1199,72,95,299689
MT,2012,corrections,653,2081749,59,65324,5509,684,712,2147073
MT,2012,highways,1283,4528897,46,40130,3523,1302,1329,4569027
MT,2012,air transportation,117,529566,45,45828,3050,132,162,575394
MT,2012,water transport and terminals,8,29199,1,243,16,8,9,29442
MT,2012,public welfare,421,1043810,360,406600,30655,594,781,1450410
MT,2012,health,835,3158058,528,768163,38545,1051,1363,3926221
MT,2012,hospitals,809,3118785,310,542174,26495,962,1119,3660959
MT,2012,social insurance administration,0,0,0,0,0,0,0,0
MT,2012,solid waste management,416,1252379,103,92527,7477,458,519,1344906
MT,2012,sewerage,303,1192348,108,45063,2996,315,411,1237411
MT,2012,parks and recreation,312,1113626,486,259248,22907,441,798,1372874
MT,2012,housing and community development,213,809755,26,30866,1770,225,239,840621
MT,2012,natural resources,204,628887,155,127503,9688,255,359,756390
MT,2012,water transport and terminals,473,1697487,156,80658,5290,496,629,1778145
MT,2012,electric power,3,19931,0,0,0,3,3,19931
MT,2012,gas supply,0,0,0,0,0,0,0,0
MT,2012,transit,256,807447,68,136766,9588,311,324,944213
MT,2012,education total,18279,68905475,10333,9009719,633135,21932,28612,77915194
MT,2012,education - elementary and secondary total,17987,67792231,9820,8575093,607727,21496,27807,76367324
MT,2012,education - elementary and secondary instructional,13654,55557342,5225,4531867,324190,15531,18879,60089209
MT,2012,education - elementary and secondary other,4333,12234889,4595,4043226,283537,5965,8928,16278115
MT,2012,education - higher education total,292,1113244,513,434626,25408,436,805,1547870
MT,2012,education - higher education instructional,101,444987,243,250390,7027,141,344,695377
MT,2012,education - higher education other,191,668257,270,184236,18381,295,461,852493
MT,2012,education - other,0,0,0,0,0,0,0,0
MT,2012,libraries,194,647957,341,295015,26861,346,535,942972
MT,2012,liquor stores,0,0,0,0,0,0,0,0
MT,2012,other and unallocable,1060,3147875,400,335226,27776,1212,1460,3483101
NE,2012,total,77381,313474712,30787,27822456,1861152,87984,108168,341297168
NE,2012,financial administration,1506,5353302,367,290739,21732,1621,1873,5644041
NE,2012,other government administration,1439,4689411,2754,736623,46195,1664,4193,5426034
NE,2012,judicial and legal,1157,4812355,198,286056,15722,1243,1355,5098411
NE,2012,police protection total,3977,18788871,470,543953,35468,4169,4447,19332824
NE,2012,police protection - officers,3109,15815318,235,248779,16079,3191,3344,16064097
NE,2012,police protection - other,868,2973553,235,295174,19389,978,1103,3268727
NE,2012,fire protection total,1315,7620056,376,65846,4815,1340,1691,7685902
NE,2012,fire protection - firefighters,1248,7293727,292,46400,3544,1267,1540,7340127
NE,2012,fire protection - other,67,326329,84,19446,1271,73,151,345775
NE,2012,corrections,1455,5122428,172,201050,13892,1531,1627,5323478
NE,2012,highways,2812,9500439,515,491501,37238,3005,3327,9991940
NE,2012,air transportation,277,1036299,89,113243,6923,316,366,1149542
NE,2012,water transport and terminals,0,0,0,0,0,0,0,0
NE,2012,public welfare,1270,3855092,583,722557,38730,1489,1853,4577649
NE,2012,health,431,1987428,332,391357,20395,545,763,2378785
NE,2012,hospitals,4066,16509050,1185,1878338,92775,4603,5251,18387388
NE,2012,social insurance administration,0,0,0,0,0,0,0,0
NE,2012,solid waste management,309,1139792,152,107254,9659,361,461,1247046
NE,2012,sewerage,513,2169131,124,95567,5965,540,637,2264698
NE,2012,parks and recreation,632,2358366,989,594003,56001,945,1621,2952369
NE,2012,housing and community development,597,2062057,416,382854,27690,754,1013,2444911
NE,2012,natural resources,642,2111109,185,90735,7286,682,827,2201844
NE,2012,water transport and terminals,986,4565911,239,173852,13574,1051,1225,4739763
NE,2012,electric power,6678,43910567,290,568302,25834,6828,6968,44478869
NE,2012,gas supply,480,2656561,8,13264,708,484,488,2669825
NE,2012,transit,402,1601177,52,41074,3678,425,454,1642251
NE,2012,education total,44983,166159965,19764,18879910,1279696,52394,64747,185039875
NE,2012,education - elementary and secondary total,42450,154499808,17073,16737147,1141903,49048,59523,171236955
NE,2012,education - elementary and secondary instructional,32505,129468710,11310,11356011,711544,36631,43815,140824721
NE,2012,education - elementary and secondary other,9945,25031098,5763,5381136,430359,12417,15708,30412234
NE,2012,education - higher education total,2533,11660157,2691,2142763,137793,3346,5224,13802920
NE,2012,education - higher education instructional,1021,5570246,1250,1109493,38889,1252,2271,6679739
NE,2012,education - higher education other,1512,6089911,1441,1033270,98904,2094,2953,7123181
NE,2012,education - other,0,0,0,0,0,0,0,0
NE,2012,libraries,412,1459923,930,758149,68018,795,1342,2218072
NE,2012,liquor stores,0,0,0,0,0,0,0,0
NE,2012,other and unallocable,1042,4005422,597,396229,29158,1199,1639,4401651
NV,2012,total,68213,356182667,22688,39413818,2571441,82886,90901,395596485
NV,2012,financial administration,1345,8284461,104,219600,11649,1412,1449,8504061
NV,2012,other government administration,1616,9218824,255,464079,24172,1755,1871,9682903
NV,2012,judicial and legal,2731,16811103,261,588404,28831,2894,2992,17399507
NV,2012,police protection total,6747,43484792,963,708271,41483,6988,7710,44193063
NV,2012,police protection - officers,4571,32506464,17,21946,1150,4577,4588,32528410
NV,2012,police protection - other,2176,10978328,946,686325,40333,2411,3122,11664653
NV,2012,fire protection total,2561,22721558,117,159189,7902,2606,2678,22880747
NV,2012,fire protection - firefighters,2318,20924117,73,110252,4708,2344,2391,21034369
NV,2012,fire protection - other,243,1797441,44,48937,3194,262,287,1846378
NV,2012,corrections,2085,13039578,111,152303,8623,2134,2196,13191881
NV,2012,highways,1052,5973356,33,25867,1604,1060,1085,5999223
NV,2012,air transportation,1356,6477397,45,84428,5157,1385,1401,6561825
NV,2012,water transport and terminals,0,0,0,0,0,0,0,0
NV,2012,public welfare,789,3991712,188,355158,17515,888,977,4346870
NV,2012,health,827,4849143,118,145571,6458,863,945,4994714
NV,2012,hospitals,3953,21422903,657,1833484,54784,4262,4610,23256387
NV,2012,social insurance administration,0,0,0,0,0,0,0,0
NV,2012,solid waste management,91,423509,2,1297,119,91,93,424806
NV,2012,sewerage,856,5138057,32,34795,1309,863,888,5172852
NV,2012,parks and recreation,1413,7191774,2955,2099790,190531,2532,4368,9291564
NV,2012,housing and community development,504,2817215,26,46098,2100,515,530,2863313
NV,2012,natural resources,166,886093,68,72137,3236,182,234,958230
NV,2012,water transport and terminals,2114,14348454,48,60534,2996,2134,2162,14408988
NV,2012,electric power,94,629141,6,17840,564,98,100,646981
NV,2012,gas supply,0,0,0,0,0,0,0,0
NV,2012,transit,236,1462311,10,26807,1186,243,246,1489118
NV,2012,education total,35487,155097646,15883,31277976,2093374,47385,51370,186375622
NV,2012,education - elementary and secondary total,35487,155097646,15883,31277976,2093374,47385,51370,186375622
NV,2012,education - elementary and secondary instructional,26874,123218511,9414,20061719,1368259,34638,36288,143280230
NV,2012,education - elementary and secondary other,8613,31879135,6469,11216257,725115,12747,15082,43095392
NV,2012,education - higher education total,0,0,0,0,0,0,0,0
NV,2012,education - higher education instructional,0,0,0,0,0,0,0,0
NV,2012,education - higher education other,0,0,0,0,0,0,0,0
NV,2012,education - other,0,0,0,0,0,0,0,0
NV,2012,libraries,606,2764743,610,617652,42485,869,1216,3382395
NV,2012,liquor stores,0,0,0,0,0,0,0,0
NV,2012,other and unallocable,1584,9148897,196,422538,25363,1727,1780,9571435
NH,2012,total,45294,181845591,20221,21945173,1422002,53528,65515,203790764
NH,2012,financial administration,819,3515509,572,590482,34807,1021,1391,4105991
NH,2012,other government administration,660,3125006,827,666732,35737,859,1487,3791738
NH,2012,judicial and legal,230,1163913,168,268330,10840,294,398,1432243
NH,2012,police protection total,3039,15493777,889,1044429,61747,3387,3928,16538206
NH,2012,police protection - officers,2368,12872875,514,670525,38227,2582,2882,13543400
NH,2012,police protection - other,671,2620902,375,373904,23520,805,1046,2994806
NH,2012,fire protection total,1640,8789602,1584,727830,57867,1968,3224,9517432
NH,2012,fire protection - firefighters,1536,8282844,1536,678339,54952,1846,3072,8961183
NH,2012,fire protection - other,104,506758,48,49491,2915,122,152,556249
NH,2012,corrections,721,2570246,76,177703,7999,767,797,2747949
NH,2012,highways,1484,6205625,204,276966,17136,1582,1688,6482591
NH,2012,air transportation,84,468336,27,48474,3271,102,111,516810
NH,2012,water transport and terminals,0,0,0,0,0,0,0,0
NH,2012,public welfare,1794,6016502,1299,2084419,129662,2527,3093,8100921
NH,2012,health,197,786146,202,153742,8062,242,399,939888
NH,2012,hospitals,0,0,0,0,0,0,0,0
NH,2012,social insurance administration,0,0,0,0,0,0,0,0
NH,2012,solid waste management,356,1335013,311,302838,25505,502,667,1637851
NH,2012,sewerage,358,1558743,43,43232,2667,371,401,1601975
NH,2012,parks and recreation,283,1186470,503,372024,30549,454,786,1558494
NH,2012,housing and community development,342,1366503,104,117237,7706,391,446,1483740
NH,2012,natural resources,25,87057,22,25637,1481,33,47,112694
NH,2012,water transport and terminals,356,1545816,126,101340,4996,385,482,1647156
NH,2012,electric power,2,10358,5,7018,402,4,7,17376
NH,2012,gas supply,0,0,0,0,0,0,0,0
NH,2012,transit,77,293685,93,94487,7496,119,170,388172
NH,2012,education total,31868,122581501,11052,13344186,864431,36942,42920,135925687
NH,2012,education - elementary and secondary total,31868,122581501,11052,13344186,864431,36942,42920,135925687
NH,2012,education - elementary and secondary instructional,25978,105104723,7905,9870143,607894,29547,33883,114974866
NH,2012,education - elementary and secondary other,5890,17476778,3147,3474043,256537,7395,9037,20950821
NH,2012,education - higher education total,0,0,0,0,0,0,0,0
NH,2012,education - higher education instructional,0,0,0,0,0,0,0,0
NH,2012,education - higher education other,0,0,0,0,0,0,0,0
NH,2012,education - other,0,0,0,0,0,0,0,0
NH,2012,libraries,380,1537503,921,912e3,64464,749,1301,2449503
NH,2012,liquor stores,0,0,0,0,0,0,0,0
NH,2012,other and unallocable,579,2208280,1193,586067,45177,829,1772,2794347
NJ,2012,total,304254,1724074253,94313,103226001,5842886,339322,398567,1827300254
NJ,2012,financial administration,4282,21936957,1124,1818295,69677,4685,5406,23755252
NJ,2012,other government administration,5430,26504887,3604,2964375,129599,6170,9034,29469262
NJ,2012,judicial and legal,6426,35959949,1666,2467197,83134,6901,8092,38427146
NJ,2012,police protection total,26443,205626358,7093,6989037,472903,29211,33536,212615395
NJ,2012,police protection - officers,22284,189042413,1139,1239780,89598,22811,23423,190282193
NJ,2012,police protection - other,4159,16583945,5954,5749257,383305,6400,10113,22333202
NJ,2012,fire protection total,7387,56931975,1909,1469015,85748,7868,9296,58400990
NJ,2012,fire protection - firefighters,6597,53449333,1101,685709,45162,6853,7698,54135042
NJ,2012,fire protection - other,790,3482642,808,783306,40586,1015,1598,4265948
NJ,2012,corrections,6299,41201321,127,175197,7842,6345,6426,41376518
NJ,2012,highways,8189,40263956,462,621483,43358,8440,8651,40885439
NJ,2012,air transportation,17,100540,3,3443,265,18,20,103983
NJ,2012,water transport and terminals,9,38500,1,812,50,9,10,39312
NJ,2012,public welfare,9092,41153869,922,1400312,77566,9549,10014,42554181
NJ,2012,health,3229,15450611,1346,1874556,103412,3830,4575,17325167
NJ,2012,hospitals,2076,9756117,464,1234977,47715,2358,2540,10991094
NJ,2012,social insurance administration,0,0,0,0,0,0,0,0
NJ,2012,solid waste management,4313,19313437,498,558352,40481,4547,4811,19871789
NJ,2012,sewerage,4195,23445901,385,296659,15332,4276,4580,23742560
NJ,2012,parks and recreation,3975,17783352,4430,3342430,253685,5460,8405,21125782
NJ,2012,housing and community development,3096,14422744,726,929404,53025,3404,3822,15352148
NJ,2012,natural resources,427,1914485,30,56452,2511,444,457,1970937
NJ,2012,water transport and terminals,1992,10194487,198,205207,8464,2037,2190,10399694
NJ,2012,electric power,175,1155031,36,44854,2085,187,211,1199885
NJ,2012,gas supply,0,0,0,0,0,0,0,0
NJ,2012,transit,586,2818135,58,90848,4626,615,644,2908983
NJ,2012,education total,195698,1090285779,62745,70368892,3955267,219809,258443,1160654671
NJ,2012,education - elementary and secondary total,188419,1049102456,50470,56511651,3351349,208817,238889,1105614107
NJ,2012,education - elementary and secondary instructional,145161,887761941,28653,33135884,1755246,155947,173814,920897825
NJ,2012,education - elementary and secondary other,43258,161340515,21817,23375767,1596103,52870,65075,184716282
NJ,2012,education - higher education total,7279,41183323,12275,13857241,603918,10992,19554,55040564
NJ,2012,education - higher education instructional,2329,17941483,7808,9201806,304126,4215,10137,27143289
NJ,2012,education - higher education other,4950,23241840,4467,4655435,299792,6777,9417,27897275
NJ,2012,education - other,0,0,0,0,0,0,0,0
NJ,2012,libraries,3426,14077234,3635,3334643,240142,4823,7061,17411877
NJ,2012,liquor stores,0,0,0,0,0,0,0,0
NJ,2012,other and unallocable,7492,33738628,2851,2979561,145999,8336,10343,36718189
NM,2012,total,73241,258893880,15018,13023616,885005,78461,88259,271917496
NM,2012,financial administration,2158,8138170,101,122668,9148,2208,2259,8260838
NM,2012,other government administration,1725,6744307,335,207023,13582,1796,2060,6951330
NM,2012,judicial and legal,427,1683907,107,88898,6591,459,534,1772805
NM,2012,police protection total,5194,25101144,361,301373,23441,5327,5555,25402517
NM,2012,police protection - officers,3879,20304516,20,25620,1306,3887,3899,20330136
NM,2012,police protection - other,1315,4796628,341,275753,22135,1440,1656,5072381
NM,2012,fire protection total,2370,12171320,289,84038,6011,2402,2659,12255358
NM,2012,fire protection - firefighters,2270,11730505,262,72268,5142,2298,2532,11802773
NM,2012,fire protection - other,100,440815,27,11770,869,104,127,452585
NM,2012,corrections,2400,7837166,51,90276,6020,2434,2451,7927442
NM,2012,highways,1926,6722553,38,56422,3283,1944,1964,6778975
NM,2012,air transportation,316,1409244,22,33013,1717,326,338,1442257
NM,2012,water transport and terminals,0,0,0,0,0,0,0,0
NM,2012,public welfare,589,2017903,459,418407,39400,810,1048,2436310
NM,2012,health,665,2345611,56,46418,3677,686,721,2392029
NM,2012,hospitals,947,4168422,331,553025,26078,1098,1278,4721447
NM,2012,social insurance administration,0,0,0,0,0,0,0,0
NM,2012,solid waste management,1241,4158495,65,54760,4867,1270,1306,4213255
NM,2012,sewerage,695,2596337,20,18996,1450,704,715,2615333
NM,2012,parks and recreation,1495,4536088,897,625081,65976,1866,2392,5161169
NM,2012,housing and community development,446,1774553,25,35040,1801,455,471,1809593
NM,2012,natural resources,469,1482456,123,62731,4246,487,592,1545187
NM,2012,water transport and terminals,994,3641307,53,46739,4152,1016,1047,3688046
NM,2012,electric power,233,1184921,0,0,0,233,233,1184921
NM,2012,gas supply,109,385507,4,774,70,109,113,386281
NM,2012,transit,721,2596291,63,93584,7654,764,784,2689875
NM,2012,education total,45807,150753782,11146,9631104,619524,49552,56953,160384886
NM,2012,education - elementary and secondary total,43282,141337885,8178,6475524,470159,46182,51460,147813409
NM,2012,education - elementary and secondary instructional,31916,113542783,4356,3664255,250864,33462,36272,117207038
NM,2012,education - elementary and secondary other,11366,27795102,3822,2811269,219295,12720,15188,30606371
NM,2012,education - higher education total,2525,9415897,2968,3155580,149365,3370,5493,12571477
NM,2012,education - higher education instructional,658,3384086,1552,2102218,54193,964,2210,5486304
NM,2012,education - higher education other,1867,6031811,1416,1053362,95172,2406,3283,7085173
NM,2012,education - other,0,0,0,0,0,0,0,0
NM,2012,libraries,460,1435663,264,275769,20654,574,724,1711432
NM,2012,liquor stores,0,0,0,0,0,0,0,0
NM,2012,other and unallocable,1854,6008733,208,177477,15663,1941,2062,6186210
NY,2012,total,854253,4746196189,196832,245383870,12771000,931631,1051085,4991580059
NY,2012,financial administration,11259,58026189,3205,3995415,203490,12396,14464,62021604
NY,2012,other government administration,11500,53202010,12664,10437439,536808,14560,24164,63639449
NY,2012,judicial and legal,10639,59992299,4266,5722507,237844,11975,14905,65714806
NY,2012,police protection total,75713,542338544,8980,11547426,617634,79277,84693,553885970
NY,2012,police protection - officers,66698,491806075,4941,7042129,321269,68555,71639,498848204
NY,2012,police protection - other,9015,50532469,4039,4505297,296365,10722,13054,55037766
NY,2012,fire protection total,23195,175105437,2381,2443976,121099,23854,25576,177549413
NY,2012,fire protection - firefighters,20654,157865437,667,715250,37790,20868,21321,158580687
NY,2012,fire protection - other,2541,1724e4,1714,1728726,83309,2986,4255,18968726
NY,2012,corrections,22501,143569224,732,1256995,63585,22890,23233,144826219
NY,2012,highways,24063,113874899,1549,1617147,120058,24739,25612,115492046
NY,2012,air transportation,1469,9588018,49,66915,5149,1501,1518,9654933
NY,2012,water transport and terminals,222,1567919,23,29728,1478,231,245,1597647
NY,2012,public welfare,43740,189149944,3390,4666222,279010,45431,47130,193816166
NY,2012,health,15727,80891762,2417,4680831,177264,16739,18144,85572593
NY,2012,hospitals,47959,267369270,3768,10416982,441942,50504,51727,277786252
NY,2012,social insurance administration,0,0,0,0,0,0,0,0
NY,2012,solid waste management,13417,81352502,927,1162161,85585,13902,14344,82514663
NY,2012,sewerage,6028,30797823,349,389890,23978,6164,6377,31187713
NY,2012,parks and recreation,8375,39465946,8155,6800792,565546,11636,16530,46266738
NY,2012,housing and community development,15804,79912355,658,833726,43756,16054,16462,80746081
NY,2012,natural resources,191,904932,59,45726,2974,209,250,950658
NY,2012,water transport and terminals,5981,32343715,574,585704,32031,6147,6555,32929419
NY,2012,electric power,460,2548809,32,29185,1629,468,492,2577994
NY,2012,gas supply,9,40886,2,1800,171,10,11,42686
NY,2012,transit,46939,301877958,588,987170,61672,47296,47527,302865128
NY,2012,education total,442295,2332801356,125901,162864198,8197024,493257,568196,2495665554
NY,2012,education - elementary and secondary total,424722,2231542005,99055,126805433,7127607,468978,523777,2358347438
NY,2012,education - elementary and secondary instructional,312435,1852405724,56437,79354825,4090718,337977,368872,1931760549
NY,2012,education - elementary and secondary other,112287,379136281,42618,47450608,3036889,131001,154905,426586889
NY,2012,education - higher education total,17573,101259351,26846,36058765,1069417,24279,44419,137318116
NY,2012,education - higher education instructional,6911,46491906,16818,26104922,482589,9939,23729,72596828
NY,2012,education - higher education other,10662,54767445,10028,9953843,586828,14340,20690,64721288
NY,2012,education - other,0,0,0,0,0,0,0,0
NY,2012,libraries,6526,28534399,9147,8302721,569560,9979,15673,36837120
NY,2012,liquor stores,0,0,0,0,0,0,0,0
NY,2012,other and unallocable,20241,120939993,7016,6499214,381713,22412,27257,127439207
NC,2012,total,374156,1365965021,104261,96896938,6222216,410100,478417,1462861959
NC,2012,financial administration,6861,27472772,520,633945,39352,7082,7381,28106717
NC,2012,other government administration,5239,20633339,2398,1244735,69064,5612,7637,21878074
NC,2012,judicial and legal,766,3654716,180,203845,12450,835,946,3858561
NC,2012,police protection total,23352,90206038,1750,1670364,119423,24027,25102,91876402
NC,2012,police protection - officers,19549,77822678,1022,1015395,71114,19951,20571,78838073
NC,2012,police protection - other,3803,12383360,728,654969,48309,4076,4531,13038329
NC,2012,fire protection total,8562,33411738,1570,742236,71463,8963,10132,34153974
NC,2012,fire protection - firefighters,8163,31783219,1491,680890,67104,8540,9654,32464109
NC,2012,fire protection - other,399,1628519,79,61346,4359,423,478,1689865
NC,2012,corrections,5062,16613421,325,344966,27139,5216,5387,16958387
NC,2012,highways,3898,12893e3,254,271864,23095,4029,4152,13164864
NC,2012,air transportation,958,3948775,326,306105,22673,1086,1284,4254880
NC,2012,water transport and terminals,0,0,0,0,0,0,0,0
NC,2012,public welfare,15227,49686318,1117,1486204,98722,15792,16344,51172522
NC,2012,health,14455,51963870,2207,2912812,172830,15441,16662,54876682
NC,2012,hospitals,43828,234849904,12703,17624453,898294,48948,56531,252474357
NC,2012,social insurance administration,0,0,0,0,0,0,0,0
NC,2012,solid waste management,4009,11486616,1191,947555,103094,4600,5200,12434171
NC,2012,sewerage,3669,13117279,104,149086,8457,3717,3773,13266365
NC,2012,parks and recreation,3811,13068609,5933,3630534,346661,5790,9744,16699143
NC,2012,housing and community development,2743,9966315,242,266674,19718,2852,2985,10232989
NC,2012,natural resources,553,1771303,120,126379,8582,604,673,1897682
NC,2012,water transport and terminals,5237,18388717,259,239493,15953,5326,5496,18628210
NC,2012,electric power,1401,6773034,44,81614,3783,1422,1445,6854648
NC,2012,gas supply,145,559520,1,2281,164,146,146,561801
NC,2012,transit,1420,4534032,726,906243,81673,1887,2146,5440275
NC,2012,education total,209645,694804019,67872,59367078,3751248,231535,277517,754171097
NC,2012,education - elementary and secondary total,193302,627095711,44759,39104742,2752714,209475,238061,666200453
NC,2012,education - elementary and secondary instructional,147308,520759199,26180,20985684,1313469,155009,173488,541744883
NC,2012,education - elementary and secondary other,45994,106336512,18579,18119058,1439245,54466,64573,124455570
NC,2012,education - higher education total,16343,67708308,23113,20262336,998534,22060,39456,87970644
NC,2012,education - higher education instructional,7325,34413505,16273,14955181,601935,10773,23598,49368686
NC,2012,education - higher education other,9018,33294803,6840,5307155,396599,11287,15858,38601958
NC,2012,education - other,0,0,0,0,0,0,0,0
NC,2012,libraries,2219,7076439,1300,1055984,94654,2762,3519,8132423
NC,2012,liquor stores,0,0,0,0,0,0,0,0
NC,2012,other and unallocable,11096,39085247,3119,2682488,233724,12428,14215,41767735
ND,2012,total,21527,81155253,15940,11132861,766887,25713,37467,92288114
ND,2012,financial administration,701,2506431,1450,286315,22228,794,2151,2792746
ND,2012,other government administration,313,999995,5374,489990,26871,402,5687,1489985
ND,2012,judicial and legal,257,991448,166,133520,5972,285,423,1124968
ND,2012,police protection total,1383,5659994,93,87012,4696,1408,1476,5747006
ND,2012,police protection - officers,1158,4966493,71,65295,2963,1174,1229,5031788
ND,2012,police protection - other,225,693501,22,21717,1733,234,247,715218
ND,2012,fire protection total,350,1615288,267,46549,3309,364,617,1661837
ND,2012,fire protection - firefighters,336,1554694,230,39206,2682,348,566,1593900
ND,2012,fire protection - other,14,60594,37,7343,627,16,51,67937
ND,2012,corrections,475,1606710,83,112652,7343,517,558,1719362
ND,2012,highways,1129,4121332,297,179617,12669,1187,1426,4300949
ND,2012,air transportation,97,418755,30,15001,1239,102,127,433756
ND,2012,water transport and terminals,0,0,0,0,0,0,0,0
ND,2012,public welfare,834,2937131,191,219899,15393,920,1025,3157030
ND,2012,health,437,1720433,448,518149,27050,591,885,2238582
ND,2012,hospitals,6,11433,6,650,104,7,12,12083
ND,2012,social insurance administration,0,0,0,0,0,0,0,0
ND,2012,solid waste management,274,961818,73,60018,4581,299,347,1021836
ND,2012,sewerage,173,652154,66,34667,2449,183,239,686821
ND,2012,parks and recreation,451,1641850,1684,820021,77425,884,2135,2461871
ND,2012,housing and community development,246,903023,129,120392,9090,296,375,1023415
ND,2012,natural resources,156,453329,223,109089,7038,197,379,562418
ND,2012,water transport and terminals,403,1545121,167,103749,7973,444,570,1648870
ND,2012,electric power,117,753006,11,10356,494,118,128,763362
ND,2012,gas supply,0,0,0,0,0,0,0,0
ND,2012,transit,37,126182,21,34391,2208,49,58,160573
ND,2012,education total,13289,50131111,4452,7263631,489167,16051,17741,57394742
ND,2012,education - elementary and secondary total,13289,50131111,4452,7263631,489167,16051,17741,57394742
ND,2012,education - elementary and secondary instructional,10327,40598547,2467,4655941,315104,12101,12794,45254488
ND,2012,education - elementary and secondary other,2962,9532564,1985,2607690,174063,3950,4947,12140254
ND,2012,education - higher education total,0,0,0,0,0,0,0,0
ND,2012,education - higher education instructional,0,0,0,0,0,0,0,0
ND,2012,education - higher education other,0,0,0,0,0,0,0,0
ND,2012,education - other,0,0,0,0,0,0,0,0
ND,2012,libraries,80,282917,167,177314,14911,161,247,460231
ND,2012,liquor stores,0,0,0,0,0,0,0,0
ND,2012,other and unallocable,319,1115792,542,309879,24677,454,861,1425671
OH,2012,total,394559,1621132127,134701,145358919,9363671,449053,529260,1766491046
OH,2012,financial administration,7116,28007236,1773,2436548,142992,7862,8889,30443784
OH,2012,other government administration,7934,27664586,10112,6413303,323786,9737,18046,34077889
OH,2012,judicial and legal,16093,57240006,2427,3695213,182504,17108,18520,60935219
OH,2012,police protection total,26459,131613369,4995,4742672,350065,28443,31454,136356041
OH,2012,police protection - officers,20631,109605395,2587,2685229,200447,21762,23218,112290624
OH,2012,police protection - other,5828,22007974,2408,2057443,149618,6681,8236,24065417
OH,2012,fire protection total,13876,77614122,12354,8924633,697659,17818,26230,86538755
OH,2012,fire protection - firefighters,13203,74932069,11888,8639871,676223,17029,25091,83571940
OH,2012,fire protection - other,673,2682053,466,284762,21436,789,1139,2966815
OH,2012,corrections,7946,27590322,593,742883,50396,8226,8539,28333205
OH,2012,highways,11859,46886049,1517,1811365,142544,12662,13376,48697414
OH,2012,air transportation,1033,4728493,144,143998,11211,1095,1177,4872491
OH,2012,water transport and terminals,46,216736,16,20921,1112,52,62,237657
OH,2012,public welfare,20135,67696217,2975,4316873,260828,21620,23110,72013090
OH,2012,health,13115,49852978,4127,4924170,327743,14986,17242,54777148
OH,2012,hospitals,8476,42065407,3859,11751095,417313,10867,12335,53816502
OH,2012,social insurance administration,0,0,0,0,0,0,0,0
OH,2012,solid waste management,2374,8500746,310,461089,31034,2552,2684,8961835
OH,2012,sewerage,6028,26132056,361,517067,30836,6199,6389,26649123
OH,2012,parks and recreation,5424,21391237,7582,5798937,507109,8289,13006,27190174
OH,2012,housing and community development,4434,16723460,515,471211,29389,4605,4949,17194671
OH,2012,natural resources,828,2825997,151,199266,12490,903,979,3025263
OH,2012,water transport and terminals,6820,27975932,557,634179,43116,7053,7377,28610111
OH,2012,electric power,1303,6385648,33,36024,2463,1316,1336,6421672
OH,2012,gas supply,41,184368,0,0,0,41,41,184368
OH,2012,transit,5484,23729094,741,1046713,80356,5938,6225,24775807
OH,2012,education total,215414,882140765,71000,77770067,5041540,245431,286414,959910832
OH,2012,education - elementary and secondary total,212021,864718626,63924,69770815,4724537,240229,275945,934489441
OH,2012,education - elementary and secondary instructional,146164,681859874,31123,35199985,2088790,158695,177287,717059859
OH,2012,education - elementary and secondary other,65857,182858752,32801,34570830,2635747,81534,98658,217429582
OH,2012,education - higher education total,3393,17422139,7076,7999252,317003,5202,10469,25421391
OH,2012,education - higher education instructional,1228,7275032,4320,5359986,157432,2134,5548,12635018
OH,2012,education - higher education other,2165,10147107,2756,2639266,159571,3068,4921,12786373
OH,2012,education - other,0,0,0,0,0,0,0,0
OH,2012,libraries,5739,19760995,5803,6105137,500273,8669,11542,25866132
OH,2012,liquor stores,0,0,0,0,0,0,0,0
OH,2012,other and unallocable,6582,24206308,2756,2395555,176912,7581,9338,26601863
OK,2012,total,137743,444017008,26401,19386755,1488504,146297,164144,463403763
OK,2012,financial administration,2782,9003283,461,340165,27304,2925,3243,9343448
OK,2012,other government administration,2265,9316782,1407,360782,24189,2370,3672,9677564
OK,2012,judicial and legal,1443,4546107,421,318526,19326,1528,1864,4864633
OK,2012,police protection total,8832,35202763,945,659883,61352,9172,9777,35862646
OK,2012,police protection - officers,6737,29318603,440,319741,29373,6896,7177,29638344
OK,2012,police protection - other,2095,5884160,505,340142,31979,2276,2600,6224302
OK,2012,fire protection total,4258,22478036,1152,169973,14641,4335,5410,22648009
OK,2012,fire protection - firefighters,4130,21981727,1054,151487,13053,4197,5184,22133214
OK,2012,fire protection - other,128,496309,98,18486,1588,138,226,514795
OK,2012,corrections,1827,4390750,122,103595,9832,1885,1949,4494345
OK,2012,highways,5119,15060713,338,322275,27295,5275,5457,15382988
OK,2012,air transportation,296,1144374,33,30184,3016,314,329,1174558
OK,2012,water transport and terminals,15,82589,1,2591,164,16,16,85180
OK,2012,public welfare,117,263729,72,62144,5965,152,189,325873
OK,2012,health,1499,5334578,553,531073,40605,1724,2052,5865651
OK,2012,hospitals,9115,39062328,2291,3764575,194061,10212,11406,42826903
OK,2012,social insurance administration,0,0,0,0,0,0,0,0
OK,2012,solid waste management,1081,3121355,122,106086,11783,1149,1203,3227441
OK,2012,sewerage,1169,3616306,68,58398,5297,1198,1237,3674704
OK,2012,parks and recreation,1275,3929347,762,562608,58628,1608,2037,4491955
OK,2012,housing and community development,1412,4505344,197,195354,16290,1506,1609,4700698
OK,2012,natural resources,206,557479,65,56522,5183,234,271,614001
OK,2012,water transport and terminals,2938,9354543,400,351694,27756,3085,3338,9706237
OK,2012,electric power,432,1652843,9,10007,981,440,441,1662850
OK,2012,gas supply,56,155035,2,4114,190,57,58,159149
OK,2012,transit,207,672247,23,33777,3181,225,230,706024
OK,2012,education total,88223,260484668,15485,10277625,839570,93204,103708,270762293
OK,2012,education - elementary and secondary total,88223,260484668,15485,10277625,839570,93204,103708,270762293
OK,2012,education - elementary and secondary instructional,62218,206010922,9225,5953410,424427,64748,71443,211964332
OK,2012,education - elementary and secondary other,26005,54473746,6260,4324215,415143,28456,32265,58797961
OK,2012,education - higher education total,0,0,0,0,0,0,0,0
OK,2012,education - higher education instructional,0,0,0,0,0,0,0,0
OK,2012,education - higher education other,0,0,0,0,0,0,0,0
OK,2012,education - other,0,0,0,0,0,0,0,0
OK,2012,libraries,1006,3422175,1014,779374,65465,1370,2020,4201549
OK,2012,liquor stores,0,0,0,0,0,0,0,0
OK,2012,other and unallocable,2170,6659634,458,285430,26430,2313,2628,6945064
OR,2012,total,104961,481819010,57264,73476216,3847805,126897,162225,555295226
OR,2012,financial administration,2998,15936864,259,474807,22337,3121,3257,16411671
OR,2012,other government administration,2595,13748614,625,882131,37783,2817,3220,14630745
OR,2012,judicial and legal,1546,7764677,317,602779,22173,1662,1863,8367456
OR,2012,police protection total,7399,43533790,506,855118,39004,7620,7905,44388908
OR,2012,police protection - officers,5240,33067087,148,173463,6816,5278,5388,33240550
OR,2012,police protection - other,2159,10466703,358,681655,32188,2342,2517,11148358
OR,2012,fire protection total,3691,25518119,1608,673099,43350,3919,5299,26191218
OR,2012,fire protection - firefighters,3261,23018725,1349,419061,29653,3420,4610,23437786
OR,2012,fire protection - other,430,2499394,259,254038,13697,499,689,2753432
OR,2012,corrections,3168,15712101,426,551054,28256,3328,3594,16263155
OR,2012,highways,3273,15578746,212,358854,15969,3366,3485,15937600
OR,2012,air transportation,421,2433792,36,51077,3108,437,457,2484869
OR,2012,water transport and terminals,209,1098393,29,34955,2448,223,238,1133348
OR,2012,public welfare,910,3753784,196,281398,16663,1004,1106,4035182
OR,2012,health,3942,17219363,1310,2669683,104838,4533,5252,19889046
OR,2012,hospitals,1772,9175909,739,2048067,73913,2247,2511,11223976
OR,2012,social insurance administration,0,0,0,0,0,0,0,0
OR,2012,solid waste management,446,1792939,111,152004,8714,495,557,1944943
OR,2012,sewerage,1727,8933933,158,226013,9903,1779,1885,9159946
OR,2012,parks and recreation,2067,9184594,4820,3322881,257797,3534,6887,12507475
OR,2012,housing and community development,1034,4645980,116,181359,9345,1086,1150,4827339
OR,2012,natural resources,601,2275195,164,156125,9600,652,765,2431320
OR,2012,water transport and terminals,2030,10322391,260,446584,18572,2131,2290,10768975
OR,2012,electric power,673,5228135,56,129052,4008,696,729,5357187
OR,2012,gas supply,0,0,0,0,0,0,0,0
OR,2012,transit,2822,15079453,414,1043356,54756,3133,3236,16122809
OR,2012,education total,57421,231399079,42821,55411916,2896392,73950,100242,286810995
OR,2012,education - elementary and secondary total,51534,203695809,31778,42090038,2393961,65227,83312,245785847
OR,2012,education - elementary and secondary instructional,36812,158976773,19496,26918380,1471700,45220,56308,185895153
OR,2012,education - elementary and secondary other,14722,44719036,12282,15171658,922261,20007,27004,59890694
OR,2012,education - higher education total,5887,27703270,11043,13321878,502431,8723,16930,41025148
OR,2012,education - higher education instructional,1923,11808976,5781,9253002,208256,3099,7704,21061978
OR,2012,education - higher education other,3964,15894294,5262,4068876,294175,5624,9226,19963170
OR,2012,education - other,0,0,0,0,0,0,0,0
OR,2012,libraries,1061,4502674,1388,1861159,114018,1704,2449,6363833
OR,2012,liquor stores,0,0,0,0,0,0,0,0
OR,2012,other and unallocable,3155,16980485,693,1062745,54858,3460,3848,18043230
PA,2012,total,366246,1637901883,121003,127281514,8626564,416363,487249,1765183397
PA,2012,financial administration,6800,26327188,4164,3194389,205642,7885,10964,29521577
PA,2012,other government administration,8144,31730152,10700,3798005,225240,9300,18844,35528157
PA,2012,judicial and legal,14184,51070444,1484,1813675,98222,14757,15668,52884119
PA,2012,police protection total,22877,131715489,8622,7863487,577083,26174,31499,139578976
PA,2012,police protection - officers,19715,120065398,4166,4363894,334894,21626,23881,124429292
PA,2012,police protection - other,3162,11650091,4456,3499593,242189,4548,7618,15149684
PA,2012,fire protection total,5048,29831710,683,463859,38029,5259,5731,30295569
PA,2012,fire protection - firefighters,4747,28564712,606,394867,33794,4937,5353,28959579
PA,2012,fire protection - other,301,1266998,77,68992,4235,322,378,1335990
PA,2012,corrections,12674,51313853,895,1206529,80930,13155,13569,52520382
PA,2012,highways,9559,36587380,2707,2383534,191056,10618,12266,38970914
PA,2012,air transportation,1535,6323373,180,156584,13598,1610,1715,6479957
PA,2012,water transport and terminals,86,545545,19,10106,631,90,105,555651
PA,2012,public welfare,16742,57125487,2513,3545965,236754,18135,19255,60671452
PA,2012,health,5680,22468216,539,754808,32751,5865,6219,23223024
PA,2012,hospitals,79,423567,49,149622,4970,107,128,573189
PA,2012,social insurance administration,0,0,0,0,0,0,0,0
PA,2012,solid waste management,2894,10316687,445,448028,37479,3107,3339,10764715
PA,2012,sewerage,6007,25966732,1392,913414,58921,6326,7399,26880146
PA,2012,parks and recreation,2357,9544218,2731,1688687,148354,3204,5088,11232905
PA,2012,housing and community development,4863,19897700,305,349576,29577,5042,5168,20247276
PA,2012,natural resources,391,1320269,30,38183,2470,405,421,1358452
PA,2012,water transport and terminals,4974,21689303,878,592617,40337,5196,5852,22281920
PA,2012,electric power,115,554941,27,14455,796,120,142,569396
PA,2012,gas supply,1664,8348539,11,17489,569,1667,1675,8366028
PA,2012,transit,11682,66671468,579,766040,56796,12007,12261,67437508
PA,2012,education total,221408,1003867723,78809,94352937,6332541,258644,300217,1098220660
PA,2012,education - elementary and secondary total,214864,971460695,66662,78343292,5563671,247639,281526,1049803987
PA,2012,education - elementary and secondary instructional,160996,796028018,33455,38265452,2597370,176367,194451,834293470
PA,2012,education - elementary and secondary other,53868,175432677,33207,40077840,2966301,71272,87075,215510517
PA,2012,education - higher education total,6544,32407028,12147,16009645,768870,11005,18691,48416673
PA,2012,education - higher education instructional,2480,14729423,8543,12937689,522937,5523,11023,27667112
PA,2012,education - higher education other,4064,17677605,3604,3071956,245933,5482,7668,20749561
PA,2012,education - other,0,0,0,0,0,0,0,0
PA,2012,libraries,1233,4604172,1105,971305,77205,1678,2338,5575477
PA,2012,liquor stores,0,0,0,0,0,0,0,0
PA,2012,other and unallocable,5250,19657727,2136,1788220,136613,6012,7386,21445947
RI,2012,total,27475,141872921,6652,6821957,405598,29984,34127,148694878
RI,2012,financial administration,557,2315024,80,73261,6001,590,637,2388285
RI,2012,other government administration,556,2359867,286,111677,5026,586,842,2471544
RI,2012,judicial and legal,72,316323,51,58645,1701,80,123,374968
RI,2012,police protection total,2621,14535425,352,307281,17850,2722,2973,14842706
RI,2012,police protection - officers,2158,12848586,16,17752,854,2163,2174,12866338
RI,2012,police protection - other,463,1686839,336,289529,16996,559,799,1976368
RI,2012,fire protection total,2034,11775119,340,203203,15104,2119,2374,11978322
RI,2012,fire protection - firefighters,1936,11347427,291,153104,11893,2002,2227,11500531
RI,2012,fire protection - other,98,427692,49,50099,3211,117,147,477791
RI,2012,corrections,0,0,0,0,0,0,0,0
RI,2012,highways,755,3021731,25,41991,2823,771,780,3063722
RI,2012,air transportation,0,0,0,0,0,0,0,0
RI,2012,water transport and terminals,2,5538,3,5199,288,3,5,10737
RI,2012,public welfare,74,268160,95,87816,6641,111,169,355976
RI,2012,health,69,302572,19,28316,1427,78,88,330888
RI,2012,hospitals,0,0,0,0,0,0,0,0
RI,2012,social insurance administration,0,0,0,0,0,0,0,0
RI,2012,solid waste management,109,420721,5,9628,594,114,114,430349
RI,2012,sewerage,190,796456,6,8443,468,192,196,804899
RI,2012,parks and recreation,321,1252735,320,201523,16022,413,641,1454258
RI,2012,housing and community development,648,2749594,122,178996,11860,718,770,2928590
RI,2012,natural resources,12,48510,4,2045,113,13,16,50555
RI,2012,water transport and terminals,562,2523764,20,24712,1281,570,582,2548476
RI,2012,electric power,18,92854,0,0,0,18,18,92854
RI,2012,gas supply,0,0,0,0,0,0,0,0
RI,2012,transit,0,0,0,0,0,0,0,0
RI,2012,education total,18187,96437118,4338,4999446,282071,19989,22525,101436564
RI,2012,education - elementary and secondary total,18187,96437118,4338,4999446,282071,19989,22525,101436564
RI,2012,education - elementary and secondary instructional,14917,85305134,2846,3380069,180335,16075,17763,88685203
RI,2012,education - elementary and secondary other,3270,11131984,1492,1619377,101736,3914,4762,12751361
RI,2012,education - higher education total,0,0,0,0,0,0,0,0
RI,2012,education - higher education instructional,0,0,0,0,0,0,0,0
RI,2012,education - higher education other,0,0,0,0,0,0,0,0
RI,2012,education - other,0,0,0,0,0,0,0,0
RI,2012,libraries,258,972856,385,337748,25002,403,643,1310604
RI,2012,liquor stores,0,0,0,0,0,0,0,0
RI,2012,other and unallocable,430,1678554,201,142027,11326,494,631,1820581
SC,2012,total,167291,588258740,28632,31287927,2037562,179136,195923,619546667
SC,2012,financial administration,3223,11346776,238,221428,16175,3315,3461,11568204
SC,2012,other government administration,2570,9086564,1207,610285,38799,2780,3777,9696849
SC,2012,judicial and legal,3536,12131339,573,703973,44725,3784,4109,12835312
SC,2012,police protection total,11549,39533628,820,785807,59895,11901,12369,40319435
SC,2012,police protection - officers,9609,33723621,344,398600,28223,9774,9953,34122221
SC,2012,police protection - other,1940,5810007,476,387207,31672,2127,2416,6197214
SC,2012,fire protection total,5317,18370739,686,352686,31401,5495,6003,18723425
SC,2012,fire protection - firefighters,4843,16598217,657,318453,29142,5009,5500,16916670
SC,2012,fire protection - other,474,1772522,29,34233,2259,486,503,1806755
SC,2012,corrections,3374,9590348,78,100266,7977,3422,3452,9690614
SC,2012,highways,2582,7593072,167,154950,13475,2654,2749,7748022
SC,2012,air transportation,475,1885595,68,82691,6559,513,543,1968286
SC,2012,water transport and terminals,6,15436,0,0,0,6,6,15436
SC,2012,public welfare,398,1056154,80,79275,7250,440,478,1135429
SC,2012,health,2198,7647658,450,544245,39626,2429,2648,8191903
SC,2012,hospitals,19529,98644464,5326,11104332,455455,22154,24855,109748796
SC,2012,social insurance administration,0,0,0,0,0,0,0,0
SC,2012,solid waste management,2180,5575783,979,903680,95227,2727,3159,6479463
SC,2012,sewerage,2140,7579435,36,42891,2801,2156,2176,7622326
SC,2012,parks and recreation,2521,7710127,2541,1852476,182254,3566,5062,9562603
SC,2012,housing and community development,1116,3867891,106,113963,9387,1172,1222,3981854
SC,2012,natural resources,171,536718,30,29060,2596,189,201,565778
SC,2012,water transport and terminals,2824,10393343,102,82467,6079,2857,2926,10475810
SC,2012,electric power,269,1234860,1,2126,217,270,270,1236986
SC,2012,gas supply,354,1488395,9,14382,1031,359,363,1502777
SC,2012,transit,442,1156515,155,188562,14791,526,597,1345077
SC,2012,education total,96272,318815038,13691,12198105,903390,101613,109963,331013143
SC,2012,education - elementary and secondary total,96272,318815038,13691,12198105,903390,101613,109963,331013143
SC,2012,education - elementary and secondary instructional,68167,253252721,9104,7655099,539818,71375,77271,260907820
SC,2012,education - elementary and secondary other,28105,65562317,4587,4543006,363572,30238,32692,70105323
SC,2012,education - higher education total,0,0,0,0,0,0,0,0
SC,2012,education - higher education instructional,0,0,0,0,0,0,0,0
SC,2012,education - higher education other,0,0,0,0,0,0,0,0
SC,2012,education - other,0,0,0,0,0,0,0,0
SC,2012,libraries,1346,3982740,932,774423,70368,1754,2278,4757163
SC,2012,liquor stores,0,0,0,0,0,0,0,0
SC,2012,other and unallocable,2899,9016122,357,345854,28084,3054,3256,9361976
SD,2012,total,27136,88304369,15511,8638599,636071,30639,42647,96942968
SD,2012,financial administration,932,3046395,883,281535,21498,1031,1815,3327930
SD,2012,other government administration,459,1447422,4347,612747,32592,588,4806,2060169
SD,2012,judicial and legal,279,1181767,66,114322,5459,307,345,1296089
SD,2012,police protection total,1543,5836648,240,208177,14856,1624,1783,6044825
SD,2012,police protection - officers,1287,5023092,100,108758,7426,1327,1387,5131850
SD,2012,police protection - other,256,813556,140,99419,7430,297,396,912975
SD,2012,fire protection total,437,1717298,68,11402,757,439,505,1728700
SD,2012,fire protection - firefighters,424,1659553,44,9889,622,426,468,1669442
SD,2012,fire protection - other,13,57745,24,1513,135,13,37,59258
SD,2012,corrections,623,2076212,125,100886,8238,669,748,2177098
SD,2012,highways,1367,4314340,279,180288,14868,1446,1646,4494628
SD,2012,air transportation,61,188184,33,26461,1395,69,94,214645
SD,2012,water transport and terminals,0,0,0,0,0,0,0,0
SD,2012,public welfare,174,530432,170,183550,12856,246,344,713982
SD,2012,health,219,838512,405,273104,18215,321,624,1111616
SD,2012,hospitals,334,1249078,182,344335,15980,427,516,1593413
SD,2012,social insurance administration,0,0,0,0,0,0,0,0
SD,2012,solid waste management,214,641838,128,72101,6385,243,342,713939
SD,2012,sewerage,239,976746,116,42594,2702,248,355,1019340
SD,2012,parks and recreation,343,1255237,1058,443874,42012,581,1401,1699111
SD,2012,housing and community development,131,436910,75,57276,4347,156,206,494186
SD,2012,natural resources,187,500417,200,92549,6710,222,387,592966
SD,2012,water transport and terminals,327,1256752,108,45502,3511,341,435,1302254
SD,2012,electric power,153,772434,17,14160,863,157,170,786594
SD,2012,gas supply,14,78795,4,2741,172,15,18,81536
SD,2012,transit,24,66362,41,31955,2919,41,65,98317
SD,2012,education total,17947,56763031,6165,5077464,380839,20123,24112,61840495
SD,2012,education - elementary and secondary total,17599,55297500,5941,4854166,367997,19702,23540,60151666
SD,2012,education - elementary and secondary instructional,13326,44634362,3651,3222410,237589,14679,16977,47856772
SD,2012,education - elementary and secondary other,4273,10663138,2290,1631756,130408,5023,6563,12294894
SD,2012,education - higher education total,348,1465531,224,223298,12842,421,572,1688829
SD,2012,education - higher education instructional,157,726311,120,174059,7477,200,277,900370
SD,2012,education - higher education other,191,739220,104,49239,5365,221,295,788459
SD,2012,education - other,0,0,0,0,0,0,0,0
SD,2012,libraries,213,687650,307,182804,17388,314,520,870454
SD,2012,liquor stores,0,0,0,0,0,0,0,0
SD,2012,other and unallocable,916,2441909,494,238772,21509,1031,1410,2680681
TN,2012,total,226281,759617526,43157,42140988,3020135,244072,269438,801758514
TN,2012,financial administration,4150,15106554,496,620610,47864,4420,4646,15727164
TN,2012,other government administration,4060,13530317,2883,1690691,97239,4603,6943,15221008
TN,2012,judicial and legal,4436,16356616,740,848136,52984,4738,5176,17204752
TN,2012,police protection total,17825,65619742,1727,2005338,145490,18666,19552,67625080
TN,2012,police protection - officers,14705,56426443,561,556014,43797,14951,15266,56982457
TN,2012,police protection - other,3120,9193299,1166,1449324,101693,3715,4286,10642623
TN,2012,fire protection total,7571,31495370,1092,288375,26194,7713,8663,31783745
TN,2012,fire protection - firefighters,7259,30370978,1027,265769,24361,7389,8286,30636747
TN,2012,fire protection - other,312,1124392,65,22606,1833,324,377,1146998
TN,2012,corrections,4949,14154628,305,341564,26962,5100,5254,14496192
TN,2012,highways,6580,19021158,275,319309,28564,6748,6855,19340467
TN,2012,air transportation,857,3915160,131,175842,13427,936,988,4091002
TN,2012,water transport and terminals,7,35223,1,507,15,7,8,35730
TN,2012,public welfare,1654,4575571,337,344774,30126,1833,1991,4920345
TN,2012,health,3805,12312439,952,1359869,91931,4337,4757,13672308
TN,2012,hospitals,18349,77169361,3361,7574464,372297,20514,21710,84743825
TN,2012,social insurance administration,0,0,0,0,0,0,0,0
TN,2012,solid waste management,2897,7921472,1092,1200434,113127,3551,3989,9121906
TN,2012,sewerage,2300,8188847,83,138530,9775,2358,2383,8327377
TN,2012,parks and recreation,2433,7484467,3140,3015621,261241,3955,5573,10500088
TN,2012,housing and community development,1926,7107836,128,174444,13375,2007,2054,7282280
TN,2012,natural resources,266,715344,87,70629,6705,305,353,785973
TN,2012,water transport and terminals,4777,17803118,437,403149,27776,4934,5214,18206267
TN,2012,electric power,5814,30380037,129,172901,13034,5892,5943,30552938
TN,2012,gas supply,2022,8771805,68,61309,3637,2044,2090,8833114
TN,2012,transit,879,3313590,203,240845,19800,992,1082,3554435
TN,2012,education total,124041,379758432,23622,19266493,1464060,132835,147663,399024925
TN,2012,education - elementary and secondary total,124041,379758432,23622,19266493,1464060,132835,147663,399024925
TN,2012,education - elementary and secondary instructional,89290,305542780,14456,11965094,826666,94188,103746,317507874
TN,2012,education - elementary and secondary other,34751,74215652,9166,7301399,637394,38647,43917,81517051
TN,2012,education - higher education total,0,0,0,0,0,0,0,0
TN,2012,education - higher education instructional,0,0,0,0,0,0,0,0
TN,2012,education - higher education other,0,0,0,0,0,0,0,0
TN,2012,education - other,0,0,0,0,0,0,0,0
TN,2012,libraries,1145,3291717,700,560392,54545,1462,1845,3852109
TN,2012,liquor stores,0,0,0,0,0,0,0,0
TN,2012,other and unallocable,3538,11588722,1168,1266762,99967,4122,4706,12855484
TX,2012,total,1039139,3829258719,181833,164918077,11381137,1104176,1220972,3994176796
TX,2012,financial administration,15800,64486860,676,774105,58573,16137,16476,65260965
TX,2012,other government administration,12901,54102427,2623,1767612,131419,13628,15524,55870039
TX,2012,judicial and legal,20285,85094402,2351,2505400,133535,21024,22636,87599802
TX,2012,police protection total,65091,306531580,3756,3188708,253288,66519,68847,309720288
TX,2012,police protection - officers,49676,252274632,1121,1524943,103065,50254,50797,253799575
TX,2012,police protection - other,15415,54256948,2635,1663765,150223,16265,18050,55920713
TX,2012,fire protection total,25511,138922223,2023,1330452,100490,26071,27534,140252675
TX,2012,fire protection - firefighters,23868,132122187,1818,1174644,90296,24374,25686,133296831
TX,2012,fire protection - other,1643,6800036,205,155808,10194,1697,1848,6955844
TX,2012,corrections,28116,93955717,919,1071454,85113,28593,29035,95027171
TX,2012,highways,19763,64982271,821,948887,89226,20272,20584,65931158
TX,2012,air transportation,5103,21619895,130,164604,13160,5177,5233,21784499
TX,2012,water transport and terminals,1111,6170527,29,25092,1323,1118,1140,6195619
TX,2012,public welfare,3683,11338403,494,474142,40529,3916,4177,11812545
TX,2012,health,22836,78824605,3008,4409383,271501,24378,25844,83233988
TX,2012,hospitals,46723,215479788,7704,15104907,703774,50731,54427,230584695
TX,2012,social insurance administration,0,0,0,0,0,0,0,0
TX,2012,solid waste management,6199,18631567,338,309379,29386,6364,6537,18940946
TX,2012,sewerage,7641,27878317,566,336242,22681,7754,8207,28214559
TX,2012,parks and recreation,12980,38945441,6643,5036251,488603,15742,19623,43981692
TX,2012,housing and community development,5804,19979799,652,772980,52360,6105,6456,20752779
TX,2012,natural resources,3409,11229333,692,549794,44742,3652,4101,11779127
TX,2012,water transport and terminals,15647,56981011,1183,790962,55266,15931,16830,57771973
TX,2012,electric power,8796,51295423,122,248241,11418,8861,8918,51543664
TX,2012,gas supply,663,2919081,11,14499,1379,672,674,2933580
TX,2012,transit,10650,44464355,1054,1703982,113782,11297,11704,46168337
TX,2012,education total,678614,2336247630,140786,119205283,8314034,726364,819400,2455452913
TX,2012,education - elementary and secondary total,646557,2196841959,100261,81783077,6363642,683234,746818,2278625036
TX,2012,education - elementary and secondary instructional,448294,1713340310,56275,42966636,3233718,466917,504569,1756306946
TX,2012,education - elementary and secondary other,198263,483501649,43986,38816441,3129924,216317,242249,522318090
TX,2012,education - higher education total,32057,139405671,40525,37422206,1950392,43130,72582,176827877
TX,2012,education - higher education instructional,11439,64654358,23414,27053294,940140,16771,34853,91707652
TX,2012,education - higher education other,20618,74751313,17111,10368912,1010252,26359,37729,85120225
TX,2012,education - other,0,0,0,0,0,0,0,0
TX,2012,libraries,5135,16783790,2368,2253247,203935,6286,7503,19037037
TX,2012,liquor stores,0,0,0,0,0,0,0,0
TX,2012,other and unallocable,16678,62394274,2884,1932471,161620,17584,19562,64326745
UT,2012,total,72114,273776245,48087,39634324,2917980,88782,120201,313410569
UT,2012,financial administration,1559,6961183,376,452470,30970,1731,1935,7413653
UT,2012,other government administration,1787,8313744,1571,961053,51271,2070,3358,9274797
UT,2012,judicial and legal,1228,5635836,333,468816,24671,1366,1561,6104652
UT,2012,police protection total,4959,20936474,1705,1375228,118740,5626,6664,22311702
UT,2012,police protection - officers,3850,17212936,215,144597,9743,3902,4065,17357533
UT,2012,police protection - other,1109,3723538,1490,1230631,108997,1724,2599,4954169
UT,2012,fire protection total,2115,10655361,1336,826175,64447,2478,3451,11481536
UT,2012,fire protection - firefighters,1926,9743384,1224,750874,58186,2252,3150,10494258
UT,2012,fire protection - other,189,911977,112,75301,6261,226,301,987278
UT,2012,corrections,2100,7913362,116,135647,7791,2144,2216,8049009
UT,2012,highways,1500,5776315,188,211202,16390,1592,1688,5987517
UT,2012,air transportation,529,2514321,40,46480,3517,550,569,2560801
UT,2012,water transport and terminals,0,0,0,0,0,0,0,0
UT,2012,public welfare,445,1417211,469,445549,37508,656,914,1862760
UT,2012,health,2669,10378833,1613,1837664,120761,3353,4282,12216497
UT,2012,hospitals,384,1596531,204,297305,16217,476,588,1893836
UT,2012,social insurance administration,0,0,0,0,0,0,0,0
UT,2012,solid waste management,577,1990193,88,105052,8263,624,665,2095245
UT,2012,sewerage,1061,4633770,136,163264,9424,1112,1197,4797034
UT,2012,parks and recreation,1529,5498471,5571,3038918,305098,3254,7100,8537389
UT,2012,housing and community development,517,2063163,96,92827,7002,556,613,2155990
UT,2012,natural resources,142,565530,76,47161,3522,159,218,612691
UT,2012,water transport and terminals,1541,6606775,229,199424,12059,1601,1770,6806199
UT,2012,electric power,543,2995537,57,52469,3792,564,600,3048006
UT,2012,gas supply,6,25914,1,180,12,6,7,26094
UT,2012,transit,1985,8159674,305,415377,25944,2134,2290,8575051
UT,2012,education total,42598,150142490,31456,26608049,1901343,53540,74054,176750539
UT,2012,education - elementary and secondary total,42598,150142490,31456,26608049,1901343,53540,74054,176750539
UT,2012,education - elementary and secondary instructional,32170,122027121,15483,14688599,877207,37218,47653,136715720
UT,2012,education - elementary and secondary other,10428,28115369,15973,11919450,1024136,16322,26401,40034819
UT,2012,education - higher education total,0,0,0,0,0,0,0,0
UT,2012,education - higher education instructional,0,0,0,0,0,0,0,0
UT,2012,education - higher education other,0,0,0,0,0,0,0,0
UT,2012,education - other,0,0,0,0,0,0,0,0
UT,2012,libraries,709,2374967,1230,1138350,95910,1253,1939,3513317
UT,2012,liquor stores,0,0,0,0,0,0,0,0
UT,2012,other and unallocable,1631,6620590,891,715664,53328,1937,2522,7336254
VT,2012,total,22225,84622483,12528,12326006,775328,26716,34753,96948489
VT,2012,financial administration,357,1346722,579,547595,31742,531,936,1894317
VT,2012,other government administration,460,1788736,970,536036,32274,640,1430,2324772
VT,2012,judicial and legal,25,101611,20,25685,1162,31,45,127296
VT,2012,police protection total,838,3899093,229,218102,12741,910,1067,4117195
VT,2012,police protection - officers,656,3205727,131,149779,8825,707,787,3355506
VT,2012,police protection - other,182,693366,98,68323,3916,203,280,761689
VT,2012,fire protection total,274,1384463,558,132729,12244,342,832,1517192
VT,2012,fire protection - firefighters,264,1349829,549,129538,12084,331,813,1479367
VT,2012,fire protection - other,10,34634,9,3191,160,11,19,37825
VT,2012,corrections,2,7706,0,0,0,2,2,7706
VT,2012,highways,1036,3998621,132,126498,8832,1082,1168,4125119
VT,2012,air transportation,32,188994,33,55e3,3807,54,65,243994
VT,2012,water transport and terminals,0,0,0,0,0,0,0,0
VT,2012,public welfare,1,3826,15,7849,675,5,16,11675
VT,2012,health,31,109738,117,68245,4205,52,148,177983
VT,2012,hospitals,0,0,0,0,0,0,0,0
VT,2012,social insurance administration,0,0,0,0,0,0,0,0
VT,2012,solid waste management,121,445144,197,134514,10120,176,318,579658
VT,2012,sewerage,184,768372,39,38364,2594,198,223,806736
VT,2012,parks and recreation,123,510084,196,107399,7846,167,319,617483
VT,2012,housing and community development,164,601303,30,38452,2382,179,194,639755
VT,2012,natural resources,7,22797,15,15149,959,12,22,37946
VT,2012,water transport and terminals,191,822323,120,58423,3325,208,311,880746
VT,2012,electric power,215,1259222,2,1578,101,215,217,1260800
VT,2012,gas supply,0,0,0,0,0,0,0,0
VT,2012,transit,195,735669,84,157715,10569,255,279,893384
VT,2012,education total,17728,65690688,8576,9637161,599672,21251,26304,75327849
VT,2012,education - elementary and secondary total,17725,65676782,8573,9633659,599544,21248,26298,75310441
VT,2012,education - elementary and secondary instructional,14172,54947057,5936,6894443,416460,16616,20108,61841500
VT,2012,education - elementary and secondary other,3553,10729725,2637,2739216,183084,4632,6190,13468941
VT,2012,education - higher education total,3,13906,3,3502,128,3,6,17408
VT,2012,education - higher education instructional,3,13906,2,2010,62,3,5,15916
VT,2012,education - higher education other,0,0,1,1492,66,0,1,1492
VT,2012,education - other,0,0,0,0,0,0,0,0
VT,2012,libraries,86,315910,244,226382,16370,176,330,542292
VT,2012,liquor stores,0,0,0,0,0,0,0,0
VT,2012,other and unallocable,155,621461,372,193130,13708,230,527,814591
VA,2012,total,297716,1154221977,77634,75597830,4729810,325844,375350,1229819807
VA,2012,financial administration,7153,33016342,555,860096,52151,7448,7708,33876438
VA,2012,other government administration,4382,21133993,1960,1549224,66123,4755,6342,22683217
VA,2012,judicial and legal,4634,20806534,685,1158188,57752,4958,5319,21964722
VA,2012,police protection total,18119,81853961,1298,1788185,107446,18737,19417,83642146
VA,2012,police protection - officers,14667,69462176,380,562994,32972,14856,15047,70025170
VA,2012,police protection - other,3452,12391785,918,1225191,74474,3881,4370,13616976
VA,2012,fire protection total,10163,52030131,641,776572,44930,10418,10804,52806703
VA,2012,fire protection - firefighters,9312,47708839,446,423183,28875,9475,9758,48132022
VA,2012,fire protection - other,851,4321292,195,353389,16055,943,1046,4674681
VA,2012,corrections,10622,38389702,466,687184,38670,10847,11088,39076886
VA,2012,highways,4006,15336925,288,538622,27800,4166,4294,15875547
VA,2012,air transportation,2019,10967309,265,268642,22858,2147,2284,11235951
VA,2012,water transport and terminals,1,2635,1,204,27,1,2,2839
VA,2012,public welfare,8294,31097307,1201,1751595,104823,8893,9495,32848902
VA,2012,health,5106,22246215,1838,3688498,181193,6137,6944,25934713
VA,2012,hospitals,1819,8110999,693,1388406,88270,2317,2512,9499405
VA,2012,social insurance administration,0,0,0,0,0,0,0,0
VA,2012,solid waste management,3240,10351263,1082,945709,101306,3815,4322,11296972
VA,2012,sewerage,4330,17520750,233,360138,23665,4458,4563,17880888
VA,2012,parks and recreation,4954,17876110,8359,7113729,574671,8222,13313,24989839
VA,2012,housing and community development,1915,8139541,144,186935,12875,1989,2059,8326476
VA,2012,natural resources,447,1476772,80,113462,7197,493,527,1590234
VA,2012,water transport and terminals,3696,14587456,226,269480,18030,3801,3922,14856936
VA,2012,electric power,360,1651726,3,3964,341,362,363,1655690
VA,2012,gas supply,458,1690832,2,1824,160,459,460,1692656
VA,2012,transit,1006,3741981,855,1589232,104736,1602,1861,5331213
VA,2012,education total,189888,697215110,51910,45206009,2708624,206510,241798,742421119
VA,2012,education - elementary and secondary total,188497,689291800,51683,44898623,2694064,205037,240180,734190423
VA,2012,education - elementary and secondary instructional,136693,562842538,32397,26982198,1464575,145657,169090,589824736
VA,2012,education - elementary and secondary other,51804,126449262,19286,17916425,1229489,59380,71090,144365687
VA,2012,education - higher education total,1391,7923310,227,307386,14560,1473,1618,8230696
VA,2012,education - higher education instructional,548,4388131,76,131761,3581,568,624,4519892
VA,2012,education - higher education other,843,3535179,151,175625,10979,905,994,3710804
VA,2012,education - other,0,0,0,0,0,0,0,0
VA,2012,libraries,2364,8982511,2664,2940451,212391,3583,5028,11922962
VA,2012,liquor stores,0,0,0,0,0,0,0,0
VA,2012,other and unallocable,8740,35995872,2185,2411481,173771,9726,10925,38407353
WA,2012,total,178170,1015846698,82455,169841786,8209610,224561,260625,1185688484
WA,2012,financial administration,5192,29465828,369,853295,34739,5384,5561,30319123
WA,2012,other government administration,3636,20728306,1526,1477910,62370,3981,5162,22206216
WA,2012,judicial and legal,5695,32290444,667,1407227,48886,5972,6362,33697671
WA,2012,police protection total,11786,83284263,339,454496,25024,11921,12125,83738759
WA,2012,police protection - officers,9144,69538884,126,108397,6992,9179,9270,69647281
WA,2012,police protection - other,2642,13745379,213,346099,18032,2742,2855,14091478
WA,2012,fire protection total,8396,64813358,4455,1739830,130802,9118,12851,66553188
WA,2012,fire protection - firefighters,7617,60004463,3717,1278300,105423,8202,11334,61282763
WA,2012,fire protection - other,779,4808895,738,461530,25379,916,1517,5270425
WA,2012,corrections,4657,25264322,208,333619,16518,4749,4865,25597941
WA,2012,highways,6630,35901822,212,461176,23006,6760,6842,36362998
WA,2012,air transportation,1146,7578101,100,145108,11139,1209,1246,7723209
WA,2012,water transport and terminals,1644,10340931,171,239462,12493,1715,1815,10580393
WA,2012,public welfare,1231,6079249,253,435072,21853,1354,1484,6514321
WA,2012,health,3404,18899326,795,2064481,73885,3826,4199,20963807
WA,2012,hospitals,11181,62743306,7657,28704958,916045,16393,18838,91448264
WA,2012,social insurance administration,0,0,0,0,0,0,0,0
WA,2012,solid waste management,1905,10423782,147,288725,15516,1991,2052,10712507
WA,2012,sewerage,3418,20484191,194,367564,16429,3506,3612,20851755
WA,2012,parks and recreation,3661,18498934,4629,3936840,277414,5224,8290,22435774
WA,2012,housing and community development,2570,12683615,262,477398,23242,2700,2832,13161013
WA,2012,natural resources,1314,6926479,327,316488,15701,1396,1641,7242967
WA,2012,water transport and terminals,3518,19980463,436,515820,21339,3634,3954,20496283
WA,2012,electric power,8014,60258104,275,773769,30618,8187,8289,61031873
WA,2012,gas supply,19,106887,0,0,0,19,19,106887
WA,2012,transit,8133,44845495,1555,4003896,179346,9153,9688,48849391
WA,2012,education total,73782,386026931,53935,115168124,5935301,107322,127717,501195055
WA,2012,education - elementary and secondary total,73782,386026931,53935,115168124,5935301,107322,127717,501195055
WA,2012,education - elementary and secondary instructional,58475,316575597,29238,63757486,3168377,76373,87713,380333083
WA,2012,education - elementary and secondary other,15307,69451334,24697,51410638,2766924,30949,40004,120861972
WA,2012,education - higher education total,0,0,0,0,0,0,0,0
WA,2012,education - higher education instructional,0,0,0,0,0,0,0,0
WA,2012,education - higher education other,0,0,0,0,0,0,0,0
WA,2012,education - other,0,0,0,0,0,0,0,0
WA,2012,libraries,2127,10233927,3049,4541403,263720,3640,5176,14775330
WA,2012,liquor stores,0,0,0,0,0,0,0,0
WA,2012,other and unallocable,5111,27988634,894,1135125,54224,5407,6005,29123759
WV,2012,total,58081,189138205,13785,14704284,926607,63430,71866,203842489
WV,2012,financial administration,1538,3986434,187,158892,14124,1617,1725,4145326
WV,2012,other government administration,1146,3427936,1084,370760,26182,1287,2230,3798696
WV,2012,judicial and legal,1008,3174911,238,197753,15567,1092,1246,3372664
WV,2012,police protection total,2779,9473529,409,273848,25714,2927,3188,9747377
WV,2012,police protection - officers,2427,8634487,231,165034,13966,2504,2658,8799521
WV,2012,police protection - other,352,839042,178,108814,11748,423,530,947856
WV,2012,fire protection total,997,3464526,131,56903,5987,1029,1128,3521429
WV,2012,fire protection - firefighters,966,3381450,123,51444,5416,995,1089,3432894
WV,2012,fire protection - other,31,83076,8,5459,571,34,39,88535
WV,2012,corrections,107,282610,20,22685,2130,118,127,305295
WV,2012,highways,770,1894005,109,104913,9968,828,879,1998918
WV,2012,air transportation,155,444672,59,55678,5400,185,214,500350
WV,2012,water transport and terminals,0,0,0,0,0,0,0,0
WV,2012,public welfare,12,29440,17,17013,1257,20,29,46453
WV,2012,health,1011,2955500,353,337368,26661,1167,1364,3292868
WV,2012,hospitals,2072,7206424,536,758022,47354,2349,2608,7964446
WV,2012,social insurance administration,0,0,0,0,0,0,0,0
WV,2012,solid waste management,730,1789746,123,104439,10565,787,853,1894185
WV,2012,sewerage,1032,2952442,102,46094,4031,1050,1134,2998536
WV,2012,parks and recreation,544,1380559,852,492087,56574,866,1396,1872646
WV,2012,housing and community development,492,1434271,61,41961,3576,512,553,1476232
WV,2012,natural resources,92,246462,15,13874,1257,100,107,260336
WV,2012,water transport and terminals,1280,3821042,232,167779,14068,1355,1512,3988821
WV,2012,electric power,18,78392,0,0,0,18,18,78392
WV,2012,gas supply,0,0,0,0,0,0,0,0
WV,2012,transit,477,1452916,107,122776,10321,534,584,1575692
WV,2012,education total,40130,135329547,8509,10908062,597875,43625,48639,146237609
WV,2012,education - elementary and secondary total,40130,135329547,8509,10908062,597875,43625,48639,146237609
WV,2012,education - elementary and secondary instructional,26405,101341664,5145,7534345,370810,28586,31550,108876009
WV,2012,education - elementary and secondary other,13725,33987883,3364,3373717,227065,15039,17089,37361600
WV,2012,education - higher education total,0,0,0,0,0,0,0,0
WV,2012,education - higher education instructional,0,0,0,0,0,0,0,0
WV,2012,education - higher education other,0,0,0,0,0,0,0,0
WV,2012,education - other,0,0,0,0,0,0,0,0
WV,2012,libraries,330,796459,264,197225,21916,458,594,993684
WV,2012,liquor stores,0,0,0,0,0,0,0,0
WV,2012,other and unallocable,1361,3516382,377,256152,26080,1506,1738,3772534
WI,2012,total,175775,769633085,95906,93818948,5747704,208485,271681,863452033
WI,2012,financial administration,3128,14220725,2024,1561036,98270,3566,5152,15781761
WI,2012,other government administration,3760,14493387,9928,3987438,245471,5110,13688,18480825
WI,2012,judicial and legal,3012,12643797,795,1013419,45460,3264,3807,13657216
WI,2012,police protection total,14205,72570215,2920,2142771,145303,15014,17125,74712986
WI,2012,police protection - officers,11228,61048998,1142,868464,55577,11540,12370,61917462
WI,2012,police protection - other,2977,11521217,1778,1274307,89726,3474,4755,12795524
WI,2012,fire protection total,4240,23948300,5781,1435386,116688,4887,10021,25383686
WI,2012,fire protection - firefighters,4058,23119447,5396,1350022,111144,4673,9454,24469469
WI,2012,fire protection - other,182,828853,385,85364,5544,214,567,914217
WI,2012,corrections,3866,16575721,304,472380,25601,4013,4170,17048101
WI,2012,highways,7745,32364803,1516,1129892,80697,8171,9261,33494695
WI,2012,air transportation,369,1681082,52,53887,3483,388,421,1734969
WI,2012,water transport and terminals,19,100822,1,399,39,19,20,101221
WI,2012,public welfare,10938,42182675,3835,6694946,393283,13183,14773,48877621
WI,2012,health,4255,18999031,2447,3561141,163020,5181,6702,22560172
WI,2012,hospitals,696,2290948,387,650134,42667,941,1083,2941082
WI,2012,social insurance administration,0,0,0,0,0,0,0,0
WI,2012,solid waste management,1159,4589412,863,289889,26031,1246,2022,4879301
WI,2012,sewerage,1814,8421314,775,384750,24143,1934,2589,8806064
WI,2012,parks and recreation,2133,8658600,3268,2248461,167219,3073,5401,10907061
WI,2012,housing and community development,938,3864705,347,312895,20084,1056,1285,4177600
WI,2012,natural resources,739,2992910,211,161084,8605,789,950,3153994
WI,2012,water transport and terminals,1767,7826630,264,239358,14286,1846,2031,8065988
WI,2012,electric power,526,2976423,36,42221,1781,534,562,3018644
WI,2012,gas supply,0,0,0,0,0,0,0,0
WI,2012,transit,1831,6972075,175,270889,18570,1937,2006,7242964
WI,2012,education total,104260,453976864,52754,62562435,3767473,126079,157014,516539299
WI,2012,education - elementary and secondary total,96727,408043253,43704,51783975,3362807,116113,140431,459827228
WI,2012,education - elementary and secondary instructional,76937,343259685,22399,30551646,1823039,87445,99336,373811331
WI,2012,education - elementary and secondary other,19790,64783568,21305,21232329,1539768,28668,41095,86015897
WI,2012,education - higher education total,7533,45933611,9050,10778460,404666,9966,16583,56712071
WI,2012,education - higher education instructional,3593,25763279,5557,7883537,207157,4837,9150,33646816
WI,2012,education - higher education other,3940,20170332,3493,2894923,197509,5129,7433,23065255
WI,2012,education - other,0,0,0,0,0,0,0,0
WI,2012,libraries,1599,6072179,3371,3314544,250595,3025,4970,9386723
WI,2012,liquor stores,0,0,0,0,0,0,0,0
WI,2012,other and unallocable,2776,11210467,3852,1289593,88935,3229,6628,12500060
WY,2012,total,31821,133779070,13449,16553823,992458,37618,45270,150332893
WY,2012,financial administration,682,2576833,83,98835,6915,721,765,2675668
WY,2012,other government administration,643,2489139,430,203841,10461,696,1073,2692980
WY,2012,judicial and legal,414,1772742,91,108704,5454,441,505,1881446
WY,2012,police protection total,1679,7368027,103,102809,6525,1715,1782,7470836
WY,2012,police protection - officers,1227,5777555,23,30237,1589,1235,1250,5807792
WY,2012,police protection - other,452,1590472,80,72572,4936,480,532,1663044
WY,2012,fire protection total,412,2116643,484,107588,8212,456,896,2224231
WY,2012,fire protection - firefighters,355,1878798,421,75168,6100,388,776,1953966
WY,2012,fire protection - other,57,237845,63,32420,2112,68,120,270265
WY,2012,corrections,660,2593792,58,88130,5763,694,718,2681922
WY,2012,highways,776,3033458,47,64637,4963,803,823,3098095
WY,2012,air transportation,161,626510,21,45558,2515,175,182,672068
WY,2012,water transport and terminals,0,0,0,0,0,0,0,0
WY,2012,public welfare,114,416834,82,92890,7180,153,196,509724
WY,2012,health,427,1612049,250,289677,17627,528,677,1901726
WY,2012,hospitals,5572,27726097,1647,4367279,161415,6497,7219,32093376
WY,2012,social insurance administration,0,0,0,0,0,0,0,0
WY,2012,solid waste management,365,1305721,75,91431,6469,402,440,1397152
WY,2012,sewerage,172,740520,28,23400,1773,181,200,763920
WY,2012,parks and recreation,492,1891264,1050,582971,50081,777,1542,2474235
WY,2012,housing and community development,78,305932,21,25767,2080,91,99,331699
WY,2012,natural resources,310,1013111,123,110619,7434,351,433,1123730
WY,2012,water transport and terminals,326,1311835,85,58950,3931,347,411,1370785
WY,2012,electric power,75,401777,3,4940,80,75,78,406717
WY,2012,gas supply,0,0,0,0,0,0,0,0
WY,2012,transit,37,119511,84,145968,10337,96,121,265479
WY,2012,education total,17512,71035813,8124,9367630,629550,21254,25636,80403443
WY,2012,education - elementary and secondary total,15725,63791382,6221,7816985,544513,18987,21946,71608367
WY,2012,education - elementary and secondary instructional,11210,50827270,3533,4429683,292661,12961,14743,55256953
WY,2012,education - elementary and secondary other,4515,12964112,2688,3387302,251852,6026,7203,16351414
WY,2012,education - higher education total,1787,7244431,1903,1550645,85037,2267,3690,8795076
WY,2012,education - higher education instructional,557,3082764,677,762096,23473,690,1234,3844860
WY,2012,education - higher education other,1230,4161667,1226,788549,61564,1577,2456,4950216
WY,2012,education - other,0,0,0,0,0,0,0,0
WY,2012,libraries,242,810292,284,340581,24269,381,526,1150873
WY,2012,liquor stores,0,0,0,0,0,0,0,0
WY,2012,other and unallocable,672,2511170,276,231618,19424,784,948,2742788
